2e+05,2015,447,4,2,1900,8160,1,0,0,3,7,1900,0,1975,1975,98022,47.211,121.99,1280,6532,40,0,6,3180,8432
3.5e+05,2014,242,4,3,3380,16133,1,0,1,3,8,2330,1050,1959,1959,98118,47.55,122.26,2500,11100,55,0,7,5880,14480
2.54e+05,2014,341,3,2,2070,9000,1,0,0,4,7,1450,620,1969,1969,98023,47.309,122.38,1630,7885,45,0,5,3700,9955
1.75e+05,2015,480,3,1,1150,8924,1,0,0,3,6,1150,0,1943,1943,98030,47.386,122.22,1492,8924,72,0,4,2642,10074
6.19e+05,2015,451,3,2.5,2040,7503,2,0,0,3,8,2040,0,1987,1987,98029,47.572,122.02,2170,7503,28,0,5.5,4210,9543
2.4e+05,2015,366,3,1,1550,12670,1,0,0,4,7,1550,0,1962,1962,98056,47.502,122.17,1550,8880,53,0,4,3100,10430
1.58e+05,2014,249,3,2.5,1520,7200,2,0,0,4,7,1520,0,1985,1985,98030,47.368,122.18,1780,7210,29,0,5.5,3300,8730
2e+05,2014,245,2,1,790,5985,1,0,0,3,6,790,0,1944,1944,98178,47.494,122.24,1030,5985,70,0,3,1820,6775
2.75e+05,2014,211,3,1.5,1900,9737,1,0,0,4,7,1200,700,1968,1968,98031,47.413,122.21,1670,9737,46,0,4.5,3570,11637
5.935e+05,2015,400,5,3.25,4300,50405,2,0,0,3,8,3220,1080,1972,1972,98027,47.462,122,2680,41684,43,0,8.25,6980,45984
3.35e+05,2015,452,5,2.5,2400,4548,2,0,0,3,7,2400,0,2003,2003,98042,47.371,122.13,2200,4465,12,0,7.5,4600,6865
2.72e+05,2015,465,4,2.25,1800,9018,2,0,0,3,7,1800,0,1992,1992,98022,47.213,121.98,1670,9380,23,0,6.25,3470,11180
2.02e+05,2014,181,1,1,590,833,1,0,0,4,7,590,0,1926,1926,98122,47.608,122.3,780,1617,88,0,2,1370,2207
2.19e+05,2015,445,3,1,1250,8276,1,0,0,5,6,1250,0,1939,1939,98022,47.209,122,1250,8792,76,0,4,2500,10042
2.225e+05,2014,272,3,1,990,10125,1,0,0,3,7,990,0,1972,1972,98042,47.342,122.09,1360,10125,42,0,4,2350,11115
2.6e+05,2014,239,3,1.75,1670,8511,1,0,0,3,7,1340,330,1985,1985,98001,47.326,122.28,1580,7218,29,0,4.75,3250,8888
4.3995e+05,2014,229,4,2.25,2780,15075,2,0,0,3,7,2780,0,1985,1985,98059,47.477,122.12,1650,25542,29,0,6.25,4430,28322
2.08e+05,2015,480,3,1,990,7420,1,0,0,5,6,990,0,1960,1960,98002,47.29,122.22,1010,7420,55,0,4,2000,8410
7.125e+05,2014,153,3,1.5,1660,8797,1,0,0,4,7,1660,0,1956,1956,98004,47.589,122.2,2350,10053,58,0,4.5,4010,11713
7.3e+05,2014,301,3,2.5,2160,8809,1,0,0,3,9,1540,620,2014,2014,98103,47.699,122.35,930,5420,0,0,5.5,3090,7580
1.53e+05,2015,393,2,1,710,9000,1,0,0,5,6,710,0,1943,1943,98166,47.481,122.34,1230,9000,72,0,3,1940,9710
4.15e+05,2014,177,3,2.5,1060,1536,2,0,0,3,8,1060,0,2000,2000,98117,47.691,122.39,1220,1316,14,0,5.5,2280,2376
5.45e+05,2014,161,2,1.25,1240,2150,2,0,0,3,8,1240,0,2014,2014,98117,47.688,122.37,1340,5289,0,0,3.25,2580,6529
2.79e+05,2014,198,4,2.5,1810,13000,1,0,0,4,8,1470,340,1977,1977,98022,47.22,121.99,1850,13000,37,0,6.5,3660,14810
2.5e+05,2014,290,4,1.75,1510,5500,1,0,0,3,7,1510,0,1920,1920,98106,47.535,122.36,1320,6431,94,0,5.75,2830,7941
3.9668e+05,2014,140,2,1,1730,6375,2,0,0,4,6,1730,0,1945,1945,98126,47.536,122.37,1180,6250,69,0,3,2910,7980
6.6e+05,2015,401,4,2.25,2010,15375,1,0,0,4,8,2010,0,1957,1957,98005,47.596,122.17,1930,15375,58,0,6.25,3940,17385
3.68e+05,2014,139,2,1.5,1660,4680,1,0,0,5,6,830,830,1908,1908,98146,47.513,122.39,1930,5400,106,0,3.5,3590,7060
4.65e+05,2014,348,3,2.5,1600,1311,3,0,0,3,8,1600,0,2005,2005,98117,47.69,122.39,1390,1321,9,0,5.5,2990,2921
4.8e+05,2015,366,5,2.75,2670,4780,2,0,0,3,8,2670,0,2013,2013,98059,47.487,122.16,2560,5380,2,0,7.75,5230,8050
7.95e+05,2014,197,4,2.5,3160,16564,2,0,0,3,10,3160,0,1987,1987,98074,47.636,122.04,3160,12415,27,0,6.5,6320,15575
5.8e+05,2015,486,3,2.5,1980,1873,2,0,0,3,7,1470,510,1996,1996,98107,47.666,122.37,1500,1873,19,0,5.5,3480,3853
4.29e+05,2014,221,3,3.25,2210,3600,2,0,0,3,8,1820,390,1995,1995,98125,47.703,122.28,2010,6690,19,0,6.25,4220,8900
2.75e+05,2015,479,3,1.75,1180,6260,1,0,0,4,8,1180,0,1993,1993,98038,47.353,122.05,1580,7272,22,0,4.75,2760,8452
6.25e+05,2014,182,3,3,1820,1641,3,0,0,3,8,1540,280,2006,2006,98119,47.648,122.36,1720,1501,8,0,6,3540,3321
3.2e+05,2014,307,3,1,1520,8870,1,0,0,4,7,1520,0,1951,1951,98155,47.764,122.32,1520,7800,63,0,4,3040,9320
6.6e+05,2014,304,3,2.25,2280,6150,2,0,2,3,8,2280,0,1984,1984,98136,47.542,122.39,1920,6150,30,0,5.25,4200,8430
7e+05,2015,369,4,2.5,3270,9650,1,0,3,4,9,2320,950,1971,1971,98166,47.409,122.33,2340,17357,44,0,6.5,5610,20627
8.7e+05,2014,175,4,2.75,2840,4000,1,0,0,5,8,1960,880,1912,1912,98144,47.585,122.29,2750,4000,102,0,6.75,5590,6840
3.09e+05,2015,473,3,2.5,1950,3825,2,0,0,3,7,1950,0,2013,2013,98042,47.359,122.08,1950,3825,2,0,5.5,3900,5775
6.97e+05,2015,479,4,1.75,1670,13125,1,0,0,5,8,1670,0,1973,1973,98052,47.632,122.1,2360,12500,42,0,5.75,4030,14170
4.8e+05,2015,460,5,2.25,2240,5500,1,0,0,3,7,1490,750,1959,1959,98136,47.531,122.39,2010,6050,56,0,7.25,4250,8290
6.7425e+05,2014,321,4,2.5,2780,35000,1,0,0,4,9,2780,0,1985,1985,98072,47.739,122.09,2740,35072,29,0,6.5,5520,37852
2e+05,2015,402,4,2,1920,4822,1,0,0,2,6,920,1000,1914,1914,98136,47.551,122.38,1120,4822,101,0,6,3040,6742
8.75e+05,2014,136,3,2,2220,6641,1,0,2,4,7,1220,1000,1947,1947,98199,47.643,122.39,1800,5900,67,0,5,4020,8120
6.25e+05,2015,451,5,2.75,2910,85377,1,0,0,4,8,1510,1400,1966,1966,98027,47.48,122.03,2160,66120,49,0,7.75,5070,69030
5.3e+05,2015,451,4,2.25,2410,14985,1,0,1,4,7,1950,460,1965,1965,98166,47.428,122.34,2510,15256,50,0,6.25,4920,17666
3.42e+05,2015,447,3,1,1980,6450,1,0,0,4,6,1120,860,1950,1950,98106,47.529,122.36,1180,5160,65,0,4,3160,7140
5.5e+05,2014,248,4,2.5,2120,9163,1,0,0,4,8,1450,670,1961,1961,98006,47.555,122.17,2120,9166,53,0,6.5,4240,11286
4.79e+05,2015,467,2,2.5,1741,1439,2,0,0,3,8,1446,295,2007,2007,98034,47.704,122.21,2090,10454,8,0,4.5,3831,12195
4.08e+05,2014,142,3,2.25,1950,7221,1,0,0,4,8,1950,0,2006,2006,98188,47.431,122.28,2310,8125,8,0,5.25,4260,10075
3.25e+05,2015,429,4,2.5,2090,7434,1,0,0,3,7,1090,1000,1993,1993,98146,47.496,122.35,1260,8404,22,0,6.5,3350,10494
7.48e+05,2014,203,4,2.5,3170,4979,2,0,0,4,7,2570,600,1925,1925,98103,47.666,122.34,2060,5000,89,0,6.5,5230,8170
2.85e+05,2014,352,4,2.25,2150,8250,1,0,0,4,7,1240,910,1978,1978,98023,47.304,122.38,2050,7875,36,0,6.25,4200,10025
3e+05,2015,478,3,1,1010,10168,1,0,0,3,6,1010,0,1979,1979,98014,47.645,121.91,1180,10318,36,0,4,2190,11328
3.7495e+05,2015,443,4,2.5,1980,12062,2,0,0,3,8,1980,0,1992,1992,98031,47.404,122.17,2300,7902,23,0,6.5,4280,9882
3.3e+05,2014,129,4,2.5,1940,3784,2,0,0,3,8,1940,0,2003,2003,98058,47.451,122.12,1940,4499,11,0,6.5,3880,6439
3.43e+05,2014,286,2,1,1230,7560,1,0,0,3,7,1230,0,1961,1961,98133,47.73,122.34,1270,7560,53,0,3,2500,8790
6.64e+05,2014,325,6,2.5,3190,12196,2,0,0,4,8,3190,0,1979,1979,98052,47.631,122.1,2790,13068,35,0,8.5,5980,16258
5.5495e+05,2014,311,4,1.75,1740,4816,1,0,0,5,7,870,870,1942,1942,98116,47.576,122.38,1210,5074,72,0,5.75,2950,6814
4.67e+05,2015,450,5,2,2080,4000,1,0,0,4,6,1040,1040,1909,1909,98144,47.586,122.31,1940,6000,106,0,7,4020,8080
3.9535e+05,2015,474,2,1,1060,5754,1,0,0,4,6,1060,0,1917,1917,98117,47.693,122.37,1460,7200,98,0,3,2520,8260
7.35e+05,2015,478,3,1.75,2250,11520,1,0,1,3,8,2250,0,1956,1956,98028,47.762,122.27,2730,12445,59,0,4.75,4980,14695
1.865e+06,2014,251,6,2.75,4460,6952,2,0,2,4,10,3460,1000,1930,1930,98105,47.663,122.27,2750,4769,84,0,8.75,7210,9229
5.125e+05,2014,135,3,2.5,1840,2875,2,0,0,4,7,1840,0,1997,1997,98116,47.562,122.39,1240,5750,17,0,5.5,3080,7590
2.45e+05,2014,263,2,1,1120,5650,1,0,1,3,6,720,400,1904,1904,98118,47.516,122.25,2160,6480,110,0,3,3280,7600
4.88e+05,2014,314,4,2.25,2500,10890,1,0,0,5,7,1800,700,1978,1978,98034,47.732,122.24,2500,7467,36,0,6.25,5000,9967
4.55e+05,2014,203,4,2.5,2090,4400,2,0,0,3,8,2090,0,2011,2011,98118,47.54,122.29,2090,3430,3,0,6.5,4180,5520
8.1e+05,2014,189,4,1.75,2000,3988,1,0,4,4,7,1000,1000,1958,1958,98116,47.593,122.39,1690,4144,56,0,5.75,3690,6144
1.65e+06,2014,239,4,2.25,2920,20400,1,0,0,4,11,2920,0,1966,1966,98004,47.624,122.23,3080,20400,48,0,6.25,6000,23320
4.65e+05,2015,411,3,2,1430,7125,1,0,0,4,7,1430,0,1984,1984,98074,47.626,122.06,1570,8075,31,0,5,3000,9505
3.3095e+05,2015,389,3,2.5,1630,2844,2,0,0,3,7,1630,0,2003,2003,98118,47.541,122.29,1610,2582,12,0,5.5,3240,4212
5.65e+05,2014,230,3,1.75,1540,4800,1,0,0,4,6,770,770,1925,1925,98105,47.67,122.28,1510,4080,89,0,4.75,3050,5620
3.2e+05,2015,373,3,2.25,1580,6561,1,0,0,3,8,1200,380,1981,1981,98058,47.439,122.14,1710,7241,34,0,5.25,3290,8821
7.886e+05,2014,143,4,2.75,3500,7200,2,0,0,3,9,3500,0,2005,2005,98053,47.682,122.03,3920,7666,9,0,6.75,7420,11166
4.63e+05,2014,129,2,1,1150,4400,1,0,0,4,7,1150,0,1905,1905,98112,47.623,122.29,1240,4400,109,0,3,2390,5550
5.45e+05,2014,209,4,1.75,1910,6731,1,0,0,4,7,1210,700,1953,1953,98116,47.569,122.39,1780,6350,61,0,5.75,3690,8260
2.53e+05,2014,160,3,1.75,2040,7281,1,0,0,3,7,1020,1020,1962,1962,98188,47.468,122.28,1740,7527,52,0,4.75,3780,9567
5.35e+05,2015,393,4,2.25,2810,12607,2,0,0,3,10,2810,0,1985,1985,98058,47.459,122.13,2810,17400,30,0,6.25,5620,20210
2.4e+05,2014,141,2,1.75,1330,7200,1,0,0,3,7,1330,0,1993,1993,98188,47.447,122.28,1450,11682,21,0,3.75,2780,13012
4.4e+05,2014,291,4,2.75,2030,56192,1,0,0,3,8,1550,480,1979,1979,98077,47.752,122.07,2510,44866,35,0,6.75,4540,46896
5.85e+05,2014,143,3,2,1670,4572,1,0,0,3,8,1670,0,1931,1931,98117,47.685,122.37,1480,4890,83,0,5,3150,6560
2.45e+05,2015,430,4,2.5,1921,4888,2,0,0,3,7,1921,0,2009,2009,98001,47.269,122.24,1921,9140,6,0,6.5,3842,11061
3.5e+05,2014,301,3,1.75,2090,6258,1,0,0,3,7,1390,700,1956,1956,98108,47.55,122.3,1790,5793,58,0,4.75,3880,7883
5.9e+05,2014,257,3,3.25,1290,1230,2,0,2,3,9,1090,200,2008,2008,98119,47.637,122.37,1710,1797,6,0,6.25,3000,3087
3.9996e+05,2014,230,4,2.5,2620,4050,2,0,0,3,8,2620,0,2014,2014,98146,47.502,122.34,2030,3944,0,0,6.5,4650,6564
3.35e+05,2014,122,2,2,1350,2560,1,0,0,3,8,1350,0,1976,1976,98052,47.634,122.11,1790,2560,38,0,4,3140,3910
7.25e+05,2014,346,2,1,2410,5930,2,0,0,3,9,1930,480,2007,2007,98116,47.566,122.39,1540,5892,7,0,3,3950,8302
7.65e+05,2014,167,3,2,1570,7000,2,0,2,4,8,1050,520,1971,1971,98122,47.606,122.29,1990,6675,43,0,5,3560,8245
4.77e+05,2014,243,4,1.5,1380,7800,1,0,0,3,7,1080,300,1928,1928,98125,47.709,122.31,1770,7503,86,0,5.5,3150,8883
6.14e+05,2015,413,4,2.75,2760,8160,1,0,2,4,8,1780,980,1940,1940,98177,47.725,122.36,2720,8160,75,0,6.75,5480,10920
5.35e+05,2014,128,4,2.5,2280,65836,2,0,0,3,8,2280,0,2004,2004,98077,47.724,122.08,2300,97574,10,0,6.5,4580,99854
4.2e+05,2014,187,3,2.25,1620,1075,3,0,0,3,8,1540,80,2009,2009,98027,47.541,122.03,1620,1237,5,0,5.25,3240,2857
4.85e+05,2014,341,4,2.75,2560,8956,1,0,0,4,7,1500,1060,1968,1968,98034,47.728,122.18,2280,9234,46,0,6.75,4840,11794
2.95e+05,2014,122,2,2.5,1630,1368,2,0,0,3,7,1280,350,2009,2009,98106,47.549,122.36,1590,2306,5,0,4.5,3220,3936
2.465e+05,2015,439,3,1.5,1170,11530,1,0,0,3,7,1170,0,1960,1960,98198,47.421,122.29,1550,8605,55,0,4.5,2720,9775
8.5733e+05,2014,304,3,3.5,3940,11632,2,0,0,3,10,3940,0,2014,2014,98166,47.438,122.34,2015,11632,0,0,6.5,5955,15572
3.4995e+05,2015,368,5,2,1880,4179,1,0,0,3,7,940,940,1952,2000,98118,47.554,122.28,1350,5150,63,1,7,3230,7030
1.805e+05,2015,436,2,1,850,5000,1,0,0,3,6,850,0,1976,1976,98198,47.382,122.31,1160,5000,39,0,3,2010,5850
2.8e+05,2014,256,6,3,2400,9373,2,0,0,3,7,2400,0,1991,1991,98002,47.326,122.21,2060,7316,23,0,9,4460,9716
3.8116e+05,2014,356,2,1,1320,3090,1,0,0,4,7,1320,0,1908,1908,98118,47.552,122.28,1270,4120,106,0,3,2590,5440
3.2e+05,2014,318,3,1.5,1240,1221,2,0,0,3,8,1050,190,2009,2009,98133,47.707,122.36,1180,887,5,0,4.5,2420,2127
4.149e+05,2014,236,3,1.5,1260,9570,1,0,0,3,7,870,390,1941,1941,98115,47.7,122.31,1620,7000,73,0,4.5,2880,8260
4.75e+05,2014,229,4,2.5,2120,57050,2,0,0,3,9,2120,0,1989,1989,98072,47.761,122.13,3320,39082,25,0,6.5,5440,41202
5e+05,2014,278,4,2.25,2490,23478,2,0,0,3,8,2490,0,1981,1981,98072,47.755,122.09,2030,12611,33,0,6.25,4520,15101
7.96e+05,2014,202,4,3.5,3670,4960,2,0,0,3,9,2870,800,2005,2005,98177,47.702,122.37,1520,6335,9,0,7.5,5190,10005
9.35e+05,2014,298,5,2.5,3150,35283,1,0,0,3,10,1800,1350,1975,1975,98005,47.637,122.16,3280,35283,39,0,7.5,6430,38433
6.35e+05,2014,211,4,1.75,2460,7560,2,0,0,4,8,2460,0,1952,1952,98177,47.726,122.37,2760,8918,62,0,5.75,5220,11378
9.259e+05,2014,317,4,3.75,3980,7828,2,0,0,3,10,3980,0,2001,2001,98074,47.63,122.06,3980,8910,13,0,7.75,7960,12890
2.9e+05,2014,176,2,1,930,7740,1,0,0,3,6,930,0,1924,1924,98125,47.709,122.29,1250,7740,90,0,3,2180,8670
5.5e+05,2014,251,4,3.5,2660,5690,2,0,0,3,8,1920,740,2014,2014,98059,47.477,122.12,2970,5690,0,0,7.5,5630,8350
3.5e+05,2014,228,3,1,1020,4980,1,0,0,4,7,850,170,1941,1941,98133,47.704,122.34,970,4980,73,0,4,1990,6000
9.904e+05,2015,409,3,2.5,2100,4097,2,0,0,3,9,2100,0,2008,2008,98004,47.598,122.2,1820,4764,7,0,5.5,3920,6864
1.5e+05,2014,263,2,1,790,7275,1,0,0,4,6,790,0,1944,1944,98058,47.477,122.17,850,7399,70,0,3,1640,8189
4.65e+05,2014,306,4,2.5,2170,7700,1,0,0,3,7,1420,750,1969,1969,98034,47.722,122.22,1710,7770,45,0,6.5,3880,9940
3e+05,2015,472,6,3,2400,9373,2,0,0,3,7,2400,0,1991,1991,98002,47.326,122.21,2060,7316,24,0,9,4460,9716
9.75e+05,2014,270,4,2.5,2720,10455,2,0,2,3,10,2500,220,1981,1981,98006,47.556,122.16,3240,12348,33,0,6.5,5960,15068
6.2e+05,2014,360,4,2.5,3040,9606,2,0,0,3,7,3040,0,2003,2003,98053,47.688,122.04,1690,3849,11,0,6.5,4730,6889
1.1e+06,2014,140,3,2,2390,6888,2,0,1,5,8,2390,0,1939,1939,98115,47.684,122.27,2390,7920,75,0,5,4780,10310
7.8789e+05,2014,236,4,2.25,2580,21115,2,0,0,4,9,2580,0,1977,1977,98040,47.557,122.22,2690,10165,37,0,6.25,5270,12745
4.92e+05,2015,424,2,1,950,6000,1,0,0,3,7,950,0,1942,1942,98115,47.69,122.29,1440,6000,73,0,3,2390,6950
6.25e+05,2015,484,4,1.5,2120,5000,2,0,0,4,8,2120,0,1900,1900,98122,47.602,122.3,1830,5000,115,0,5.5,3950,7120
7.95e+05,2014,218,4,2.75,3100,7501,2,0,0,3,10,3100,0,1998,1998,98052,47.686,122.11,3140,8672,16,0,6.75,6240,11772
2.8e+05,2014,181,3,1,1090,10710,1,0,0,4,7,1090,0,1962,1962,98056,47.5,122.17,1090,10440,52,0,4,2180,11530
4.5e+05,2014,236,2,1,910,5000,1,0,0,4,6,910,0,1914,1914,98117,47.683,122.37,1480,5000,100,0,3,2390,5910
5e+05,2014,287,2,1,1120,3220,1,0,0,4,7,1120,0,1923,1923,98103,47.659,122.34,1440,3220,91,0,3,2560,4340
2.75e+05,2014,208,3,2.5,1870,6821,2,0,0,3,7,1870,0,1989,1989,98023,47.306,122.36,1970,6821,25,0,5.5,3840,8691
3.05e+05,2014,342,4,2,1780,5043,1,0,0,3,7,870,910,1993,1993,98133,47.705,122.34,1350,5044,21,0,6,3130,6824
5.5499e+05,2015,493,3,2.5,2100,6092,2,0,0,3,8,2100,0,2013,2013,98028,47.751,122.24,2250,8592,2,0,5.5,4350,10692
6.1e+05,2014,194,3,1.75,1630,1500,3,0,0,3,8,1630,0,2014,2014,98103,47.654,122.35,1570,1335,0,0,4.75,3200,2965
6.9e+05,2014,280,3,2.75,2480,3240,1,0,0,3,9,1890,590,1929,1929,98112,47.64,122.31,2160,3240,85,0,5.75,4640,5720
5.9995e+05,2015,451,3,2.5,1970,1.0672e+05,1,0,4,3,9,1970,0,1985,1985,98022,47.25,122,2910,1.0149e+05,30,0,5.5,4880,1.0346e+05
4.15e+05,2014,176,3,1,1170,6700,1,0,0,3,8,1170,0,1957,1957,98125,47.712,122.29,2410,7620,57,0,4,3580,8790
1.25e+06,2014,298,3,2.75,2780,4815,3,0,2,3,10,2780,0,1974,1974,98105,47.657,122.29,2820,5000,40,0,5.75,5600,7780
1.45e+05,2014,310,2,1,800,8125,1,0,0,3,6,800,0,1964,1964,98033,47.684,122.17,2390,8125,50,0,3,3190,8925
1.085e+06,2014,217,3,1.5,2560,4000,1,0,0,5,8,1660,900,1927,1927,98112,47.638,122.28,2560,4000,87,0,4.5,5120,6560
4e+05,2015,374,2,1,610,4560,1,0,0,3,5,610,0,1918,1918,98136,47.55,122.38,930,1392,97,0,3,1540,2002
4.3e+05,2015,410,4,1.75,1570,7650,1,0,0,3,7,1100,470,1975,1975,98052,47.68,122.11,1580,7650,40,0,5.75,3150,9220
7e+05,2015,464,4,1.75,1870,6000,1,0,0,5,8,1670,200,1949,1949,98199,47.644,122.4,1710,6000,66,0,5.75,3580,7870
2.73e+05,2015,487,3,2.25,1930,8192,1,0,0,3,7,1470,460,1984,1984,98003,47.262,122.3,1510,8192,31,0,5.25,3440,10122
4.11e+05,2015,399,1,1,1080,5000,1,0,0,3,7,1080,0,1948,1948,98199,47.66,122.39,1620,4000,67,0,2,2700,5080
8.98e+05,2014,284,2,2.25,2470,7658,1,0,0,4,8,1480,990,1954,1954,98199,47.653,122.42,2070,7270,60,0,4.25,4540,9740
5.25e+05,2014,270,5,1,1280,3876,1,0,0,3,7,1280,0,1923,1923,98105,47.66,122.32,1420,3825,91,0,6,2700,5105
7.06e+05,2014,283,4,2.5,3280,16575,1,0,0,3,9,2190,1090,1972,1972,98188,47.426,122.28,1570,13209,42,0,6.5,4850,16489
6.3e+05,2015,473,5,3.5,4060,8309,2,0,0,3,9,2960,1100,2001,2001,98028,47.757,122.23,1730,11711,14,0,8.5,5790,15771
3.7095e+05,2015,417,3,2.5,2529,9653,2,0,0,3,7,2529,0,2012,2012,98042,47.374,122.16,2533,6125,3,0,5.5,5062,8654
2.65e+05,2014,183,3,1,1020,8610,1,0,0,5,7,1020,0,1959,1959,98056,47.497,122.17,1070,5940,55,0,4,2090,6960
2.999e+05,2015,430,4,2.75,2330,7200,1,0,0,4,8,1560,770,1977,1977,98023,47.32,122.39,2350,7600,38,0,6.75,4680,9930
4.4225e+05,2015,387,3,2.5,2170,8169,2,0,0,3,8,2170,0,2003,2003,98059,47.483,122.14,2240,6733,12,0,5.5,4410,8903
2.65e+05,2014,169,3,1.75,1840,7300,1,0,0,3,8,1840,0,1966,1966,98023,47.312,122.37,1920,8010,48,0,4.75,3760,9850
1.24e+06,2014,160,5,3,2830,7500,2,0,0,3,9,2460,370,1923,1923,98105,47.658,122.28,2900,5000,91,0,8,5730,7830
6.25e+05,2014,283,4,2.5,2601,34335,2,0,0,3,9,2601,0,1995,1995,98072,47.742,122.09,2080,32336,19,0,6.5,4681,34937
4.85e+05,2015,466,4,2.5,3710,15935,1,0,0,3,10,2130,1580,2005,2005,98001,47.353,122.27,3674,17913,10,0,6.5,7384,21623
3.36e+05,2015,464,2,1,1180,7200,1,0,0,4,6,1180,0,1949,1949,98133,47.748,122.34,1180,7200,66,0,3,2360,8380
9.3e+05,2014,134,3,2.5,3100,20553,1,0,0,3,10,3100,0,1954,1954,98177,47.764,122.38,3000,22302,60,0,5.5,6100,25402
5.5e+05,2014,182,4,2.75,2160,5005,1,0,0,3,7,1430,730,1987,1987,98115,47.697,122.3,1770,5326,27,0,6.75,3930,7486
1.71e+06,2014,147,5,4.5,4590,14685,2,0,0,3,10,4590,0,2009,2009,98033,47.664,122.2,3030,9486,5,0,9.5,7620,14076
1.35e+05,2014,154,1,1,790,13062,1,0,0,3,6,790,0,1942,1942,98168,47.492,122.31,1240,7137,72,0,2,2030,7927
9.7e+05,2014,292,3,2.25,3400,10000,2,0,0,3,10,3400,0,1983,1983,98115,47.685,122.28,1860,5100,31,0,5.25,5260,8500
1.295e+06,2015,451,4,2.5,3070,4000,2,0,0,4,8,2070,1000,1940,1940,98105,47.659,122.28,2560,4000,75,0,6.5,5630,7070
5.1e+05,2014,293,4,2,2990,1.0237e+05,1,0,0,4,8,2990,0,1974,1974,98092,47.307,122.09,2820,57140,40,0,6,5810,60130
3.6e+05,2015,488,4,1.75,2010,12188,1,0,0,4,7,1150,860,1960,1960,98059,47.501,122.15,1720,8475,55,0,5.75,3730,10485
4.95e+05,2014,326,2,1.75,1850,2530,2,0,0,4,7,1850,0,1903,1903,98122,47.611,122.31,1500,1795,111,0,3.75,3350,3645
5.51e+05,2015,438,4,1.75,2040,6348,1,0,0,3,7,1020,1020,1962,1962,98103,47.696,122.34,1770,5047,53,0,5.75,3810,7087
5.83e+05,2014,214,3,1.5,1800,10050,1,0,0,3,7,1800,0,1955,1955,98008,47.634,122.13,1610,10050,59,0,4.5,3410,11850
7.4995e+05,2014,320,4,2.5,2370,2971,2,0,2,3,9,2080,290,2008,2008,98034,47.706,122.22,2970,7500,6,0,6.5,5340,9870
7.543e+05,2015,474,5,2.75,1800,4500,2,0,0,4,7,1680,120,1939,1939,98107,47.665,122.36,1730,4500,76,0,7.75,3530,6300
2.55e+05,2015,413,4,1,1250,9102,1,0,0,3,7,1250,0,1955,1955,98148,47.426,122.33,1260,9180,60,0,5,2510,10430
3.58e+05,2014,344,2,1,1140,8340,1,0,0,3,7,1140,0,1948,1948,98155,47.745,122.3,1030,8149,66,0,3,2170,9289
1.1e+06,2014,209,4,2.25,3310,8540,1,0,4,4,9,1660,1650,1973,1973,98006,47.56,122.16,3450,9566,41,0,6.25,6760,12876
4.3e+05,2014,141,3,2.75,2550,11160,2,0,0,3,8,2550,0,1994,1994,98155,47.735,122.32,1020,7440,20,0,5.75,3570,9990
9.095e+05,2015,401,4,4,4420,5940,2,0,0,3,10,3410,1010,2006,2006,98027,47.54,122.07,4510,5797,9,0,8,8930,10217
3.11e+05,2014,349,3,2,1190,7840,1,0,0,4,6,1190,0,1918,1918,98108,47.553,122.31,1460,3240,96,0,5,2650,4430
1.85e+05,2014,195,3,1,1510,17040,1,0,0,4,6,1510,0,1975,1975,98001,47.265,122.28,1520,14000,39,0,4,3030,15510
3.0689e+05,2015,487,4,1.5,1940,8970,1,0,0,3,7,1270,670,1980,1980,98125,47.73,122.33,1960,8470,35,0,5.5,3900,10410
5.61e+05,2015,438,3,2.5,2120,5277,2,0,0,3,7,2120,0,2005,2005,98053,47.681,122.03,2370,5257,10,0,5.5,4490,7377
9.1e+05,2014,278,4,1.5,2890,9000,2,0,4,3,8,2090,800,1939,1939,98118,47.568,122.27,2550,8400,75,0,5.5,5440,11290
2.65e+05,2014,159,2,1,1000,31505,1,0,0,3,6,1000,0,1960,1960,98019,47.766,121.9,1560,22597,54,0,3,2560,23597
7.1e+05,2014,160,3,3.5,2440,3427,2,0,0,3,7,1990,450,2000,2000,98005,47.589,122.17,2440,2601,14,0,6.5,4880,5041
4.649e+05,2014,177,4,2.25,2020,8424,1,0,0,4,7,1380,640,1979,1979,98034,47.726,122.23,2030,7236,35,0,6.25,4050,9256
3.45e+05,2014,210,5,3,2080,6150,1,0,0,3,7,1040,1040,1950,1950,98116,47.571,122.39,1420,6150,64,0,8,3500,8230
7.75e+05,2014,221,4,2.25,4220,24186,1,0,0,3,8,2600,1620,1984,1984,98166,47.445,122.35,2410,30617,30,0,6.25,6630,34837
3.25e+05,2014,126,4,2.5,1890,6156,1,0,0,3,7,980,910,1980,1980,98106,47.551,122.36,1590,6954,34,0,6.5,3480,8844
3.299e+05,2014,284,2,2.5,980,1021,3,0,0,3,8,980,0,2008,2008,98117,47.684,122.39,980,1023,6,0,4.5,1960,2003
7.95e+05,2015,471,5,3,2750,10000,1,0,0,4,7,1730,1020,1957,1957,98008,47.588,122.13,2520,10000,58,0,8,5270,12750
6.755e+05,2015,445,4,2.75,2060,21344,1,0,0,2,8,1460,600,1978,1978,98005,47.593,122.15,2060,16088,37,0,6.75,4120,18148
6.35e+05,2015,412,4,2.5,2880,3091,2,0,0,3,9,1940,940,2014,2014,98144,47.571,122.29,1560,4080,1,0,6.5,4440,6960
2.69e+05,2014,204,3,2.5,1440,3800,2,0,0,3,7,1440,0,2005,2005,98038,47.361,122.04,1890,3819,9,0,5.5,3330,5259
2.2995e+05,2015,460,2,1,850,6000,1,0,0,3,6,850,0,1924,1924,98178,47.497,122.22,1100,6000,91,0,3,1950,6850
3.261e+05,2014,147,2,1,880,7683,1,0,0,3,6,880,0,1942,1942,98177,47.715,122.36,1370,7695,72,0,3,2250,8575
3.4495e+05,2014,341,3,2,1330,7419,1,0,0,3,7,1330,0,1985,1985,98034,47.732,122.24,1330,7297,29,0,5,2660,8627
5.39e+05,2014,242,3,2.5,2830,9972,2,0,0,3,9,2830,0,2006,2006,98019,47.738,121.97,3557,9159,8,0,5.5,6387,11989
2.54e+05,2014,136,4,2,1510,4235,1,0,0,3,7,1510,0,1955,1955,98108,47.546,122.29,1510,4268,59,0,6,3020,5778
9.4e+05,2014,255,4,3,2720,11740,1,0,0,5,9,2720,0,1957,1957,98040,47.583,122.24,2640,11740,57,0,7,5360,14460
3.5e+05,2014,132,2,1,910,4500,1,0,0,4,7,910,0,1906,1906,98118,47.563,122.29,1270,3500,108,0,3,2180,4410
6.7232e+05,2014,214,2,1.75,1600,5795,1,0,0,3,8,1600,0,1940,1940,98105,47.671,122.28,2310,6301,74,0,3.75,3910,7901
2.15e+05,2015,399,3,1,1610,7140,1,0,0,3,7,1080,530,1976,1976,98031,47.394,122.19,1800,7600,39,0,4,3410,9210
6.65e+05,2015,441,4,2.25,2650,8149,1,0,0,4,8,1610,1040,1975,1975,98006,47.562,122.18,2290,8019,40,0,6.25,4940,10669
2.699e+05,2014,215,5,1.75,1750,8325,1,0,0,5,7,1750,0,1966,1966,98031,47.401,122.2,1430,8325,48,0,6.75,3180,10075
3.51e+05,2015,463,4,2.5,2370,7274,2,0,0,3,7,2370,0,1997,1997,98031,47.398,122.17,2090,7656,18,0,6.5,4460,10026
3.6e+05,2015,479,5,3,2480,7200,1,0,0,3,7,1560,920,1999,1999,98188,47.459,122.28,1910,9432,16,0,8,4390,11912
3.825e+05,2014,167,4,2.5,2210,7079,2,0,0,3,8,2210,0,1993,1993,98031,47.421,122.18,1970,7000,21,0,6.5,4180,9210
3.69e+05,2015,484,4,2.5,3060,27251,1,0,0,3,8,3060,0,2008,2008,98022,47.197,121.97,1760,27251,7,0,6.5,4820,30311
3.68e+05,2014,278,4,2,2500,36900,1,0,0,3,7,1540,960,1972,1972,98038,47.371,122.05,1960,36900,42,0,6,4460,39400
3.78e+05,2014,319,2,2.5,1700,2513,2,0,0,3,8,1700,0,2009,2009,98065,47.516,121.88,1760,2891,5,0,4.5,3460,4591
2.45e+05,2014,230,3,1.75,1480,3900,1,0,0,4,7,1480,0,1980,1980,98023,47.298,122.37,1830,6956,34,0,4.75,3310,8436
1.208e+06,2015,454,4,2.75,4250,10925,2,0,0,3,10,4250,0,2003,2003,98059,47.53,122.14,4650,11544,12,0,6.75,8900,15794
2.38e+05,2014,237,3,1,1240,5700,1,0,0,5,6,1240,0,1953,1953,98056,47.493,122.17,1140,5700,61,0,4,2380,6940
3.155e+05,2015,386,3,1,1300,12600,1,0,0,4,7,1300,0,1969,1969,98072,47.742,122.1,1480,13530,46,0,4,2780,14830
2.575e+05,2014,265,3,2,1140,7078,1,0,0,4,7,1140,0,1991,1991,98031,47.406,122.19,1460,7078,23,0,5,2600,8218
7.7995e+05,2014,277,4,2.75,2990,4298,2,0,0,3,9,2990,0,2014,2014,98052,47.71,122.11,2990,4837,0,0,6.75,5980,7827
7e+05,2015,463,4,3.25,3580,43093,1,0,0,4,8,3580,0,1990,1990,98024,47.559,121.9,2070,43093,25,0,7.25,5650,46673
1.45e+06,2015,422,4,2.75,2750,17789,1,0,0,3,8,1980,770,1914,1992,98004,47.614,122.21,3060,11275,101,1,6.75,5810,14025
2e+05,2014,170,2,1,860,6600,1,0,0,5,6,860,0,1949,1949,98168,47.488,122.32,1030,6732,65,0,3,1890,7592
3.15e+05,2015,407,3,1.75,1890,10661,1,0,0,5,7,1460,430,1978,1978,98038,47.358,122.06,1680,9604,37,0,4.75,3570,11494
1.875e+05,2014,167,3,1.5,1180,7000,1,0,0,4,7,1180,0,1977,1977,98023,47.297,122.37,1180,7370,37,0,4.5,2360,8550
5.35e+05,2014,148,3,2.5,1720,4006,2,0,0,3,8,1720,0,1994,1994,98029,47.569,122.01,1780,3974,20,0,5.5,3500,5694
9.85e+05,2014,306,2,2.5,2720,26761,2,1,4,3,7,2720,0,1990,1990,98166,47.45,122.38,1870,12396,24,0,4.5,4590,15116
3.73e+05,2014,305,3,1.75,1850,9655,1,0,0,3,7,1100,750,1959,1959,98155,47.736,122.32,1480,8683,55,0,4.75,3330,10533
6.6e+05,2014,156,3,1.75,1980,3300,1,0,0,4,7,1140,840,1926,1926,98115,47.673,122.3,1590,5000,88,0,4.75,3570,6980
2.754e+05,2014,278,2,1,890,8180,1,0,0,3,7,890,0,1947,1947,98155,47.737,122.3,1130,8180,67,0,3,2020,9070
4.3e+05,2015,447,3,1.75,1540,8100,1,0,0,4,7,940,600,1947,1947,98133,47.749,122.35,1840,8100,68,0,4.75,3380,9640
2.225e+06,2015,443,4,4.25,4700,10800,2,0,1,3,11,3910,790,2002,2002,98033,47.688,122.21,2370,7680,13,0,8.25,7070,12380
2.469e+05,2015,401,3,1.5,1370,9800,1,0,0,5,7,1370,0,1968,1968,98001,47.307,122.27,1370,9800,47,0,4.5,2740,11170
4.45e+05,2014,353,3,2.5,2790,16173,2,0,0,3,10,2790,0,1988,1988,98023,47.304,122.34,2890,11632,26,0,5.5,5680,14422
3.325e+05,2014,196,3,1,1030,8164,1,0,0,4,7,1030,0,1950,1950,98133,47.735,122.33,1340,8164,64,0,4,2370,9194
4.14e+05,2014,265,3,2.5,1790,3754,2,0,0,3,8,1790,0,2013,2013,98065,47.534,121.84,1800,3393,1,0,5.5,3590,5183
4.65e+05,2015,433,3,1.75,1730,8073,1,0,0,3,8,1350,380,1971,1971,98177,47.769,122.37,2500,8073,44,0,4.75,4230,9803
6.95e+05,2014,181,3,2,2500,4080,1,0,0,5,7,1680,820,1922,1922,98103,47.681,122.35,1550,3060,92,0,5,4050,5560
4.75e+05,2014,251,4,2.25,2110,7560,2,0,0,4,8,2110,0,1974,1974,98034,47.733,122.18,2110,7560,40,0,6.25,4220,9670
7.31e+05,2014,230,4,2.5,3070,5936,2,0,0,3,9,3070,0,2005,2005,98075,47.59,121.99,3160,5936,9,0,6.5,6230,9006
7.25e+05,2014,198,3,1.75,1530,4000,2,0,0,3,8,1530,0,1985,1985,98136,47.524,122.39,2140,5000,29,0,4.75,3670,6530
2.86e+05,2015,437,3,2.5,1680,4226,2,0,0,3,8,1680,0,2003,2003,98042,47.368,122.12,1800,5559,12,0,5.5,3480,7239
5.26e+05,2014,198,4,1.75,2220,6350,1,0,0,3,7,1110,1110,1959,1959,98125,47.714,122.29,1950,8100,55,0,5.75,4170,10320
4.095e+05,2014,127,4,2.75,2140,13000,1,0,0,3,7,1320,820,1968,1968,98028,47.768,122.25,2360,11000,46,0,6.75,4500,13140
2.41e+05,2015,365,3,1.5,1660,8000,1,0,0,4,7,1120,540,1976,1976,98030,47.353,122.17,1900,7500,39,0,4.5,3560,9160
4.855e+05,2014,269,4,2.5,1800,4500,2,0,0,3,8,1800,0,1999,1999,98075,47.6,122.01,1800,4500,15,0,6.5,3600,6300
4.275e+05,2014,180,2,2,1090,934,3,0,0,3,8,1090,0,2008,2008,98109,47.634,122.34,1090,1376,6,0,4,2180,2466
7.25e+05,2014,283,3,2,1550,12262,1,0,0,4,7,1550,0,1964,1964,98040,47.575,122.22,2900,12372,50,0,5,4450,13922
8.1e+05,2015,444,5,3.25,2950,67475,1,0,0,3,8,2530,420,1981,2004,98072,47.723,122.12,2620,39820,34,1,8.25,5570,42770
6.82e+05,2014,305,4,2.25,2450,34092,2,0,0,4,8,2450,0,1980,1980,98075,47.575,122.05,2410,35378,34,0,6.25,4860,37828
3.12e+05,2015,451,3,2.25,1470,7857,1,0,0,4,7,1180,290,1973,1973,98055,47.455,122.21,1900,7600,42,0,5.25,3370,9070
3.81e+05,2014,211,3,2,1680,8946,1,0,0,3,6,940,740,1996,1996,98053,47.638,121.97,1550,11625,18,0,5,3230,13305
4.47e+05,2014,300,3,2.25,1440,4667,2,0,0,3,7,1440,0,1985,1985,98029,47.566,122.02,1610,4756,29,0,5.25,3050,6196
7.8e+05,2014,215,4,3.25,3900,40962,2,0,0,3,10,3900,0,1991,1991,98053,47.683,122.06,1730,11775,23,0,7.25,5630,15675
3.95e+05,2014,264,4,1.75,1910,8117,1,0,0,3,7,1460,450,1975,1975,98072,47.734,122.17,1810,8100,39,0,5.75,3720,10010
4.98e+05,2014,194,3,2,1620,8400,1,0,0,3,7,1180,440,1968,1968,98052,47.657,122.13,2120,8424,46,0,5,3740,10044
4.55e+05,2014,152,2,1,1170,6000,1,0,0,4,7,970,200,1941,1941,98103,47.699,122.35,2130,6002,73,0,3,3300,7172
3.4e+05,2014,166,3,2.5,1212,1174,3,0,0,3,7,1212,0,2004,2004,98125,47.715,122.31,1256,1226,10,0,5.5,2468,2438
4.87e+05,2015,389,4,2.25,2400,7000,1,0,0,4,8,1800,600,1965,1965,98034,47.721,122.18,2210,7210,50,0,6.25,4610,9610
3.8e+05,2015,450,3,2.25,1530,1305,2,0,0,3,7,1116,414,2007,2007,98177,47.703,122.36,1320,1427,8,0,5.25,2850,2957
5.7e+05,2014,221,3,2.5,3150,20189,2,0,0,3,10,3150,0,1990,1990,98058,47.447,122.09,2920,20612,24,0,5.5,6070,23762
3.25e+05,2014,205,4,2.75,2110,6838,2,0,0,4,8,2110,0,1991,1991,98031,47.388,122.17,2100,7280,23,0,6.75,4210,9390
4.575e+05,2014,147,3,1.75,1840,4030,1,0,0,5,7,1050,790,1925,1925,98108,47.555,122.31,1840,5040,89,0,4.75,3680,6880
5.75e+05,2014,298,7,1.5,2670,11250,1,0,0,4,8,2320,350,1948,1948,98133,47.712,122.33,2030,9000,66,0,8.5,4700,11670
6.225e+05,2014,142,4,2.5,2980,8107,2,0,0,3,9,2980,0,2000,2000,98065,47.539,121.88,2750,7760,14,0,6.5,5730,10740
7e+05,2014,160,5,2.75,3100,9825,2,0,2,4,8,3100,0,1950,1982,98125,47.719,122.28,2120,8400,64,1,7.75,5220,11500
4.85e+05,2014,181,3,2.25,2440,47916,2,0,0,3,8,2090,350,1991,1991,98053,47.635,121.96,2150,24000,23,0,5.25,4590,26440
4.76e+05,2014,321,2,2.25,1140,1332,3,0,0,3,8,1140,0,1999,1999,98103,47.654,122.36,1140,1267,15,0,4.25,2280,2407
8.69e+05,2014,170,4,3,3740,30884,2,0,0,3,9,3060,680,1988,1988,98072,47.751,122.12,3240,37031,26,0,7,6980,40771
7.165e+05,2015,447,3,2.5,2340,2155,2,0,0,3,10,2120,220,2012,2012,98027,47.53,122.07,2640,2680,3,0,5.5,4980,5020
9.8e+05,2014,307,4,3.25,3720,7150,2,0,2,3,11,3720,0,2007,2007,98027,47.536,122.07,4040,7442,7,0,7.25,7760,11162
4.5e+05,2015,415,3,1.5,1340,7200,1,0,0,3,7,1340,0,1972,1972,98034,47.718,122.19,1730,8820,43,0,4.5,3070,10160
3.469e+05,2015,430,4,2.5,1970,5106,2,0,0,3,8,1970,0,1999,1999,98055,47.449,122.2,2230,5109,16,0,6.5,4200,7079
3.7e+05,2015,464,3,1.75,1480,7725,1,0,0,4,7,1480,0,1981,1981,98059,47.483,122.16,1720,8379,34,0,4.75,3200,9859
8.83e+05,2014,164,4,2.5,2960,41656,2,0,0,3,10,2960,0,1985,1985,98072,47.732,122.13,3900,35104,29,0,6.5,6860,38064
2.1e+05,2014,198,2,1,1040,4590,1,0,0,3,7,1040,0,1954,1954,98146,47.508,122.34,1040,6120,60,0,3,2080,7160
1.8e+05,2014,338,3,1,780,3540,1,0,0,2,6,780,0,1920,1920,98118,47.565,122.29,1260,3540,94,0,4,2040,4320
4.025e+05,2014,129,4,2.5,2600,11951,2,0,0,3,10,2600,0,1988,1988,98023,47.305,122.34,2820,12093,26,0,6.5,5420,14693
2.4e+05,2014,194,3,1.5,1010,10350,1,0,0,3,7,1010,0,1969,1969,98032,47.379,122.29,1640,7700,45,0,4.5,2650,8710
3.0764e+05,2014,214,3,2.5,1820,4200,2,0,0,3,8,1820,0,2014,2014,98038,47.369,122.02,2370,4200,0,0,5.5,4190,6020
2.55e+05,2014,345,3,1.5,1320,7980,1,0,0,3,7,1320,0,1956,1956,98178,47.507,122.26,2000,7700,58,0,4.5,3320,9020
3e+05,2015,442,3,1.75,1420,7200,1,0,0,3,7,1000,420,1979,1979,98146,47.507,122.37,1550,8640,36,0,4.75,2970,10060
4.05e+05,2014,125,2,3,1410,1240,2,0,0,3,8,1140,270,2006,2006,98136,47.522,122.39,1410,1273,8,0,5,2820,2683
4.55e+05,2015,422,4,2.5,2710,6558,2,0,0,3,9,2710,0,1997,1997,98058,47.434,122.11,2710,7635,18,0,6.5,5420,10345
2.53e+05,2014,277,3,2.5,2020,6564,1,0,0,3,7,1310,710,1994,1994,98042,47.355,122.16,1710,5151,20,0,5.5,3730,7171
2.18e+05,2014,264,3,1,1140,7560,1,0,0,4,6,1140,0,1958,1958,98058,47.462,122.19,1300,7560,56,0,4,2440,8700
1.05e+06,2015,440,3,3.5,3190,29982,1,0,3,4,8,2630,560,1941,1941,98166,47.458,122.37,2600,19878,74,0,6.5,5790,23068
3.0595e+05,2014,222,4,2.5,2007,4968,2,0,0,3,9,2007,0,2009,2009,98092,47.33,122.19,2189,5852,5,0,6.5,4196,7859
4.28e+05,2015,451,2,2.5,1414,1960,2,0,0,3,8,1414,0,1986,1986,98006,47.542,122.19,1414,2511,29,0,4.5,2828,3925
1.87e+05,2014,189,2,1,840,11600,1,0,0,3,6,840,0,1952,1952,98168,47.492,122.3,1610,9120,62,0,3,2450,9960
5.89e+05,2014,284,4,2.5,2630,15000,2,0,0,5,8,2630,0,1962,1962,98027,47.526,122.03,1770,8700,52,0,6.5,4400,11330
5.82e+05,2014,215,3,2.5,2380,19860,2,0,0,4,8,2380,0,1995,1995,98056,47.526,122.17,2450,10220,19,0,5.5,4830,12600
2.29e+05,2014,221,3,1.5,1200,5000,1,0,0,3,6,1200,0,1979,1979,98146,47.512,122.36,1440,2500,35,0,4.5,2640,3700
4.4e+05,2014,332,4,2.25,2600,28600,1,0,0,3,8,1810,790,1968,1968,98072,47.776,122.14,2580,26950,46,0,6.25,5180,29550
6.75e+05,2014,230,3,2,1010,5973,1,0,0,5,6,1010,0,1942,1942,98033,47.665,122.2,1920,6015,72,0,5,2930,7025
3.5995e+05,2014,286,4,2.75,2260,5705,2,0,0,3,8,2260,0,2014,2014,98042,47.373,122.16,2260,5727,0,0,6.75,4520,7987
3.055e+05,2014,347,3,1,1240,6090,1,0,0,4,7,1240,0,1950,1950,98155,47.754,122.31,1550,9096,64,0,4,2790,10336
4.5e+05,2015,480,4,1.75,1740,12204,1,0,0,3,7,1270,470,1961,1961,98155,47.767,122.28,2190,12204,54,0,5.75,3930,13944
5.25e+05,2014,285,4,1.75,2540,7200,1,0,0,4,7,1270,1270,1947,1947,98118,47.558,122.27,1650,7200,67,0,5.75,4190,9740
2.1e+05,2014,153,3,1,1110,7962,1,0,0,3,7,1110,0,1962,1962,98146,47.504,122.36,1200,8094,52,0,4,2310,9204
4.89e+05,2015,373,2,2.25,1290,1334,3,0,0,3,8,1290,0,2007,2007,98107,47.672,122.38,1350,1334,8,0,4.25,2640,2624
4.47e+05,2014,177,2,1,1320,8380,1,0,0,3,7,1320,0,1953,1953,98177,47.705,122.37,1290,8025,61,0,3,2610,9345
2.4995e+05,2014,225,3,1,1370,11658,1,0,0,4,6,1370,0,1958,1958,98058,47.458,122.18,1080,9198,56,0,4,2450,10568
5.47e+05,2015,375,5,3,2200,1.0324e+05,1,0,0,3,7,1160,1040,1971,1971,98072,47.773,122.11,2300,1.0324e+05,44,0,8,4500,1.0544e+05
1.62e+06,2014,348,3,3.5,3490,4000,2,0,0,3,9,2570,920,2009,2009,98112,47.639,122.28,1880,4000,5,0,6.5,5370,7490
5.35e+05,2014,215,4,2.25,1890,3615,2,0,0,3,7,1890,0,2005,2005,98029,47.549,122,1630,3280,9,0,6.25,3520,5170
7.39e+05,2014,226,5,2.5,2840,5000,1,0,0,4,7,1620,1220,1913,1913,98144,47.582,122.29,2200,5000,101,0,7.5,5040,7840
1.925e+05,2014,168,3,1,1080,8580,1,0,0,3,6,1080,0,1900,1900,98168,47.472,122.26,1800,12672,114,0,4,2880,13752
6.565e+05,2014,162,4,2,2710,4750,1,0,0,4,7,1460,1250,1919,1919,98115,47.676,122.31,1700,3800,95,0,6,4410,6510
8.78e+05,2014,277,4,2.5,3480,13421,2,0,0,3,11,3480,0,1995,1995,98027,47.55,122.1,3290,9642,19,0,6.5,6770,13122
5.25e+05,2014,230,4,2.5,2840,4750,2,0,0,3,9,2840,0,2002,2002,98058,47.451,122.12,2460,4750,12,0,6.5,5300,7590
1.0409e+06,2014,299,5,4,4180,7232,2,0,0,3,9,4180,0,2014,2014,98052,47.705,122.13,3570,6054,0,0,9,7750,10234
2.8e+05,2014,252,3,2.25,1610,10454,1,0,0,3,7,1610,0,1977,1977,98148,47.452,122.33,1720,9583,37,0,5.25,3330,11193
6.8e+05,2015,393,4,2.5,2700,37431,1,0,0,4,8,1600,1100,1978,1978,98072,47.726,122.12,2290,37431,37,0,6.5,4990,40131
3.38e+05,2014,306,4,1.75,1530,8152,1,0,0,5,6,910,620,1948,1948,98155,47.756,122.33,1310,8152,66,0,5.75,2840,9682
4.6e+05,2014,331,2,1,1430,12092,1,0,0,4,7,1430,0,1938,1938,98125,47.702,122.28,2320,10800,76,0,3,3750,12230
5.64e+05,2014,300,4,1,1170,4590,1,0,0,4,7,1170,0,1925,1925,98115,47.68,122.31,1430,4080,89,0,5,2600,5250
5.65e+05,2014,154,5,2.5,2650,11455,1,0,0,3,7,1400,1250,1961,1961,98008,47.614,122.12,1960,9880,53,0,7.5,4610,12530
4.35e+05,2014,214,3,2.5,2370,6082,2,0,0,3,7,2370,0,2004,2004,98065,47.529,121.85,2690,6152,10,0,5.5,5060,8522
7.05e+05,2014,211,4,2.75,2780,6207,2,0,0,3,8,2780,0,2001,2001,98053,47.687,122.04,2660,5592,13,0,6.75,5440,8372
2.21e+05,2014,292,3,2.5,1320,1780,2,0,0,3,7,880,440,2005,2005,98118,47.528,122.27,3040,6000,9,0,5.5,4360,7320
6.25e+05,2014,238,3,2.5,2000,6341,1,0,0,5,8,1040,960,1981,1981,98116,47.564,122.4,2030,6341,33,0,5.5,4030,8341
4.278e+05,2014,314,3,1.75,1340,13241,1,0,2,3,7,1340,0,1985,1985,98034,47.727,122.21,2090,9704,29,0,4.75,3430,11044
4.388e+05,2015,456,4,2.5,2770,4432,2,0,0,3,9,2770,0,2004,2004,98058,47.454,122.12,2770,5423,11,0,6.5,5540,8193
6.8e+05,2014,266,4,2.5,3030,13068,2,0,0,3,9,3030,0,1978,1978,98005,47.631,122.17,2940,11999,36,0,6.5,5970,15029
1.85e+06,2015,465,4,2.5,3830,11972,1,1,4,3,11,2370,1460,1981,1981,98155,47.74,122.28,3080,12297,34,0,6.5,6910,16127
5.15e+05,2015,446,5,3,2530,5105,1,0,0,3,8,1520,1010,2005,2005,98133,47.755,122.34,2290,4011,10,0,8,4820,6541
5.8e+05,2014,148,5,2,1940,6000,1,0,0,5,7,970,970,1945,1945,98115,47.688,122.29,1700,6000,69,0,7,3640,7940
5.18e+05,2014,139,3,2.5,1680,2096,2,0,0,3,8,1380,300,2008,2008,98117,47.69,122.37,1360,2096,6,0,5.5,3040,3776
1.9e+05,2014,360,3,1,1640,8100,1,0,0,3,6,1040,600,1939,1939,98146,47.482,122.34,1600,8100,75,0,4,3240,9740
5.43e+05,2015,447,2,1,1070,4700,1,0,0,5,7,1070,0,1910,1910,98117,47.689,122.37,1370,4700,105,0,3,2440,5770
5e+05,2014,359,3,2.25,2210,7916,2,0,0,3,8,2210,0,1978,1978,98133,47.718,122.34,1450,7955,36,0,5.25,3660,10165
5.64e+05,2015,464,5,2.25,2140,8700,1,0,2,3,8,1220,920,1962,1962,98115,47.697,122.31,1720,6670,53,0,7.25,3860,8810
1.85e+05,2014,359,3,1.75,1130,7000,1,0,0,3,7,1130,0,1978,1978,98023,47.307,122.37,1830,8880,36,0,4.75,2960,10010
4.35e+05,2014,252,4,2.5,1700,6380,1,0,0,4,7,850,850,1940,1940,98115,47.699,122.32,1380,6380,74,0,6.5,3080,8080
9.05e+05,2014,324,4,3,3370,47959,2,0,0,4,10,3370,0,1981,1981,98072,47.733,122.13,3370,38896,33,0,7,6740,42266
4.29e+05,2014,249,2,1,1080,3600,1,0,0,3,7,1080,0,1922,1922,98122,47.608,122.29,2230,4500,92,0,3,3310,5580
3.65e+05,2015,441,3,2,2030,8649,1,0,0,3,7,2030,0,1998,1998,98056,47.508,122.17,1760,7200,17,0,5,3790,9230
5.2513e+05,2014,258,5,2.25,1950,8025,1,0,2,3,7,1150,800,1960,1960,98008,47.616,122.11,1780,8560,54,0,7.25,3730,10510
6.775e+05,2014,292,5,1,2340,4730,2,0,0,3,8,1810,530,1918,1918,98116,47.59,122.39,2100,4970,96,0,6,4440,7310
2.47e+05,2014,287,3,1.75,1820,8740,1,0,0,4,8,1820,0,1987,1987,98023,47.307,122.39,2210,8320,27,0,4.75,4030,10140
2.675e+05,2015,467,3,2.5,1400,7629,1,0,0,3,7,1120,280,1988,1988,98030,47.379,122.18,1530,7688,27,0,5.5,2930,9088
2.45e+05,2014,231,3,2,1490,7929,1,0,0,3,7,1490,0,1989,1989,98002,47.288,122.22,1650,7929,25,0,5,3140,9419
1.13e+06,2014,291,4,3.5,4300,8406,2,0,1,3,11,3580,720,1987,1987,98040,47.54,122.21,2770,10006,27,0,7.5,7070,14306
4.87e+05,2015,451,2,1.5,1160,1118,2,0,0,3,8,1020,140,2007,2007,98117,47.675,122.38,1210,1118,8,0,3.5,2370,2278
9.599e+05,2014,226,4,3.75,3550,15151,2,0,0,3,11,3550,0,2004,2004,98075,47.589,121.97,4340,15151,10,0,7.75,7890,18701
3.1e+05,2014,127,3,1.75,1840,10723,1,0,0,4,7,1220,620,1974,1974,98058,47.429,122.15,1590,9820,40,0,4.75,3430,11660
2.925e+05,2014,353,4,2.5,1860,8709,2,0,0,3,8,1860,0,1994,1994,98092,47.329,122.17,1990,6825,20,0,6.5,3850,8685
1.135e+06,2014,356,4,4.25,4590,17621,2,0,0,3,10,3160,1430,2003,2003,98033,47.697,122.2,3800,12268,11,0,8.25,8390,16858
2.6e+05,2014,314,3,2.5,1520,6298,2,0,0,3,7,1520,0,1986,1986,98030,47.369,122.18,1670,7207,28,0,5.5,3190,8727
2.7e+05,2014,175,2,1,2060,8398,1,0,0,3,7,1260,800,1962,1962,98168,47.509,122.32,1690,13495,52,0,3,3750,15555
3.86e+05,2014,221,4,2.5,2810,11897,2,0,0,3,8,2810,0,2003,2003,98092,47.325,122.19,1770,4240,11,0,6.5,4580,7050
5.99e+05,2014,148,4,2.75,2020,2750,1,0,0,3,8,1010,1010,1917,2014,98122,47.605,122.29,1840,4000,97,1,6.75,3860,6020
1.35e+05,2015,433,4,1,1460,18599,1,0,0,3,5,1460,0,1940,1940,98146,47.501,122.35,1320,8100,75,0,5,2780,9560
3.85e+05,2014,155,3,2.25,1710,11500,1,0,0,3,7,1210,500,1978,1978,98028,47.767,122.27,1800,11500,36,0,5.25,3510,13210
2.53e+05,2014,127,3,1.75,1250,10122,1,0,0,3,7,1250,0,1994,1994,98010,47.328,122,1980,10175,20,0,4.75,3230,11425
8e+05,2014,338,3,1.75,1890,10292,1,0,0,4,8,1890,0,1969,1969,98040,47.535,122.23,2630,10625,45,0,4.75,4520,12515
7.3e+05,2015,381,3,2.5,1860,1290,2,0,0,3,9,1240,620,2010,2010,98122,47.618,122.3,1710,1525,5,0,5.5,3570,3385
1.8e+05,2014,231,3,1,840,5700,1,0,0,4,5,840,0,1945,1945,98038,47.395,122.03,1430,12600,69,0,4,2270,13440
5.54e+05,2014,190,2,2,1670,4996,1,0,0,3,8,1670,0,2004,2004,98053,47.714,122.03,1670,4996,10,0,4,3340,6666
5.3e+05,2015,429,5,2.25,2720,8800,1,0,0,4,7,1500,1220,1958,1958,98008,47.598,122.12,2110,8800,57,0,7.25,4830,11520
2.16e+05,2015,399,2,1,710,5120,1,0,0,3,6,710,0,1918,1918,98106,47.522,122.36,1150,1252,97,0,3,1860,1962
3.31e+05,2014,229,2,1,1480,6210,1,0,0,3,7,1080,400,1950,1950,98133,47.774,122.35,1290,7509,64,0,3,2770,8989
2.25e+05,2015,485,2,1,1070,6000,1,0,0,4,5,1070,0,1922,1922,98178,47.495,122.23,1910,6000,93,0,3,2980,7070
5.498e+05,2014,211,3,2.25,1580,11680,1,0,0,4,7,1580,0,1958,1958,98005,47.587,122.17,2270,10948,56,0,5.25,3850,12528
3.75e+05,2015,376,3,1.75,1430,8412,1,0,0,4,7,1070,360,1928,1928,98125,47.722,122.3,1490,8410,87,0,4.75,2920,9840
3.75e+05,2014,181,3,1.75,2530,35150,1,0,0,4,7,1800,730,1977,1977,98042,47.391,122.12,2460,36386,37,0,4.75,4990,38916
4.75e+05,2014,169,3,2.5,950,1110,2,0,0,3,8,950,0,2003,2003,98102,47.623,122.32,1230,1215,11,0,5.5,2180,2165
2.3e+05,2014,300,6,3,2180,7220,2,0,0,3,7,2180,0,1980,1980,98003,47.305,122.31,2260,7344,34,0,9,4440,9524
3.28e+05,2014,306,3,1.75,1470,7650,1,0,0,3,7,1130,340,1983,1983,98059,47.482,122.16,1590,7500,31,0,4.75,3060,8970
2.37e+05,2014,155,3,1,1130,10650,1,0,0,3,7,1130,0,1954,1954,98188,47.436,122.29,1320,10650,60,0,4,2450,11780
2.47e+05,2014,313,3,2,1270,7198,1,0,0,3,7,1270,0,1916,2013,98022,47.209,122,1160,7198,98,1,5,2430,8468
2.76e+05,2015,446,2,1,720,4000,1,0,0,3,6,720,0,1918,1918,98106,47.535,122.35,1630,4000,97,0,3,2350,4720
3.2e+05,2014,176,2,1,950,5316,1,0,2,3,7,950,0,1948,1948,98126,47.57,122.38,1620,6085,66,0,3,2570,7035
4.53e+05,2014,255,3,1,1210,9473,1,0,0,5,7,1210,0,1955,1955,98006,47.564,122.14,1700,11465,59,0,4,2910,12675
3.8e+05,2014,237,4,2.5,2270,11500,1,0,0,3,8,1540,730,1967,1967,98034,47.709,122.24,2020,10918,47,0,6.5,4290,13188
3.36e+05,2014,188,3,2.25,2760,10160,1,0,0,3,8,2760,0,1969,1969,98058,47.45,122.15,2760,9600,45,0,5.25,5520,12360
5.8e+05,2014,125,2,1,2540,7000,1,0,0,5,8,1320,1220,1942,1942,98118,47.526,122.26,2160,6000,72,0,3,4700,8540
4.5995e+05,2014,218,4,1.75,2430,9747,1,0,0,3,8,1780,650,1974,1974,98155,47.769,122.28,2340,10296,40,0,5.75,4770,12726
3.25e+05,2014,209,4,2.5,2230,8500,2,0,0,3,8,2230,0,1994,1994,98022,47.208,122.01,2270,8770,20,0,6.5,4500,11000
4.5e+05,2014,278,4,1.75,1640,1480,1,0,0,4,7,820,820,1912,1912,98105,47.668,122.31,1420,2342,102,0,5.75,3060,3982
4.75e+05,2015,441,3,1,1270,4268,1,0,0,3,7,1270,0,1921,1921,98117,47.685,122.39,1310,4080,94,0,4,2580,5350
6.7e+05,2014,290,3,2.5,1800,4763,2,0,0,3,7,1240,560,1985,1985,98119,47.646,122.36,1790,4763,29,0,5.5,3590,6563
2.8825e+05,2015,478,3,1.75,2110,15400,1,0,0,3,7,1380,730,1963,1963,98178,47.486,122.23,2110,9800,52,0,4.75,4220,11910
5.35e+05,2014,259,2,1.5,1940,5700,1,0,0,3,7,970,970,1937,1937,98117,47.688,122.37,1250,5700,77,0,3.5,3190,7640
3.89e+05,2015,464,3,1.75,1820,8028,1,0,0,3,7,1220,600,1980,1980,98133,47.747,122.36,1940,11100,35,0,4.75,3760,12920
4.25e+05,2014,181,3,2.5,1950,5689,2,0,0,3,7,1950,0,2009,2009,98065,47.516,121.87,2190,5653,5,0,5.5,4140,7603
2.8928e+05,2014,221,3,2,2860,24046,1,0,0,3,9,1700,1160,1985,1985,98019,47.772,121.9,1460,13648,29,0,5,4320,16508
4.4e+05,2014,347,4,2.5,2798,5085,2,0,0,3,9,2798,0,2011,2011,98092,47.331,122.19,2502,5707,3,0,6.5,5300,8505
3.1289e+05,2014,173,5,3,2300,8214,2,0,0,3,8,2300,0,2013,2013,98001,47.305,122.28,2594,4950,1,0,8,4894,7250
7.2e+05,2014,265,4,2.25,2530,5200,1,0,1,4,8,1530,1000,1957,1957,98117,47.699,122.38,2240,5200,57,0,6.25,4770,7730
6.37e+05,2014,217,3,2,1980,6000,1,0,0,4,7,1380,600,1958,1958,98115,47.692,122.28,1260,6000,56,0,5,3240,7980
2.75e+05,2014,244,3,1.5,1950,7620,1,0,0,4,7,1010,940,1956,1956,98166,47.459,122.35,1850,7620,58,0,4.5,3800,9570
1.85e+05,2014,307,3,1.5,1010,7755,1,0,0,3,6,1010,0,1953,1953,98148,47.424,122.33,1270,8350,61,0,4.5,2280,9360
5.885e+05,2014,122,3,1.75,2330,14892,1,0,0,3,8,1970,360,1980,1980,98074,47.627,122.05,2570,14217,34,0,4.75,4900,16547
2.32e+05,2015,412,3,1,1400,10403,1,0,0,4,6,1400,0,1976,1976,98038,47.362,122.03,1230,10209,39,0,4,2630,11609
2.4e+06,2015,445,4,4.25,4890,15188,2,0,2,3,11,3090,1800,1999,1999,98040,47.56,122.23,3470,16201,16,0,8.25,8360,21091
1.32e+06,2014,209,4,3.25,3470,11843,1,0,3,3,11,2270,1200,1989,1989,98006,47.551,122.14,3910,13247,25,0,7.25,7380,16717
3.55e+05,2015,487,5,2.5,3220,5806,2,0,0,3,8,3220,0,2002,2002,98042,47.371,122.1,2760,5813,13,0,7.5,5980,9033
3.05e+05,2014,209,3,2.5,1260,1622,3,0,0,3,8,1260,0,2009,2009,98133,47.733,122.34,1340,1188,5,0,5.5,2600,2448
7.8e+05,2015,446,4,2.25,2260,16188,1,0,0,3,10,2260,0,1984,1984,98006,47.564,122.11,2840,10158,31,0,6.25,5100,12418
2.4e+05,2015,474,3,2,1553,6550,1,0,0,3,7,1553,0,1900,2001,98022,47.206,121.99,1010,10546,115,1,5,2563,12099
5.099e+05,2014,125,3,2.5,1790,2700,2,0,0,3,8,1790,0,2010,2010,98027,47.564,122.09,1890,3078,4,0,5.5,3680,4868
4.43e+05,2015,456,3,1.75,1530,8028,1,0,0,3,7,1200,330,1967,1967,98177,47.777,122.36,1530,8028,48,0,4.75,3060,9558
3.85e+05,2015,425,3,2.5,1520,1488,3,0,0,3,8,1520,0,2006,2006,98125,47.734,122.31,1520,1497,9,0,5.5,3040,3017
4.1295e+05,2015,443,4,2.5,2430,6796,2,0,0,3,8,2430,0,1993,1993,98058,47.45,122.13,2450,8400,22,0,6.5,4880,10830
2.7e+05,2014,159,4,2.75,1990,7252,1,0,0,3,7,1270,720,1999,1999,98002,47.284,122.2,2100,7535,15,0,6.75,4090,9525
3.55e+05,2014,326,3,1.5,1240,15867,1,0,0,3,7,1240,0,1962,1962,98034,47.717,122.2,1570,9600,52,0,4.5,2810,10840
2.87e+05,2014,169,3,2,1300,11374,1,0,0,5,7,1300,0,1933,1933,98168,47.484,122.3,1480,9670,81,0,5,2780,10970
6.21e+05,2014,293,3,1,1340,4000,1,0,0,4,7,1340,0,1927,1927,98105,47.665,122.29,1510,4000,87,0,4,2850,5340
3.1e+05,2014,173,3,2.5,2540,4775,2,0,0,3,7,2540,0,2006,2006,98042,47.334,122.05,2270,5000,8,0,5.5,4810,7540
2.3e+05,2014,273,3,1.5,1630,6625,1,0,0,5,7,980,650,1980,1980,98023,47.29,122.37,1440,7145,34,0,4.5,3070,8775
1.295e+06,2015,488,5,3.75,3490,15246,1,0,1,4,10,1940,1550,1968,1968,98040,47.548,122.21,3410,15682,47,0,8.75,6900,19172
5.55e+05,2014,270,2,2.25,1160,954,2,0,0,3,8,960,200,2014,2014,98105,47.665,122.28,1160,1327,0,0,4.25,2320,2487
6.07e+05,2014,225,3,2,2060,4080,1,0,0,5,7,1060,1000,1921,1921,98144,47.574,122.29,1400,4080,93,0,5,3460,6140
3.65e+05,2014,168,3,2.5,2640,6715,2,0,0,3,8,1680,960,1991,1991,98058,47.441,122.13,2260,7373,23,0,5.5,4900,10013
2.21e+05,2014,222,3,2.25,1430,5999,2,0,0,3,7,1430,0,1987,1987,98023,47.312,122.36,1600,5999,27,0,5.25,3030,7429
5.72e+05,2014,242,3,1.5,1680,13751,1,0,0,4,7,1680,0,1951,1951,98040,47.572,122.23,1760,13500,63,0,4.5,3440,15180
2.15e+05,2014,340,3,2.5,1322,6006,2,0,0,3,7,1322,0,2009,2009,98001,47.271,122.25,1440,6796,5,0,5.5,2762,8118
3.285e+05,2014,298,4,3,2290,8250,2,0,0,3,9,2290,0,1990,1990,98042,47.374,122.16,2290,8250,24,0,7,4580,10540
6.33e+05,2014,183,4,2.5,2360,10000,1,0,3,3,8,1980,380,1977,1977,98126,47.573,122.37,2480,5000,37,0,6.5,4840,7360
6.4995e+05,2014,269,3,2.75,1670,1350,3,0,0,3,9,1350,320,2014,2014,98116,47.576,122.41,1520,4800,0,0,5.75,3190,6470
7.25e+05,2015,486,4,1.75,2350,7574,1,0,0,3,8,1720,630,1979,1979,98027,47.563,122.09,2220,8496,36,0,5.75,4570,10846
4.9995e+05,2014,147,3,3.5,1820,1501,2,0,0,3,8,1430,390,2014,2014,98144,47.596,122.3,1550,1501,0,0,6.5,3370,3321
4.31e+05,2015,408,3,1,1810,7200,1,0,0,4,7,1130,680,1954,1954,98133,47.749,122.35,1810,8100,61,0,4,3620,9910
4.6094e+05,2014,277,4,2.5,3202,4964,2,0,0,3,9,3202,0,2014,2014,98030,47.341,122.18,2425,4886,0,0,6.5,5627,8088
8e+05,2014,175,2,1,1740,5719,1,0,0,3,8,1740,0,1955,1955,98103,47.673,122.33,1980,5000,59,0,3,3720,6740
2.39e+05,2014,194,2,1,710,14000,1,0,0,4,6,710,0,1953,1953,98166,47.438,122.34,1500,10540,61,0,3,2210,11250
1.017e+06,2015,438,3,2.5,2605,2216,2,0,2,4,9,2090,515,1979,1979,98033,47.653,122.2,2605,1979,36,0,5.5,5210,4584
3.795e+05,2015,413,4,2.5,2560,5102,2,0,0,3,8,2560,0,2013,2013,98092,47.34,122.18,2586,5059,2,0,6.5,5146,7619
4.29e+05,2014,298,5,2.5,2720,8120,1,0,0,3,7,1360,1360,1970,1970,98108,47.557,122.31,2020,8120,44,0,7.5,4740,10840
5.5995e+05,2015,413,5,2.75,2990,6370,2,0,0,3,8,2990,0,2014,2014,98059,47.485,122.15,2730,5740,1,0,7.75,5720,8730
2.99e+05,2014,266,4,2.5,1950,3000,2,0,0,3,7,1950,0,2002,2002,98178,47.498,122.23,1170,6000,12,0,6.5,3120,7950
5.23e+05,2014,338,3,1.75,3000,5413,2,0,0,4,8,1900,1100,1963,1963,98115,47.696,122.31,1550,5413,51,0,4.75,4550,8413
6.555e+05,2014,126,4,3.5,3380,8330,2,0,0,3,8,3380,0,2000,2000,98177,47.774,122.38,2220,8330,14,0,7.5,5600,11710
8.95e+05,2014,156,4,3,3240,5562,2,0,0,3,10,3240,0,2013,2013,98075,47.592,121.97,3380,5562,1,0,7,6620,8802
3.36e+05,2015,457,3,1.5,1240,5000,1,0,2,3,7,1240,0,1964,1964,98106,47.566,122.36,1050,5000,51,0,4.5,2290,6240
4.97e+05,2014,258,3,2.25,1460,1353,2,0,0,3,8,1050,410,2012,2012,98116,47.577,122.41,1690,3776,2,0,5.25,3150,5236
3.91e+05,2015,457,3,2.5,1800,1120,2,0,0,3,8,1800,0,2011,2011,98126,47.544,122.37,1800,2380,4,0,5.5,3600,4180
4.375e+05,2014,232,2,1.5,1210,1232,3,0,0,3,8,1210,0,2007,2007,98107,47.671,122.39,1330,1174,7,0,3.5,2540,2384
5.25e+05,2015,478,3,2.25,1960,12350,1,0,0,4,7,1960,0,1961,1961,98027,47.525,122.05,1920,13608,54,0,5.25,3880,15568
7.17e+05,2014,277,4,2.5,2540,4241,2,0,0,3,8,2540,0,2009,2009,98052,47.707,122.11,3010,4929,5,0,6.5,5550,7469
1.99e+05,2014,198,3,1,1390,12145,1,0,0,4,7,1390,0,1964,1964,98042,47.422,122.15,1030,10800,50,0,4,2420,12190
2.7195e+05,2015,447,3,1.5,1220,8400,1,0,0,4,7,1220,0,1962,1962,98006,47.547,122.17,2110,9119,53,0,4.5,3330,10339
2.3e+05,2015,407,3,1,1000,4000,1,0,0,4,6,1000,0,1915,1915,98118,47.552,122.29,1040,4240,100,0,4,2040,5240
6.1575e+05,2014,235,4,2,2140,6360,2,0,0,3,7,1840,300,1945,1945,98115,47.687,122.29,1690,6360,69,0,6,3830,8500
5.6e+05,2014,278,3,1,1140,7028,1,0,0,3,8,1140,0,1931,1931,98115,47.695,122.32,1350,6923,83,0,4,2490,8063
3e+05,2015,376,3,1,1490,7200,1,0,0,3,7,1490,0,1954,1954,98125,47.728,122.31,1280,7200,61,0,4,2770,8690
1.31e+06,2014,325,5,3,3650,16600,1,0,3,4,9,1860,1790,1978,1978,98006,47.56,122.14,3150,10400,36,0,8,6800,14050
4.85e+05,2014,181,4,1.75,1430,4096,2,0,0,3,7,1430,0,1900,1900,98122,47.604,122.31,1640,3377,114,0,5.75,3070,4807
2.02e+05,2014,194,1,0.75,590,5650,1,0,0,3,6,590,0,1944,1944,98118,47.518,122.27,980,5650,70,0,1.75,1570,6240
2.9e+05,2015,432,4,2,1560,8800,2,0,0,5,6,1560,0,1942,1967,98168,47.493,122.31,1480,10000,73,1,6,3040,11560
2.915e+05,2015,464,3,1.75,1260,9600,1,0,0,4,7,1260,0,1988,1988,98042,47.359,122.08,1640,9946,27,0,4.75,2900,11206
3.55e+05,2015,474,2,1.75,1620,3640,1,0,0,3,7,900,720,1929,1929,98108,47.543,122.3,1590,5538,86,0,3.75,3210,7158
3e+06,2014,221,3,3.5,4410,10756,2,1,4,3,11,3430,980,2014,2014,98056,47.528,122.2,3550,5634,0,0,6.5,7960,10044
1e+06,2015,456,3,1,1540,24500,1,0,0,3,7,1540,0,1949,1949,98125,47.721,122.29,1540,7250,66,0,4,3080,8790
7.1341e+05,2014,294,3,2.5,2830,6000,1,0,3,3,9,1730,1100,1954,1954,98126,47.575,122.38,2040,5300,60,0,5.5,4870,8130
3.3e+05,2014,223,4,2.5,2080,7000,1,0,0,4,8,1400,680,1989,1989,98058,47.425,122.16,2090,7082,25,0,6.5,4170,9162
2.34e+05,2014,153,2,1,940,5375,1,0,0,4,5,940,0,1952,1952,98198,47.421,122.32,1200,7500,62,0,3,2140,8440
3.55e+05,2014,305,2,1.75,1760,4600,1,0,0,4,7,850,910,1926,1926,98126,47.565,122.37,1150,4800,88,0,3.75,2910,6560
2.6495e+05,2014,340,3,1.5,1400,10853,1,0,0,4,7,1400,0,1964,1964,98055,47.443,122.19,1620,10849,50,0,4.5,3020,12249
2.67e+05,2014,168,3,2.25,1584,2800,2,0,0,3,7,1584,0,2012,2012,98002,47.345,122.21,1584,2800,2,0,5.25,3168,4384
7.999e+05,2014,257,4,4,3650,18223,2,0,3,3,9,3330,320,2013,2013,98006,47.544,122.12,3220,11022,1,0,8,6870,14672
1.095e+06,2014,166,4,4,3530,8400,2,0,0,5,8,2630,900,1958,1958,98199,47.64,122.39,2340,8216,56,0,8,5870,11746
2.2e+05,2015,407,4,1.75,1910,8171,1,0,0,3,7,1910,0,1986,1986,98030,47.35,122.17,1910,7542,29,0,5.75,3820,9452
7.05e+05,2014,198,2,1.75,2320,6755,1,0,0,5,8,1380,940,1946,1946,98199,47.64,122.4,1990,5000,68,0,3.75,4310,7320
3.5e+05,2014,223,3,2,1320,1298,3,0,0,3,7,1320,0,1995,1995,98117,47.696,122.38,1380,1503,19,0,5,2700,2823
2.96e+05,2014,264,3,2.5,1560,5845,2,0,0,3,7,1560,0,2003,2003,98038,47.385,122.03,1860,5752,11,0,5.5,3420,7312
4.075e+05,2015,466,2,1,770,6017,1,0,0,3,7,770,0,1950,1950,98125,47.722,122.32,1670,7500,65,0,3,2440,8270
2.45e+05,2014,270,2,1,820,7475,1,0,0,3,6,820,0,1945,1945,98133,47.732,122.34,1030,5720,69,0,3,1850,6540
4.43e+05,2014,361,3,2.5,1780,2778,2,0,0,3,8,1530,250,2007,2007,98126,47.549,122.37,1380,1998,7,0,5.5,3160,3778
3.1e+05,2015,414,2,1,770,8149,1,0,0,4,6,770,0,1948,1948,98155,47.744,122.3,820,8149,67,0,3,1590,8919
1.2e+06,2014,238,4,3.25,3850,19842,2,0,3,3,11,3180,670,1989,1989,98074,47.624,122.06,4320,19500,25,0,7.25,8170,23350
2.5e+05,2014,126,3,1,1050,6874,1,0,0,3,6,1050,0,1954,1954,98133,47.762,122.36,1500,8954,60,0,4,2550,10004
6.8e+05,2014,214,3,2.25,2920,6300,1,0,0,3,8,1710,1210,1956,1956,98177,47.706,122.37,1940,6300,58,0,5.25,4860,9220
3.05e+05,2014,305,4,2.25,1950,7700,1,0,0,3,8,1350,600,1979,1979,98058,47.444,122.13,2150,7350,35,0,6.25,4100,9300
2.04e+05,2015,422,2,2.5,1090,13444,2,0,0,3,7,1090,0,2007,2007,98198,47.417,122.32,1380,6000,8,0,4.5,2470,7090
4.3e+05,2015,459,3,2.5,2075,39553,1,0,0,3,7,2075,0,2012,2012,98038,47.36,122.03,1960,9047,3,0,5.5,4035,11122
3.625e+05,2014,290,5,2,2330,8586,1,0,0,4,7,1270,1060,1961,1961,98133,47.767,122.33,1550,8287,53,0,7,3880,10617
2.55e+05,2015,425,3,1,1010,11880,1,0,0,3,7,1010,0,1960,1960,98030,47.376,122.22,1150,9435,55,0,4,2160,10445
3.84e+05,2014,259,4,1.75,2100,7135,1,0,0,4,7,1050,1050,1955,1955,98106,47.535,122.35,1730,4000,59,0,5.75,3830,6100
3.9895e+05,2014,221,4,3,3000,10297,2,0,0,3,8,3000,0,2003,2003,98042,47.368,122.07,2520,8366,11,0,7,5520,11366
9.15e+05,2014,339,5,2.75,2580,7630,1,0,0,4,7,1730,850,1954,1954,98004,47.623,122.2,2040,7717,60,0,7.75,4620,10297
2.08e+05,2014,272,4,2.75,1810,8677,1,0,0,3,7,1810,0,1962,1962,98198,47.367,122.31,1740,8677,52,0,6.75,3550,10487
3.4845e+05,2014,241,4,2.5,1950,8628,2,0,0,3,8,1950,0,1994,1994,98038,47.382,122.03,2210,9019,20,0,6.5,4160,10969
2.5995e+05,2014,269,2,1,790,8100,1,0,0,3,6,790,0,1947,1947,98125,47.716,122.31,1420,8100,67,0,3,2210,8890
3.75e+05,2014,346,3,1.75,1380,5060,1,0,0,3,7,1380,0,1986,1986,98133,47.706,122.34,1030,5060,28,0,4.75,2410,6440
4.5e+05,2014,241,3,2.25,1780,9969,1,0,0,3,8,1450,330,1985,1985,98034,47.729,122.17,1950,7974,29,0,5.25,3730,9754
1.25e+06,2014,310,3,2.5,3670,18505,1,0,4,3,10,2530,1140,1983,1983,98177,47.759,122.38,2920,20000,31,0,5.5,6590,23670
2.625e+05,2014,271,3,1.5,1610,10291,1,0,0,4,7,1610,0,1961,1961,98022,47.203,122,1410,7729,53,0,4.5,3020,9339
2.6e+05,2014,229,5,1,1600,7350,1,0,0,5,7,1600,0,1962,1962,98031,47.394,122.2,1600,7725,52,0,6,3200,9325
7.5131e+05,2014,318,4,2.5,2660,8469,2,0,0,3,10,2660,0,1994,1994,98006,47.553,122.12,2920,10697,20,0,6.5,5580,13357
4.77e+05,2014,265,3,2,1750,4990,1,0,0,3,7,950,800,1916,1916,98107,47.667,122.36,1700,5000,98,0,5,3450,6750
7.55e+05,2014,176,4,2.75,2880,4000,1,0,0,3,9,2100,780,1912,2000,98144,47.584,122.29,2110,4000,102,1,6.75,4990,6880
4.2e+05,2014,285,4,2.5,2170,10500,1,0,0,3,7,1570,600,1962,1962,98155,47.751,122.3,1850,11127,52,0,6.5,4020,13297
6.55e+05,2014,271,3,1,1370,5250,1,0,0,3,7,1070,300,1939,1939,98109,47.642,122.35,2410,4200,75,0,4,3780,5570
2.91e+05,2014,258,3,2.25,1860,13939,1,0,0,4,7,1860,0,1961,1961,98030,47.375,122.22,1530,10018,53,0,5.25,3390,11878
3.535e+05,2015,438,4,2.5,3250,4650,2,0,0,3,8,3250,0,2007,2007,98031,47.4,122.2,2960,4650,8,0,6.5,6210,7900
5.5e+05,2015,481,3,1,980,10960,1,0,0,4,7,980,0,1953,1953,98005,47.591,122.17,2100,10960,62,0,4,3080,11940
6.1075e+05,2014,162,4,2.25,2180,7297,2,0,0,3,8,2180,0,1984,1984,98074,47.646,122.06,2250,9781,30,0,6.25,4430,11961
1.495e+06,2014,292,4,3.25,3070,10375,2,0,0,3,10,2180,890,1962,2005,98004,47.586,122.2,2500,11194,52,1,7.25,5570,14264
2.6e+05,2014,230,3,1.75,1580,7344,1,0,0,5,7,1580,0,1911,1911,98126,47.526,122.38,1580,6207,103,0,4.75,3160,7787
3.4e+05,2014,319,3,2.25,2580,7434,1,0,0,3,7,1630,950,1963,1963,98133,47.745,122.33,1920,7737,51,0,5.25,4500,10317
5e+05,2015,439,3,2.5,1670,2575,2,0,0,3,8,1670,0,2000,2000,98027,47.531,122.05,1670,2897,15,0,5.5,3340,4567
7.075e+05,2015,440,3,1,1500,2555,2,0,2,3,7,1500,0,1910,1910,98109,47.627,122.35,1820,2555,105,0,4,3320,4055
5.8014e+05,2014,153,4,2.5,3150,5886,2,0,0,3,8,3150,0,2014,2014,98059,47.479,122.12,2650,5886,0,0,6.5,5800,9036
6.075e+05,2014,134,5,1.75,2220,6000,1,0,0,3,7,1420,800,1923,1923,98199,47.648,122.38,1550,1715,91,0,6.75,3770,3935
4.38e+05,2015,386,3,2.25,2340,14279,1,0,0,3,8,1340,1000,1965,1965,98006,47.572,122.12,2340,13600,50,0,5.25,4680,15940
8.025e+05,2015,403,4,2.25,1950,7000,1,0,1,3,8,1450,500,1957,1957,98118,47.543,122.26,1840,6440,58,0,6.25,3790,8390
8.1495e+05,2014,318,4,2.75,2990,6626,2,0,0,3,9,2990,0,2014,2014,98052,47.711,122.11,2910,5533,0,0,6.75,5900,8523
4e+05,2014,189,3,2,1760,6875,1,0,0,4,8,1760,0,1967,1967,98072,47.74,122.09,1670,13650,47,0,5,3430,15410
6.55e+05,2015,439,2,2.25,1460,1851,2,0,0,3,9,1180,280,2014,2014,98119,47.646,122.36,1800,4269,1,0,4.25,3260,5729
4.235e+05,2015,470,3,2,1770,6000,1,0,3,3,7,1100,670,1984,1984,98118,47.564,122.29,1300,3000,31,0,5,3070,4770
6.3e+05,2015,450,2,1.75,1260,5300,1,0,0,4,7,840,420,1951,1951,98103,47.681,122.35,1280,3000,64,0,3.75,2540,4260
8e+05,2014,287,4,2.25,2010,7200,1,0,1,4,8,1010,1000,1950,1950,98118,47.559,122.27,2010,7200,64,0,6.25,4020,9210
2e+05,2015,424,2,1,950,8100,1,0,0,3,6,950,0,1955,1955,98166,47.457,122.35,1620,7630,60,0,3,2570,8580
6.75e+05,2014,333,4,2.5,2920,6000,2,0,4,3,9,2920,0,2004,2004,98065,47.533,121.86,3100,6001,10,0,6.5,6020,8921
3.35e+05,2014,202,3,2.25,2060,47318,1,0,2,4,8,1600,460,1976,1976,98001,47.276,122.27,1870,19663,38,0,5.25,3930,21723
1.65e+05,2014,311,3,1,1010,7690,1,0,0,4,6,1010,0,1958,1958,98058,47.45,122.18,1010,7619,56,0,4,2020,8629
8.15e+05,2015,431,4,2.5,3880,7208,2,0,0,3,10,3880,0,2006,2006,98075,47.584,121.97,3280,7221,9,0,6.5,7160,11101
3.75e+05,2015,466,3,2.5,1300,1362,2,0,0,3,8,880,420,2008,2008,98144,47.589,122.32,1300,1251,7,0,5.5,2600,2551
2.75e+05,2014,210,3,1,1250,7654,1,0,0,3,7,1000,250,1952,1952,98125,47.729,122.29,1310,7350,62,0,4,2560,8600
2.99e+05,2014,148,3,1,1390,9624,1,0,0,4,7,1390,0,1954,1954,98155,47.776,122.3,1440,9624,60,0,4,2830,11014
3.28e+05,2014,209,4,1.75,1990,7194,1,0,0,4,8,1400,590,1978,1978,98058,47.442,122.14,1820,7400,36,0,5.75,3810,9390
6.12e+05,2014,303,4,2.5,2670,5974,2,0,0,3,8,2670,0,1999,1999,98034,47.712,122.23,2140,5729,15,0,6.5,4810,8399
3.15e+05,2015,430,3,1.75,1500,10230,1,0,0,2,7,1500,0,1968,1968,98058,47.435,122.17,1770,8374,47,0,4.75,3270,9874
6.25e+05,2014,133,3,3.5,1810,1846,2,0,0,4,8,1440,370,2009,2009,98122,47.607,122.31,1480,3600,5,0,6.5,3290,5410
3.794e+05,2014,310,4,1.75,2120,7680,1,0,0,4,7,1060,1060,1950,1950,98177,47.717,122.36,1530,7680,64,0,5.75,3650,9800
3.25e+05,2014,285,4,2.5,1850,7324,2,0,0,3,8,1850,0,1997,1997,98042,47.37,122.11,2100,7329,17,0,6.5,3950,9179
6.4e+05,2014,284,4,2.75,3150,7379,1,0,0,4,7,2430,720,1915,1915,98115,47.697,122.3,1990,7379,99,0,6.75,5140,10529
5e+05,2015,486,4,2.25,2050,7201,2,0,0,3,8,2050,0,1994,1994,98033,47.7,122.17,1970,7350,21,0,6.25,4020,9400
2.85e+05,2014,269,3,1,1120,10701,1,0,0,3,7,1120,0,1954,1954,98106,47.554,122.36,1130,6350,60,0,4,2250,7470
7.675e+05,2014,346,2,1.75,2210,9374,1,0,3,4,8,1560,650,1951,1951,98107,47.663,122.36,2140,5640,63,0,3.75,4350,7850
3e+05,2015,443,3,1,1320,7200,1,0,0,4,7,1320,0,1959,1959,98056,47.505,122.19,1720,7249,56,0,4,3040,8569
5.151e+05,2014,284,3,2.5,2074,4900,2,0,0,3,8,2074,0,1997,1997,98034,47.733,122.23,1840,7382,17,0,5.5,3914,9456
4.55e+05,2014,280,3,1.75,1270,7700,1,0,0,4,7,1270,0,1968,1968,98052,47.671,122.15,1510,7700,46,0,4.75,2780,8970
3.5595e+05,2014,347,4,2.5,1960,8540,1,0,0,3,7,1220,740,1955,1955,98177,47.765,122.36,1910,9120,59,0,6.5,3870,11080
3.05e+05,2014,325,2,1,1000,8212,1,0,0,4,7,1000,0,1947,1947,98133,47.744,122.34,1620,8214,67,0,3,2620,9214
5.5e+05,2014,251,3,2.25,1360,5111,1,0,0,5,7,1360,0,1934,1934,98115,47.699,122.31,1900,5111,80,0,5.25,3260,6471
3.35e+05,2015,453,5,3,2660,7700,1,0,0,4,7,1670,990,1962,1962,98058,47.46,122.17,1610,7700,53,0,8,4270,10360
2.9435e+05,2014,230,3,1,1410,5120,1,0,0,3,6,1210,200,1925,1925,98106,47.524,122.36,1330,5120,89,0,4,2740,6530
7.25e+05,2015,431,3,1.75,1630,9000,1,0,0,3,7,960,670,1955,1955,98004,47.602,122.2,1880,9000,60,0,4.75,3510,10630
3.0995e+05,2014,313,3,2.25,1990,6350,2,0,0,3,7,1990,0,1967,1967,98198,47.382,122.32,1220,6250,47,0,5.25,3210,8240
6.5e+05,2014,263,4,2.5,2290,10186,2,0,0,3,8,2290,0,1985,1985,98008,47.635,122.12,2150,10186,29,0,6.5,4440,12476
4.075e+05,2014,243,5,2,2740,8230,1,0,0,3,7,2210,530,1962,1962,98155,47.735,122.3,2130,8232,52,0,7,4870,10972
2.2e+05,2014,141,4,2.5,2160,8005,2,0,0,3,7,2160,0,1993,1993,98001,47.267,122.23,1790,8016,21,0,6.5,3950,10176
3.7e+05,2015,459,4,3,2490,5706,2,0,0,3,9,2490,0,2005,2005,98042,47.351,122.17,2650,5880,10,0,7,5140,8370
3.15e+05,2014,310,4,2.5,1780,6000,2,0,0,3,9,1780,0,2000,2000,98038,47.377,122.03,2650,6000,14,0,6.5,4430,7780
7.4e+05,2015,472,4,2.75,3350,6500,2,0,0,3,10,3350,0,1999,1999,98075,47.584,122.03,2960,6970,16,0,6.75,6310,10320
2.76e+05,2014,181,1,0.75,370,1801,1,0,0,5,5,370,0,1923,1923,98117,47.678,122.39,1340,5000,91,0,1.75,1710,5370
2.5e+05,2014,248,3,2,1140,11161,1,0,0,4,7,1140,0,1998,1998,98022,47.209,122.01,1720,8587,16,0,5,2860,9727
1.91e+05,2015,478,3,1,840,5525,1,0,0,5,6,840,0,1969,1969,98042,47.361,122.08,920,5330,46,0,4,1760,6170
3.25e+05,2015,472,2,1,1010,6180,1,0,0,3,6,1010,0,1903,1903,98118,47.553,122.28,1560,6180,112,0,3,2570,7190
5.06e+05,2014,332,2,1,1060,3588,1,0,0,4,7,960,100,1926,1926,98107,47.672,122.39,1570,3741,88,0,3,2630,4801
2.72e+05,2014,320,4,2.5,2789,3960,2,0,0,3,7,2789,0,2007,2007,98001,47.306,122.28,2547,3960,7,0,6.5,5336,6749
4.599e+05,2014,150,3,1.75,2580,11000,1,0,0,4,7,1290,1290,1951,1951,98006,47.565,122.18,2280,17643,63,0,4.75,4860,20223
7.31e+05,2015,447,5,2.5,3670,8960,1,0,0,3,8,3670,0,1973,1973,98052,47.665,122.14,2340,9425,42,0,7.5,6010,13095
4.3e+05,2014,324,3,2.25,2020,2750,2,0,0,3,8,1680,340,2008,2008,98108,47.563,122.3,1720,1546,6,0,5.25,3740,3566
2.55e+05,2014,347,3,1,1180,13650,1,0,0,4,7,1180,0,1967,1967,98058,47.455,122.15,1460,11730,47,0,4,2640,12910
4.6e+05,2014,286,3,3.25,1370,1194,3,0,0,3,8,1370,0,2005,2005,98107,47.67,122.39,1320,1217,9,0,6.25,2690,2587
3.695e+05,2015,438,3,1.75,1300,20700,1,0,0,3,7,1300,0,1962,1962,98024,47.559,121.9,1930,37638,53,0,4.75,3230,38938
1.135e+06,2015,473,4,3.25,4130,11444,2,0,0,3,11,4130,0,2001,2001,98059,47.521,122.15,3720,11431,14,0,7.25,7850,15561
1.25e+06,2014,174,4,2.5,3220,15600,1,0,0,5,9,1680,1540,1973,1973,98006,47.57,122.18,2990,15600,41,0,6.5,6210,18820
6.25e+05,2014,122,4,3.25,2730,54014,1,0,0,3,9,1560,1170,2007,2007,98059,47.513,122.11,2730,1.1127e+05,7,0,7.25,5460,1.14e+05
3.65e+05,2014,216,2,1.75,1270,7500,1,0,0,4,7,1270,0,1982,1982,98074,47.619,122.06,1280,7500,32,0,3.75,2550,8770
2.5e+05,2014,321,2,1,1420,21158,1,0,0,3,7,1420,0,1953,1953,98166,47.459,122.36,1220,8625,61,0,3,2640,10045
9.79e+05,2014,170,3,1.5,1700,14133,1,0,1,4,8,1700,0,1954,1954,98004,47.617,122.22,2630,17376,60,0,4.5,4330,19076
4.19e+05,2014,204,3,1.75,2140,15030,1,0,0,4,7,1570,570,1958,1958,98166,47.418,122.34,2170,15030,56,0,4.75,4310,17170
1.95e+06,2015,376,4,2.75,4020,18745,2,0,4,4,10,2830,1190,1989,1989,98004,47.604,122.21,3150,20897,26,0,6.75,7170,24917
6.2e+05,2014,168,4,2.5,1910,7683,2,0,0,3,8,1910,0,1987,1987,98027,47.564,122.09,1980,8485,27,0,6.5,3890,10395
1.278e+06,2014,210,4,4,4390,17832,1,0,0,4,11,2430,1960,1994,1994,98059,47.528,122.14,3090,12369,20,0,8,7480,16759
1.6e+05,2014,147,2,1,1180,9350,1,0,0,3,6,1180,0,1918,1918,98178,47.489,122.26,1780,9306,96,0,3,2960,10486
3.4e+05,2015,430,3,1,670,23522,1,0,0,4,6,670,0,1968,1968,98024,47.533,121.89,1880,20270,47,0,4,2550,20940
4e+05,2014,166,4,1.75,1580,5340,1,0,0,3,7,1130,450,1947,1947,98144,47.6,122.31,830,980,67,0,5.75,2410,2560
2.87e+05,2014,125,3,1,1450,6000,1,0,0,4,7,1450,0,1953,1953,98118,47.524,122.29,1170,6464,61,0,4,2620,7914
3.535e+05,2014,270,4,2.5,1770,9239,2,0,0,3,7,1770,0,2004,2004,98038,47.351,122.01,2150,5450,10,0,6.5,3920,7220
5e+05,2014,261,4,3.25,2670,5001,1,0,0,3,9,1640,1030,2013,2013,98108,47.567,122.29,1610,5001,1,0,7.25,4280,7671
1.965e+05,2014,175,3,1,1320,9000,1,0,0,3,7,1320,0,1966,1966,98001,47.346,122.27,1320,9800,48,0,4,2640,11120
3.5e+05,2015,388,2,1,1070,2880,1,0,0,3,7,1070,0,1902,1902,98102,47.626,122.32,2030,2880,113,0,3,3100,3950
5.56e+05,2014,259,3,1,1800,4005,1,0,0,4,7,1160,640,1929,1929,98117,47.688,122.38,1240,4005,85,0,4,3040,5805
6.08e+05,2014,160,4,2.75,2490,9714,1,0,0,4,8,1400,1090,1983,1983,98011,47.75,122.2,2060,15300,31,0,6.75,4550,17790
4.4e+05,2014,176,3,1.5,2120,6290,1,0,0,4,8,1220,900,1949,1949,98108,47.566,122.32,1620,5400,65,0,4.5,3740,7520
4.1172e+05,2014,154,3,1.75,1840,5101,1,0,0,5,7,1040,800,1952,1952,98108,47.559,122.32,1340,5000,62,0,4.75,3180,6840
8.4709e+05,2014,317,4,2.75,2760,5670,2,0,0,3,10,2760,0,2014,2014,98075,47.582,122.05,2760,6600,0,0,6.75,5520,9360
5.8e+05,2014,258,3,2.75,1430,1521,2,0,0,3,9,1130,300,2009,2009,98119,47.635,122.37,1930,2700,5,0,5.75,3360,4130
7.4e+05,2014,189,4,2.5,3360,15091,2,0,0,3,9,3360,0,1997,1997,98052,47.665,122.14,1930,9936,17,0,6.5,5290,13296
8.25e+05,2014,251,2,2,1830,3600,1,0,0,4,7,1230,600,1926,1926,98109,47.636,122.35,2020,3600,88,0,4,3850,5430
2.25e+05,2014,211,3,2.25,2510,12013,2,0,0,3,8,2510,0,1988,1988,98003,47.347,122.31,1870,8017,26,0,5.25,4380,10527
4.99e+05,2014,134,3,2,2090,42689,1,0,0,3,7,2090,0,1959,1998,98010,47.35,121.94,1890,18276,55,1,5,3980,20366
2.9e+05,2015,407,3,1,1240,9300,1,0,0,3,7,1240,0,1954,1954,98148,47.436,122.33,1250,9300,61,0,4,2490,10540
7.39e+05,2015,365,3,2.75,2950,6667,2,0,0,3,9,2950,0,2003,2003,98029,47.558,122.03,3340,6667,12,0,5.75,6290,9617
5.45e+05,2015,380,3,2.5,2370,9000,1,0,3,4,8,1570,800,1952,1952,98146,47.492,122.36,2120,9500,63,0,5.5,4490,11870
9.1e+05,2014,258,2,2.5,2000,5150,2,0,4,3,9,2000,0,1992,1992,98034,47.706,122.22,2510,6800,22,0,4.5,4510,8800
5.45e+05,2015,440,3,1.75,1680,6200,1,0,0,3,7,1680,0,1916,1916,98136,47.534,122.38,1680,5100,99,0,4.75,3360,6780
5.3e+05,2014,359,5,2,3020,6000,1,0,0,5,7,1860,1160,1925,1925,98126,47.521,122.38,1380,6000,89,0,7,4400,9020
2.546e+05,2014,176,3,2,1470,20000,1,0,0,4,7,1470,0,1968,1968,98002,47.297,122.08,1390,30056,46,0,5,2860,31526
3.7495e+05,2015,472,4,3,2540,8800,1,0,1,3,9,1620,920,1977,1977,98023,47.32,122.39,2540,8800,38,0,7,5080,11340
3.925e+05,2014,266,2,1,1050,4125,1,0,0,4,7,1050,0,1909,1909,98144,47.574,122.31,1650,4125,105,0,3,2700,5175
3.78e+05,2015,467,4,1.75,1990,23200,1,0,0,4,7,1990,0,1976,1976,98059,47.486,122.13,1950,17040,39,0,5.75,3940,19030
2.25e+05,2014,291,4,2.25,1800,9350,1,0,0,3,8,1800,0,1969,1969,98092,47.296,122.19,2060,8800,45,0,6.25,3860,10600
3.04e+05,2014,174,4,2,1310,8454,1,0,0,4,7,1310,0,1953,1953,98155,47.757,122.32,1320,8274,61,0,6,2630,9584
6.8989e+05,2014,198,4,2.25,1930,3500,1,0,0,5,8,1540,390,1916,1916,98122,47.617,122.29,1800,5000,98,0,6.25,3730,6930
7.75e+05,2014,263,4,2.5,3310,5101,2,0,0,3,9,3310,0,2005,2005,98052,47.665,122.08,3010,5176,9,0,6.5,6320,8486
4.4e+05,2015,474,3,1,1410,8925,1,0,0,3,7,1410,0,1958,1958,98052,47.678,122.16,1330,8925,57,0,4,2740,10335
3.55e+05,2014,154,2,1.75,1650,4000,1,0,0,4,7,950,700,1947,1947,98108,47.562,122.32,1060,4110,67,0,3.75,2710,5760
9.24e+05,2014,305,5,2.75,3210,8001,2,0,0,3,9,3210,0,2014,2014,98074,47.593,122.06,3190,6624,0,0,7.75,6400,9834
4.1e+05,2015,439,3,1.75,1880,8424,1,0,0,4,7,1380,500,1977,1977,98059,47.512,122.16,1970,8523,38,0,4.75,3850,10403
2.7995e+05,2015,458,3,2.5,1608,4800,2,0,0,3,8,1608,0,2013,2013,98092,47.258,122.2,2009,4800,2,0,5.5,3617,6408
3.17e+05,2015,394,4,2.5,2160,8049,2,0,0,3,9,2160,0,1988,1988,98001,47.334,122.26,2490,8995,27,0,6.5,4650,11155
5e+05,2014,333,3,3.25,1490,902,3,0,0,3,8,1220,270,2001,2001,98102,47.636,122.32,1550,1092,13,0,6.25,3040,2582
1.225e+06,2014,250,5,4.5,3732,4426,2,0,0,3,10,2932,800,2001,2001,98112,47.619,122.29,2950,4000,13,0,9.5,6682,7732
1.0855e+06,2014,208,4,2.75,3010,10830,2,0,3,4,9,3010,0,1980,1980,98034,47.7,122.23,3010,10650,34,0,6.75,6020,13660
1.15e+06,2014,159,3,2.5,2850,10474,1,0,0,4,8,1730,1120,1954,1954,98004,47.622,122.21,2820,10474,60,0,5.5,5670,13324
3.6495e+05,2015,472,4,2.5,2070,2992,2,0,0,3,8,2070,0,2002,2002,98058,47.45,122.12,1900,2957,13,0,6.5,3970,5027
3.499e+05,2014,285,4,2.75,2530,13474,2,0,0,4,8,2530,0,1994,1994,98023,47.289,122.34,2490,13140,20,0,6.75,5020,15670
1.198e+06,2014,181,4,3.5,3400,3850,2,0,0,3,10,2790,610,2008,2008,98112,47.626,122.3,2030,4000,6,0,7.5,5430,7400
2.95e+05,2015,446,4,2.5,1677,7209,2,0,0,3,7,1677,0,2011,2011,98023,47.296,122.36,2236,7209,4,0,6.5,3913,8886
3.3999e+05,2014,170,3,2.5,2570,4600,2,0,0,3,8,2570,0,2014,2014,98092,47.258,122.2,2570,5000,0,0,5.5,5140,7570
96500,2014,299,3,1,840,12091,1,0,0,3,6,840,0,1959,1959,98023,47.328,122.34,840,9324,55,0,4,1680,10164
1.83e+05,2014,205,3,1,870,5200,1,0,0,5,6,870,0,1969,1969,98042,47.37,122.08,870,5200,45,0,4,1740,6070
9.25e+05,2015,458,3,1.75,1610,10796,1,0,0,3,7,1070,540,1951,1951,98004,47.627,122.21,1940,10796,64,0,4.75,3550,12406
2.95e+05,2015,474,3,2.5,1570,6932,2,0,0,3,7,1570,0,1993,1993,98038,47.39,122.05,1570,6271,22,0,5.5,3140,7841
2.45e+05,2014,211,3,1,1370,6000,1,0,0,3,7,1370,0,1955,1955,98146,47.488,122.34,1370,9520,59,0,4,2740,10890
3.795e+05,2014,312,3,1,1110,7128,1,0,0,3,7,1110,0,1980,1980,98052,47.697,122.12,1510,7107,34,0,4,2620,8217
6.8e+05,2015,450,4,2.75,2220,5310,1,0,0,5,7,1170,1050,1951,1951,98144,47.58,122.29,1540,4200,64,0,6.75,3760,6420
7.185e+05,2014,194,4,2.75,2840,8800,2,0,0,3,9,2840,0,2008,2008,98033,47.703,122.17,1840,7700,6,0,6.75,4680,10540
3.25e+05,2014,257,3,1,1150,7486,1,0,0,3,7,1150,0,1970,1970,98034,47.726,122.22,1510,7486,44,0,4,2660,8636
2.0045e+05,2015,438,3,1,970,9130,1,0,0,3,6,970,0,1957,1957,98188,47.437,122.27,1000,8886,58,0,4,1970,9856
2.95e+05,2015,369,3,1.5,1670,10800,1,0,0,4,8,1670,0,1956,1956,98022,47.2,122,1670,9169,59,0,4.5,3340,10839
1.2225e+06,2014,134,4,3.5,4910,9444,1,0,0,3,11,3110,1800,2007,2007,98074,47.65,122.07,4560,11063,7,0,7.5,9470,15973
1.2346e+06,2014,170,5,3.25,3240,6551,1,0,4,4,9,2500,740,1939,1939,98115,47.679,122.27,2740,9300,75,0,8.25,5980,12540
4.29e+05,2015,389,2,1,1010,5000,1,0,0,2,7,1010,0,1924,1924,98107,47.672,122.36,1410,5000,91,0,3,2420,6010
3.424e+05,2014,135,3,2.25,1180,9630,2,0,0,3,7,1180,0,1986,1986,98028,47.735,122.23,2660,5979,28,0,5.25,3840,7159
4.9e+05,2014,132,2,2.5,1230,1391,2,0,0,3,8,870,360,2004,2004,98112,47.619,122.3,1240,1350,10,0,4.5,2470,2580
4.85e+05,2015,450,3,2.25,1570,6810,1,0,0,3,8,1180,390,1988,1988,98074,47.618,122.04,1620,6584,27,0,5.25,3190,8154
5.1e+05,2015,451,3,2,1430,9250,1,0,0,4,8,990,440,1983,1983,98052,47.695,122.1,1830,8003,32,0,5,3260,9433
2.8e+05,2015,375,2,1,850,16400,1,0,0,3,6,850,0,1923,1923,98168,47.489,122.3,1100,14459,92,0,3,1950,15309
9.797e+05,2014,299,5,3,3730,5500,1,0,0,3,7,2160,1570,1927,1927,98102,47.651,122.32,1890,5500,87,0,8,5620,9230
4.47e+05,2014,310,3,2.25,1520,14080,2,0,0,3,7,1520,0,1984,1984,98074,47.627,122.06,1530,9758,30,0,5.25,3050,11278
2.83e+05,2014,175,3,1,890,8400,1,0,0,4,6,890,0,1954,1954,98056,47.517,122.2,1850,5565,60,0,4,2740,6455
2.8e+05,2015,480,3,1.75,1740,8625,1,0,0,4,7,1240,500,1978,1978,98023,47.305,122.38,1980,8625,37,0,4.75,3720,10365
3.35e+05,2014,209,3,1,1380,7470,1,0,0,5,7,1380,0,1965,1965,98133,47.748,122.34,1440,7473,49,0,4,2820,8853
4.7e+05,2015,478,5,1.75,2740,9600,1,0,0,4,7,1370,1370,1945,1945,98144,47.574,122.31,1990,4800,70,0,6.75,4730,7540
6.4999e+05,2014,264,4,2.25,2130,11900,2,0,0,3,9,2130,0,1976,1976,98074,47.641,122.06,2590,11900,38,0,6.25,4720,14030
8.005e+05,2015,409,4,2.5,1780,11130,1,0,0,5,8,1780,0,1962,1962,98005,47.593,122.18,2610,11130,53,0,6.5,4390,12910
1.745e+05,2014,153,2,2.5,1240,2689,2,0,0,3,7,1240,0,1986,1986,98003,47.324,122.32,1430,3609,28,0,4.5,2670,4849
5.45e+05,2014,264,3,2.25,2290,14585,2,0,0,3,8,2290,0,1981,1981,98075,47.587,122.07,1660,36961,33,0,5.25,3950,39251
5.3e+05,2014,318,4,2.25,2240,8376,1,0,0,3,8,1740,500,1984,1984,98074,47.632,122.03,1890,7875,30,0,6.25,4130,10115
2.695e+05,2014,225,2,1,1140,74052,1,0,0,4,6,1140,0,1968,1968,98022,47.209,121.96,1730,43560,46,0,3,2870,44700
2.1995e+05,2015,467,3,1.5,1070,6601,1,0,0,3,6,1070,0,1985,1985,98002,47.312,122.21,1030,6614,30,0,4.5,2100,7684
2.75e+05,2014,300,3,2,1910,8050,1,0,0,4,7,1000,910,1980,1980,98030,47.37,122.17,1780,7344,34,0,5,3690,9254
9.1e+05,2015,425,4,2.5,3530,49222,2,0,0,4,9,3530,0,1986,1986,98072,47.728,122.11,3750,49222,29,0,6.5,7280,52752
3.1e+05,2014,160,3,2.5,1780,6771,1,0,0,3,7,1230,550,1990,1990,98106,47.524,122.35,1780,6771,24,0,5.5,3560,8551
7.35e+05,2014,236,3,3.25,2960,39370,2,0,0,3,10,2960,0,1989,1989,98011,47.745,122.2,2960,56628,25,0,6.25,5920,59588
7.97e+05,2015,402,3,3.5,3500,9473,2,0,0,3,10,3500,0,2008,2008,98075,47.581,121.97,3510,7833,7,0,6.5,7010,11333
3.485e+05,2014,339,4,1.75,1870,7575,1,0,0,3,7,1480,390,1972,1972,98034,47.721,122.22,1670,7575,42,0,5.75,3540,9445
2.15e+05,2014,208,3,1,1180,9000,1,0,0,4,7,1180,0,1970,1970,98031,47.39,122.17,1290,8316,44,0,4,2470,9496
8.35e+05,2015,444,6,2,3560,5120,2,0,2,3,9,3560,0,1900,1900,98122,47.606,122.31,2130,5120,115,0,8,5690,8680
3e+05,2014,305,3,1.75,1210,7000,1,0,0,3,7,1210,0,1975,1975,98058,47.457,122.17,1670,7000,39,0,4.75,2880,8210
5.6e+05,2014,167,5,1,1710,9100,1,0,0,4,7,1320,390,1926,1926,98126,47.538,122.38,1880,9100,88,0,6,3590,10810
5.6e+05,2014,256,4,1.75,1740,8800,1,0,0,4,8,1740,0,1965,1965,98007,47.623,122.14,2180,8436,49,0,5.75,3920,10176
6.1795e+05,2015,446,4,2.5,2410,7950,2,0,0,3,8,2410,0,1997,1997,98034,47.718,122.23,1920,7713,18,0,6.5,4330,10123
2.8e+05,2015,446,4,3,2460,9606,1,0,0,3,8,2460,0,2012,2012,98168,47.489,122.32,1730,7500,3,0,7,4190,9960
2.685e+05,2014,317,4,1.75,1420,7500,1,0,0,4,7,1080,340,1981,1981,98031,47.403,122.18,1500,7260,33,0,5.75,2920,8680
4.95e+05,2014,176,3,1.75,1440,11787,1,0,0,3,8,1440,0,1983,1983,98074,47.628,122.03,2190,11787,31,0,4.75,3630,13227
2.18e+05,2015,425,3,1.5,1140,4875,1,0,0,5,6,1140,0,1970,1970,98042,47.368,122.08,980,5070,45,0,4.5,2120,6210
4.9995e+05,2014,204,3,1,1440,5580,1,0,0,3,7,1440,0,1908,1908,98115,47.69,122.33,2010,5580,106,0,4,3450,7020
3.59e+05,2014,142,3,1.5,1360,885,3,0,0,3,8,1360,0,2008,2008,98103,47.696,122.35,1360,1167,6,0,4.5,2720,2527
6.1e+05,2015,386,5,3.25,3490,23400,1,0,0,4,8,1890,1600,1957,1957,98006,47.57,122.12,2660,12400,58,0,8.25,6150,15890
2.799e+05,2014,126,3,1.75,1580,8151,1,0,1,4,7,1100,480,1962,1962,98198,47.367,122.31,1650,8151,52,0,4.75,3230,9731
4.35e+05,2014,163,3,1.75,1500,8173,1,0,0,3,7,1500,0,1997,1997,98034,47.729,122.23,1970,8173,17,0,4.75,3470,9673
1.505e+06,2015,442,2,2.5,3180,9400,2,0,4,5,10,2610,570,1985,1985,98006,47.562,122.16,3760,9450,30,0,4.5,6940,12630
5.3e+05,2015,458,4,3,2290,5105,2,0,0,3,8,2290,0,2012,2012,98028,47.773,122.24,2450,5105,3,0,7,4740,7395
3.89e+05,2014,149,2,1,910,7000,1,0,0,3,7,910,0,1952,1952,98115,47.7,122.31,1260,7528,62,0,3,2170,8438
2.48e+05,2014,136,4,3.5,1850,6519,2,0,0,3,7,1130,720,1986,1986,98023,47.309,122.35,1280,6664,28,0,7.5,3130,8514
2.75e+05,2014,250,3,1,1190,27215,1,0,0,5,7,1190,0,1943,1989,98059,47.498,122.11,1450,56628,71,1,4,2640,57818
3.6e+05,2015,467,3,2.5,1480,3851,2,0,0,3,8,1480,0,1998,1998,98072,47.773,122.16,1650,4716,17,0,5.5,3130,6196
7.25e+05,2014,272,4,2.25,3440,14237,2,0,0,3,9,3440,0,1982,1982,98077,47.724,122.06,3250,18365,32,0,6.25,6690,21805
5e+05,2014,191,3,1.5,1320,8100,1,0,0,4,7,1320,0,1951,1951,98177,47.719,122.37,1480,8100,63,0,4.5,2800,9420
5.25e+05,2015,471,4,2,2260,7680,1,0,0,4,7,1130,1130,1947,1947,98177,47.719,122.36,1800,7680,68,0,6,4060,9940
3.65e+05,2014,223,5,2.75,3260,9253,2,0,0,3,8,3260,0,2004,2004,98042,47.367,122.07,2770,8067,10,0,7.75,6030,11327
3e+05,2014,225,4,2,1580,9600,1,0,0,5,7,1050,530,1965,1965,98198,47.409,122.31,1710,9600,49,0,6,3290,11180
3.4245e+05,2014,318,3,1.5,1280,5525,1,0,0,3,7,1280,0,1962,1962,98133,47.734,122.34,1330,5286,52,0,4.5,2610,6566
2.86e+05,2014,238,2,1,610,4000,1,0,0,4,6,610,0,1918,1918,98136,47.547,122.39,870,5160,96,0,3,1480,5770
2.1e+05,2015,481,2,1,1100,6000,1,0,0,4,6,1100,0,1900,1900,98108,47.528,122.32,1280,6000,115,0,3,2380,7100
4.25e+05,2014,361,3,2.25,1400,6970,2,0,0,3,8,1400,0,1984,1984,98006,47.542,122.18,1800,8140,30,0,5.25,3200,9540
2.35e+05,2014,250,5,1,1500,9282,1,0,0,5,6,1500,0,1966,1966,98168,47.47,122.28,1520,9639,48,0,6,3020,11139
5.65e+05,2015,477,4,2,2040,8281,2,0,1,3,7,2040,0,1961,1961,98033,47.669,122.19,2560,8281,54,0,6,4600,10321
3.9e+05,2014,222,4,2.75,2500,12848,1,0,1,3,8,2120,380,1975,1975,98003,47.336,122.32,2370,12497,39,0,6.75,4870,14997
6.1069e+05,2014,284,4,2.5,2520,6023,2,0,0,3,9,2520,0,2014,2014,98056,47.514,122.17,2520,6023,0,0,6.5,5040,8543
1e+06,2015,466,3,3,2880,3750,2,0,0,3,9,2220,660,1909,1991,98122,47.615,122.29,1910,4000,106,1,6,4790,6880
6.1e+05,2014,189,3,2.5,2630,5827,2,0,0,3,8,2630,0,2001,2001,98053,47.688,122.04,2330,4715,13,0,5.5,4960,7345
4.75e+05,2015,459,3,1.75,1850,26445,1,0,0,4,7,1850,0,1962,1977,98010,47.341,122.05,2110,23280,53,1,4.75,3960,25130
8.8e+05,2014,180,4,2.75,3220,4392,1,0,0,4,9,2320,900,1931,1931,98105,47.671,122.28,2310,5795,83,0,6.75,5530,9015
5.52e+05,2014,166,3,1,1120,2300,1,0,0,4,7,820,300,1912,1912,98117,47.68,122.38,1430,5100,102,0,4,2550,6220
1.125e+06,2014,163,6,3.75,3010,4360,2,0,0,3,9,2000,1010,2014,2014,98103,47.687,122.33,1600,5160,0,0,9.75,4610,8170
3.01e+05,2014,249,3,1.5,1030,8414,1,0,0,4,7,1030,0,1967,1967,98155,47.765,122.3,1750,8414,47,0,4.5,2780,9444
6e+05,2014,148,4,2,2510,38141,1,0,0,3,9,2510,0,1960,1960,98034,47.722,122.26,3180,11760,54,0,6,5690,14270
4.78e+05,2015,440,3,1,1440,7107,1,0,0,4,7,1000,440,1980,1980,98052,47.697,122.12,1540,7140,35,0,4,2980,8580
5.903e+05,2014,169,3,1.5,1470,7200,2,0,0,4,7,1470,0,1907,1907,98118,47.56,122.28,1530,7200,107,0,4.5,3000,8670
9.5125e+05,2014,286,5,3,2710,8227,1,0,2,3,8,1910,800,1953,1953,98199,47.651,122.39,2060,5400,61,0,8,4770,8110
7.17e+05,2015,432,4,2.5,2780,7985,2,0,0,4,10,2780,0,1992,1992,98029,47.561,122.02,2650,8094,23,0,6.5,5430,10874
4.68e+05,2014,205,4,1.75,2250,8580,1,0,0,4,7,1330,920,1958,1958,98011,47.763,122.2,2250,10032,56,0,5.75,4500,12282
6.6e+05,2014,331,4,1.5,1960,4500,1,0,2,3,7,1960,0,1922,1922,98117,47.68,122.36,1960,4500,92,0,5.5,3920,6460
8.8e+05,2014,223,4,2.5,3070,8250,1,0,0,5,8,2100,970,1958,1958,98005,47.593,122.17,2270,8800,56,0,6.5,5340,11870
5e+05,2014,128,3,1.75,1410,1197,3,0,0,3,8,1410,0,2012,2012,98103,47.656,122.35,1350,2512,2,0,4.75,2760,3922
2.4e+05,2014,299,5,1.75,2460,16000,1,0,0,3,7,1230,1230,1957,1957,98023,47.331,122.35,1990,16000,57,0,6.75,4450,18460
9.05e+05,2014,173,4,3.25,3440,7661,2,0,0,3,11,3440,0,2006,2006,98029,47.543,122,3580,6478,8,0,7.25,7020,9918
3.3e+05,2014,332,3,2.5,2370,9102,2,0,0,3,9,2370,0,1990,1990,98023,47.307,122.39,2530,9883,24,0,5.5,4900,12253
8e+05,2014,324,4,2.25,2510,9963,1,0,0,4,9,2200,310,1967,1967,98005,47.597,122.18,3110,9963,47,0,6.25,5620,12473
2.38e+05,2014,197,3,1.5,1610,6132,1,0,2,4,7,1090,520,1959,1959,98056,47.502,122.17,1650,6132,55,0,4.5,3260,7742
5.4e+05,2014,205,4,1.5,2993,19400,2,0,0,4,7,2233,760,1921,1921,98166,47.469,122.36,2060,15100,93,0,5.5,5053,18093
2.8e+05,2014,198,3,2.5,1580,7000,2,0,0,3,8,1580,0,1992,1992,98030,47.366,122.17,2110,7062,22,0,5.5,3690,8642
3.02e+05,2015,415,6,2,2650,4621,1,0,0,3,8,2650,0,1911,1911,98118,47.554,122.28,1640,4879,104,0,8,4290,7529
4.2e+05,2014,332,3,3.5,1900,2133,2,0,0,3,8,1520,380,2009,2009,98126,47.568,122.37,1530,3264,5,0,6.5,3430,5164
7.4995e+05,2014,211,3,1.75,1800,5700,1,0,0,4,8,1000,800,1941,1941,98119,47.649,122.37,1680,5350,73,0,4.75,3480,7150
2.22e+05,2015,474,3,1,1460,8400,1,0,0,4,6,1460,0,1962,1962,98023,47.309,122.36,1060,8563,53,0,4,2520,10023
4.25e+05,2014,303,3,2.25,1260,3000,2,0,0,3,7,1260,0,2003,2003,98029,47.545,122,1630,3042,11,0,5.25,2890,4302
3.0755e+05,2014,159,4,2.5,1980,5909,2,0,0,3,8,1980,0,2003,2003,98031,47.391,122.19,2550,5487,11,0,6.5,4530,7467
2.015e+05,2014,129,3,1,1160,8320,1,0,0,4,7,1160,0,1959,1959,98032,47.383,122.29,1480,7800,55,0,4,2640,8960
1.17e+06,2014,142,3,2.75,2890,12130,2,0,3,4,10,2830,60,1987,1987,98033,47.651,122.2,2415,11538,27,0,5.75,5305,14428
2.45e+05,2015,375,2,1,990,4800,1,0,0,3,6,990,0,1908,1908,98118,47.562,122.28,1700,5400,107,0,3,2690,6390
4.98e+05,2015,493,4,2.5,3402,14355,2,0,0,3,10,2846,556,2014,2014,98023,47.301,122.39,3402,8487,1,0,6.5,6804,11889
2.903e+05,2014,161,2,1,860,3874,1,0,0,4,6,860,0,1931,1931,98055,47.484,122.2,1400,5106,83,0,3,2260,5966
9e+05,2014,162,4,2.25,2460,44431,1,0,0,4,9,2460,0,1957,1957,98007,47.604,122.15,2830,44431,57,0,6.25,5290,46891
2.97e+05,2014,320,2,1.75,1280,37373,1,0,0,4,7,1280,0,1996,1996,98022,47.263,122.02,2180,48351,18,0,3.75,3460,49631
6.45e+05,2014,342,4,2.5,2340,8955,2,0,0,3,9,2340,0,1990,1990,98074,47.628,122.03,2340,8955,24,0,6.5,4680,11295
2.39e+05,2014,352,4,1.75,1500,12560,1,0,0,4,7,1000,500,1977,1977,98002,47.292,122.2,1700,9020,37,0,5.75,3200,10520
2.5e+05,2014,167,2,1.5,1088,1360,2,0,0,3,7,1088,0,1983,1983,98034,47.709,122.21,1098,1469,31,0,3.5,2186,2557
8.98e+05,2014,249,5,2.25,2700,9000,2,0,0,5,9,2700,0,1987,1987,98007,47.66,122.15,2630,9000,27,0,7.25,5330,11700
2.35e+05,2014,163,3,1.75,1900,8540,1,0,0,3,6,950,950,1980,1980,98168,47.487,122.3,1370,10204,34,0,4.75,3270,12104
4.32e+05,2014,290,4,1.75,2410,8400,1,0,0,3,7,1600,810,1978,1978,98011,47.734,122.2,1850,8400,36,0,5.75,4260,10810
6.13e+05,2014,232,5,3.5,3240,6919,2,0,0,3,8,2760,480,2014,2014,98059,47.478,122.12,2970,5690,0,0,8.5,6210,8930
3.385e+05,2015,372,4,2.5,2390,6111,2,0,0,3,8,2390,0,1997,1997,98030,47.368,122.17,2520,6500,18,0,6.5,4910,8890
4.35e+05,2014,209,3,2.5,1778,1.4782e+05,2,0,0,3,7,1778,0,1999,1999,98014,47.681,121.92,2840,43676,15,0,5.5,4618,45454
4.275e+05,2014,278,4,2.5,2430,3249,2,0,0,3,8,2430,0,2010,2010,98059,47.505,122.16,2650,3844,4,0,6.5,5080,6274
2.18e+05,2014,310,3,1,980,12812,1,0,0,3,7,980,0,1956,1956,98168,47.489,122.31,1430,8986,58,0,4,2410,9966
5.325e+05,2014,265,3,1.75,1620,3360,1,0,0,5,7,980,640,1927,1927,98117,47.689,122.36,1400,3840,87,0,4.75,3020,5460
2.747e+05,2014,195,4,2,2440,9600,1,0,0,5,7,1220,1220,1963,1963,98031,47.414,122.18,1370,9600,51,0,6,3810,12040
4.85e+05,2014,361,4,2.5,2100,8886,2,0,0,4,7,2100,0,1964,1964,98007,47.595,122.13,1840,9058,50,0,6.5,3940,11158
3.7e+05,2014,314,5,2.5,2250,10400,1,0,0,3,8,1280,970,1973,1973,98058,47.45,122.14,2140,9592,41,0,7.5,4390,11842
2.705e+05,2014,353,5,2.5,2406,7093,2,0,0,3,8,2406,0,2006,2006,98001,47.261,122.25,1767,7093,8,0,7.5,4173,9499
3.75e+05,2014,279,4,2,1757,19370,1,0,2,5,7,1757,0,1955,1955,98198,47.397,122.31,1850,11125,59,0,6,3607,12882
3.95e+05,2014,245,3,2,1500,2506,1,0,0,3,7,870,630,2003,2003,98144,47.596,122.3,1500,4662,11,0,5,3000,6162
4.26e+05,2015,470,3,2.5,2210,5750,2,0,0,3,7,1710,500,1914,2000,98106,47.553,122.37,1350,5750,101,1,5.5,3560,7960
3.969e+05,2014,349,3,2,1360,3120,2,0,0,3,7,1360,0,1989,1989,98115,47.694,122.31,1360,3120,25,0,5,2720,4480
6.5e+05,2014,229,4,3.5,3270,15704,2,0,0,3,9,2110,1160,1990,1990,98074,47.626,122.04,3020,8582,24,0,7.5,6290,11852
2.55e+05,2014,356,2,2,1360,5433,1,0,0,3,8,1360,0,1974,2003,98198,47.38,122.32,1160,5264,40,1,4,2520,6624
2.37e+05,2014,235,3,1.5,1800,9216,1,0,0,4,7,1800,0,1950,1950,98001,47.274,122.25,1400,10022,64,0,4.5,3200,11822
3.9995e+05,2014,228,3,1,1020,18050,1,0,0,3,7,1020,0,1969,1969,98027,47.525,122.04,1750,11640,45,0,4,2770,12660
5e+05,2015,485,4,2.5,1770,8155,1,0,0,4,6,1770,0,1970,1993,98034,47.719,122.17,1460,7360,45,1,6.5,3230,9130
6.9e+05,2014,146,4,2.5,2700,8810,2,0,0,3,9,2700,0,2004,2004,98052,47.704,122.12,2730,5100,10,0,6.5,5430,7800
5.449e+05,2014,321,3,2.5,1990,4936,2,0,0,3,8,1990,0,2004,2004,98075,47.591,122.02,2250,4815,10,0,5.5,4240,6805
3.95e+05,2014,266,2,2.25,1620,1841,2,0,0,3,8,1540,80,2004,2004,98029,47.548,122,1530,1831,10,0,4.25,3150,3451
8.75e+05,2014,187,3,1.5,1820,12686,1,0,0,4,7,1820,0,1952,1952,98004,47.589,122.19,3020,11550,62,0,4.5,4840,13370
5.85e+05,2015,388,3,2.75,3080,7282,2,0,0,3,9,3080,0,2008,2008,98059,47.483,122.15,3080,7274,7,0,5.75,6160,10354
5.39e+05,2014,154,3,2.5,1710,2300,2,0,0,3,8,1570,140,2005,2005,98052,47.674,122.14,2120,2856,9,0,5.5,3830,4566
5.3e+05,2014,297,3,1.75,1660,4800,1,0,0,3,7,960,700,1941,1996,98116,47.573,122.41,1510,4800,73,1,4.75,3170,6460
6.59e+05,2015,472,2,2.5,1450,1213,2,0,0,3,9,1110,340,2015,2015,98107,47.669,122.37,1620,1456,0,0,4.5,3070,2906
4.03e+05,2015,474,3,2.5,1700,4125,2,0,0,3,7,1700,0,2004,2004,98065,47.531,121.85,1970,4105,11,0,5.5,3670,5805
4.75e+05,2014,304,3,2.5,2420,36862,1,0,0,4,8,1530,890,1957,1957,98003,47.326,122.31,1670,9046,57,0,5.5,4090,11466
2.15e+05,2015,388,3,1,860,6635,1,0,0,3,6,860,0,1952,1952,98133,47.751,122.34,1170,8000,63,0,4,2030,8860
5.35e+05,2015,465,3,2.75,2300,12197,2,0,0,3,8,2300,0,1989,1989,98166,47.437,122.34,1710,11220,26,0,5.75,4010,13520
6.82e+05,2015,481,2,1,890,5000,1,0,0,3,7,890,0,1943,1943,98105,47.667,122.28,1680,5000,72,0,3,2570,5890
6.25e+05,2014,332,3,2.5,1860,10027,2,0,0,3,8,1860,0,1993,1993,98033,47.678,122.17,1530,9204,21,0,5.5,3390,11064
6e+05,2014,188,3,2.25,1900,46609,1,0,0,4,7,1440,460,1969,1969,98072,47.753,122.12,2460,43560,45,0,5.25,4360,45460
8.5e+05,2015,461,5,4,2980,4500,1,0,0,3,7,2070,910,1921,1921,98115,47.674,122.32,1560,4225,94,0,9,4540,7205
5.4e+05,2015,410,3,2.5,1950,13227,2,0,0,4,9,1950,0,1978,1978,98034,47.722,122.26,2650,12943,37,0,5.5,4600,14893
2.55e+05,2014,298,4,1.75,1650,7200,1,0,0,3,7,1100,550,1977,1977,98031,47.394,122.19,1620,7374,37,0,5.75,3270,9024
2.86e+05,2014,211,3,1.75,1770,9000,1,0,0,3,7,1090,680,1954,1954,98168,47.5,122.33,1520,21141,60,0,4.75,3290,22911
4.25e+05,2014,136,3,2.5,2670,13218,1,0,0,4,10,2670,0,1988,1988,98042,47.368,122.15,1960,13130,26,0,5.5,4630,15800
6.1e+05,2014,202,5,2.75,2930,31411,1,0,0,4,9,1520,1410,1975,1975,98006,47.558,122.19,3070,12378,39,0,7.75,6000,15308
2.05e+05,2014,163,3,1,1290,6566,1,0,0,5,7,1290,0,1976,1976,98023,47.3,122.38,1690,6860,38,0,4,2980,8150
2.11e+05,2015,447,3,2,1060,7412,1,0,0,3,7,1060,0,1987,1987,98038,47.39,122.05,1080,7093,28,0,5,2140,8153
3.9995e+05,2014,147,3,3,1296,1051,3,0,0,3,8,1296,0,2009,2009,98125,47.718,122.28,1520,1939,5,0,6,2816,3235
3.1995e+05,2014,256,3,2.5,1980,9907,2,0,0,3,8,1980,0,1991,1991,98022,47.19,122.01,2050,9907,23,0,5.5,4030,11887
8.35e+05,2014,204,5,4,3600,14720,1,0,2,5,8,1800,1800,1960,1960,98034,47.702,122.23,3600,15358,54,0,9,7200,18958
4.5e+05,2015,464,2,1.75,2130,6574,1,0,0,3,8,1500,630,1946,1946,98199,47.653,122.41,2130,6275,69,0,3.75,4260,8405
5.3e+05,2014,155,4,3.25,4160,35654,2,0,0,3,8,2760,1400,1973,1973,98027,47.468,122.01,2500,35675,41,0,7.25,6660,39835
5.9995e+05,2014,189,3,3.25,1830,1804,3,0,0,3,8,1830,0,2014,2014,98117,47.694,122.38,1830,1804,0,0,6.25,3660,3634
4.1999e+05,2014,231,3,2.5,1690,1689,2,0,0,3,8,1150,540,2014,2014,98029,47.553,122,1540,1689,0,0,5.5,3230,3379
3.95e+05,2014,291,3,3.5,1450,1263,2,0,0,3,8,1160,290,2007,2007,98199,47.651,122.38,1390,1282,7,0,6.5,2840,2732
1.3283e+05,2015,408,3,1.5,1210,5200,1,0,0,5,6,1210,0,1969,1969,98042,47.361,122.09,1120,5200,46,0,4.5,2330,6410
3.818e+05,2014,286,4,2,1530,5250,1,0,0,3,7,1110,420,1981,1981,98133,47.734,122.34,1100,5250,33,0,6,2630,6780
7.15e+05,2014,205,4,2.5,2370,10000,1,0,0,5,8,1660,710,1974,1974,98052,47.638,122.1,2480,9875,40,0,6.5,4850,12245
4e+05,2015,440,4,2.5,3130,5240,2,0,0,3,8,3130,0,2004,2004,98038,47.345,122.04,2470,5240,11,0,6.5,5600,8370
1.24e+06,2015,465,4,3,3010,6139,2,0,4,5,8,2560,450,1950,1972,98115,47.68,122.27,2100,6798,65,1,7,5110,9808
5.85e+05,2014,243,4,2.5,3110,6479,2,0,0,3,9,3110,0,2005,2005,98065,47.541,121.86,3110,7075,9,0,6.5,6220,10185
2.36e+05,2014,314,3,1.75,1560,10919,1,0,0,3,7,1560,0,1975,1975,98023,47.292,122.37,1730,10919,39,0,4.75,3290,12479
4.2e+05,2015,414,3,1.5,2080,5000,1,0,0,3,7,1300,780,1963,1963,98118,47.532,122.29,1860,5000,52,0,4.5,3940,7080
4.3e+05,2015,400,4,2,1990,4740,1,0,0,3,7,1080,910,1926,1926,98122,47.611,122.3,1560,2370,89,0,6,3550,4360
4.25e+05,2014,236,3,1.5,1390,9680,1,0,0,4,7,1390,0,1956,1956,98008,47.634,122.13,1460,10050,58,0,4.5,2850,11440
3.25e+05,2015,480,2,2.25,1550,2285,2,0,0,3,8,1550,0,2007,2007,98106,47.54,122.37,1550,2135,8,0,4.25,3100,3685
1.07e+05,2014,238,3,1.5,910,5120,1,0,0,3,6,910,0,1973,1973,98106,47.524,122.36,1410,5132,41,0,4.5,2320,6042
7.005e+05,2014,347,3,2.5,2560,35265,2,0,0,3,9,2560,0,1981,1981,98072,47.735,122.09,2820,35496,33,0,5.5,5380,38056
2.95e+05,2014,249,2,1.75,1050,6500,1,0,2,4,6,1050,0,1925,1925,98055,47.473,122.2,1320,10075,89,0,3.75,2370,11125
3.5e+05,2015,458,3,1.75,1580,19998,1,0,0,4,7,1580,0,1968,1968,98010,47.33,122.05,1860,19998,47,0,4.75,3440,21578
2.82e+05,2014,147,3,2.5,1680,15711,1,0,0,3,7,1240,440,1994,1994,98031,47.423,122.17,1420,8588,20,0,5.5,3100,10268
1.09e+06,2014,298,4,2.5,2780,6837,2,0,0,3,9,2780,0,2004,2004,98033,47.666,122.2,1160,6837,10,0,6.5,3940,9617
6.1942e+05,2014,141,4,2.75,2450,14803,2,0,0,4,9,2450,0,1988,1988,98059,47.526,122.16,2330,14803,26,0,6.75,4780,17253
4.5e+05,2014,168,3,1.75,1180,4080,1,0,0,4,6,760,420,1928,1928,98117,47.682,122.39,1490,4080,86,0,4.75,2670,5260
5.8e+05,2014,197,5,2.75,3550,9600,2,0,0,3,7,3550,0,1960,1960,98033,47.677,122.19,3370,9600,54,0,7.75,6920,13150
3.75e+05,2014,237,4,2.25,2330,11400,1,0,0,4,8,2330,0,1974,1974,98058,47.45,122.15,2640,10200,40,0,6.25,4970,12530
5.2995e+05,2014,334,3,2.25,1240,1250,3,0,0,3,8,1240,0,2014,2014,98107,47.675,122.38,1470,1250,0,0,5.25,2710,2490
2.05e+05,2014,249,3,1,1010,8800,1,0,0,4,7,1010,0,1968,1968,98002,47.276,122.21,1550,7700,46,0,4,2560,8710
6.43e+05,2015,464,4,2.5,2518,4663,2,0,0,3,8,2518,0,2005,2005,98075,47.589,122.02,2280,4525,10,0,6.5,4798,7043
1.68e+05,2014,142,2,2.5,1160,2174,2,0,0,3,7,1160,0,1998,1998,98106,47.526,122.37,1380,1919,16,0,4.5,2540,3079
3.38e+05,2014,310,3,1.75,1250,7710,1,0,0,4,7,1250,0,1947,1947,98155,47.762,122.32,1340,7710,67,0,4.75,2590,8960
5.8e+05,2014,313,3,2.5,1910,11550,1,0,0,3,8,1910,0,2003,2003,98074,47.621,122.06,2230,11550,11,0,5.5,4140,13460
3.92e+05,2014,255,4,3.75,2220,3797,1,0,0,4,6,1330,890,1917,1917,98108,47.557,122.31,1490,4340,97,0,7.75,3710,6560
2.1995e+05,2015,480,3,1.5,1210,5200,1,0,0,5,6,1210,0,1969,1969,98042,47.361,122.09,1120,5200,46,0,4.5,2330,6410
4.75e+05,2014,278,3,1.5,1640,2720,1,0,0,3,8,1640,0,1929,1929,98115,47.687,122.32,1490,4375,85,0,4.5,3130,6015
7.95e+05,2015,425,3,2,2920,13650,1,0,2,5,8,1460,1460,1975,1975,98033,47.665,122.19,2920,10988,40,0,5,5840,13908
4.4745e+05,2014,287,3,2.25,1570,7200,2,0,0,3,8,1570,0,1991,1991,98034,47.733,122.23,1620,7318,23,0,5.25,3190,8888
3.65e+05,2014,218,3,2.5,2190,5091,2,0,0,3,8,2190,0,2004,2004,98038,47.351,122.04,2200,5948,10,0,5.5,4390,8138
3.4995e+05,2014,216,2,3.25,1570,2031,2,0,0,3,8,1310,260,2006,2006,98126,47.548,122.38,1570,2039,8,0,5.25,3140,3609
5.25e+05,2015,446,3,1,1560,8100,1,0,0,4,8,1140,420,1952,1952,98177,47.726,122.36,2130,8100,63,0,4,3690,9660
4.05e+05,2014,325,4,2.75,2360,7716,1,0,0,3,7,1390,970,1978,1978,98034,47.73,122.22,2160,8794,36,0,6.75,4520,11154
4.75e+05,2014,153,3,2.5,2600,7210,2,0,0,3,8,2600,0,1989,1989,98059,47.512,122.15,2350,7225,25,0,5.5,4950,9825
4.77e+05,2014,139,3,2.5,1350,2053,3,0,0,3,8,1350,0,2005,2005,98117,47.676,122.39,1350,4150,9,0,5.5,2700,5500
7.75e+05,2014,127,3,2,2540,7200,1,0,3,4,8,1600,940,1905,1905,98144,47.597,122.29,2040,5900,109,0,5,4580,8440
3.48e+05,2015,399,3,2.5,1490,2478,3,0,0,3,8,1490,0,2009,2009,98133,47.724,122.35,1270,1156,6,0,5.5,2760,2646
9.55e+05,2014,134,5,2.25,2510,9887,2,0,0,3,8,2510,0,1972,1972,98040,47.534,122.22,2510,10006,42,0,7.25,5020,12516
1.165e+06,2015,399,4,2.25,3080,10487,2,0,0,4,9,3080,0,1968,1968,98040,47.534,122.22,2480,10607,47,0,6.25,5560,13687
4.48e+05,2015,473,3,3.25,1560,1345,2,0,0,3,8,1260,300,2009,2009,98126,47.564,122.38,1560,4800,6,0,6.25,3120,6360
5.3e+05,2014,189,3,2.5,1790,3078,2,0,0,3,8,1790,0,2010,2010,98027,47.564,122.09,1890,3078,4,0,5.5,3680,4868
7.35e+05,2014,143,3,2.5,2390,9157,2,0,0,3,9,2390,0,1984,1984,98052,47.662,122.15,2360,8250,30,0,5.5,4750,10640
8.75e+05,2014,154,4,2.75,3790,10669,2,0,0,3,10,3790,0,1999,1999,98075,47.598,121.98,3750,11634,15,0,6.75,7540,15424
1.475e+05,2015,362,3,1.5,1230,10125,1,0,0,3,7,1230,0,1960,1960,98198,47.397,122.3,1970,10125,55,0,4.5,3200,11355
2.18e+05,2014,325,4,1,1640,10455,1,0,0,3,7,950,690,1963,1963,98023,47.297,122.37,1360,9750,51,0,5,3000,11390
3.8e+05,2015,475,4,2.5,2400,9398,1,0,0,4,7,1310,1090,1958,1958,98056,47.495,122.18,1330,8249,57,0,6.5,3730,10649
2.68e+05,2015,453,5,1.75,1730,10368,1,0,0,5,7,1010,720,1963,1963,98059,47.501,122.16,1730,7728,52,0,6.75,3460,9458
2.299e+05,2014,201,3,1,1440,11925,1,0,0,3,7,1440,0,1968,1968,98003,47.274,122.3,1440,10425,46,0,4,2880,11865
5e+05,2015,464,3,2.25,1690,4964,2,0,0,3,8,1690,0,1989,1989,98029,47.576,122.01,1800,5036,26,0,5.25,3490,6726
5.65e+05,2014,170,4,2.75,3260,4900,2,0,0,3,9,3260,0,2013,2013,98059,47.481,122.12,3260,6132,1,0,6.75,6520,9392
2.24e+05,2015,473,4,3,2300,7609,2,0,0,4,7,2300,0,1976,1976,98002,47.294,122.23,940,5937,39,0,7,3240,8237
4.21e+05,2014,307,3,2,1420,12655,1,0,0,5,7,1420,0,1968,1968,98056,47.531,122.19,2020,9655,46,0,5,3440,11075
3.899e+05,2014,250,4,1,1710,1.1718e+05,1,0,0,4,6,1710,0,1942,1942,98055,47.45,122.21,1940,12223,72,0,5,3650,13933
5.045e+05,2014,244,3,2.5,1820,1545,3,0,2,3,8,1640,180,1998,1998,98103,47.652,122.35,1440,1290,16,0,5.5,3260,3110
2.5e+05,2014,352,4,1.75,1710,7140,1,0,0,5,7,1010,700,1968,1968,98032,47.374,122.28,1770,8960,46,0,5.75,3480,10670
5.3e+05,2014,325,4,2.5,2000,4700,1,0,0,4,7,1220,780,1944,1944,98117,47.69,122.37,1560,4700,70,0,6.5,3560,6700
2.5e+05,2014,191,2,1,1030,8786,1,0,0,3,6,1030,0,1956,1956,98146,47.481,122.34,1480,8121,58,0,3,2510,9151
1.9e+05,2015,486,3,2.25,1640,7730,1,0,0,4,7,1220,420,1989,1989,98038,47.358,122.04,1560,7566,26,0,5.25,3200,9206
5.25e+05,2014,133,3,2.5,1580,1161,2,0,0,3,8,1010,570,2008,2008,98112,47.621,122.3,1680,1177,6,0,5.5,3260,2757
8.5e+05,2014,203,4,2,3380,90968,1,0,0,4,9,1690,1690,1979,1979,98075,47.594,122.08,3380,42740,35,0,6,6760,46120
3.15e+05,2015,387,3,1.75,1480,7500,1,0,0,4,7,1480,0,1968,1968,98055,47.463,122.19,1480,7500,47,0,4.75,2960,8980
3.8e+05,2014,197,4,2.25,1860,7980,1,0,0,4,8,1860,0,1966,1966,98058,47.452,122.15,1860,8814,48,0,6.25,3720,10674
1.216e+06,2014,139,4,2.5,3190,8684,1,0,3,5,9,1680,1510,1967,1967,98006,47.562,122.16,3160,8684,47,0,6.5,6350,11874
4.9e+05,2014,313,3,1.75,1660,8208,1,0,0,4,8,1660,0,1965,1965,98005,47.592,122.15,2210,11000,49,0,4.75,3870,12660
7.23e+05,2014,149,4,2.25,1960,8680,1,0,0,4,8,1290,670,1959,1959,98004,47.608,122.19,2160,8680,55,0,6.25,4120,10640
6.7e+05,2014,352,3,1,1710,6195,1,0,0,3,7,1410,300,1946,1946,98105,47.671,122.27,1610,6195,68,0,4,3320,7905
4.4e+05,2014,189,3,1.5,1270,1413,3,0,0,3,8,1270,0,2007,2007,98115,47.699,122.32,1270,1413,7,0,4.5,2540,2683
5.23e+05,2015,444,3,2.5,2400,6182,2,0,0,3,8,2400,0,1998,1998,98065,47.536,121.87,2420,5829,17,0,5.5,4820,8229
8.19e+05,2014,188,3,2.75,3176,13391,2,0,3,4,9,2726,450,1985,1985,98198,47.343,122.33,3470,12779,29,0,5.75,6646,15955
6.65e+05,2014,163,4,2.5,2790,43091,2,0,0,4,9,2790,0,1989,1989,98077,47.776,122.08,2750,35290,25,0,6.5,5540,38080
4.75e+05,2015,409,3,2.5,1310,1294,2,0,0,3,8,1180,130,2008,2008,98116,47.577,122.41,1330,1265,7,0,5.5,2640,2575
7.4e+05,2014,175,4,2.5,3000,10392,2,0,0,3,9,3000,0,1995,1995,98027,47.535,122.05,3140,9213,19,0,6.5,6140,12213
2.55e+05,2014,224,1,0.5,880,1642,1,0,0,3,6,500,380,1910,1910,98126,47.573,122.37,1410,2992,104,0,1.5,2290,3872
3.85e+05,2015,478,3,1.75,1340,3850,1,0,0,4,7,1340,0,1960,1960,98125,47.713,122.29,1540,7645,55,0,4.75,2880,8985
5.5e+05,2014,251,4,3.5,2970,6587,2,0,0,3,8,2260,710,2014,2014,98059,47.478,122.12,2970,5690,0,0,7.5,5940,8660
5.2795e+05,2014,279,4,1.75,1760,3600,1,0,0,5,7,880,880,1926,1926,98103,47.689,122.33,1500,5580,88,0,5.75,3260,7340
6.999e+05,2014,178,4,2.5,2190,11500,1,0,0,4,8,1430,760,1972,1972,98006,47.567,122.15,2580,9700,42,0,6.5,4770,11890
2.52e+05,2014,195,2,1,940,15450,1,0,0,4,6,940,0,1926,1926,98070,47.441,122.46,1370,34820,88,0,3,2310,35760
5.8589e+05,2015,471,3,2,1490,7431,1,0,0,4,7,1490,0,1966,1966,98052,47.67,122.16,1700,7725,49,0,5,3190,9215
1.665e+06,2014,200,4,3.75,3450,8395,2,0,4,4,10,2640,810,1993,1993,98122,47.613,122.28,3180,5183,21,0,7.75,6630,8633
9.25e+05,2015,446,4,2.75,3010,3400,2,0,2,3,9,2240,770,1923,2009,98122,47.614,122.28,1940,5080,92,1,6.75,4950,8090
4.725e+05,2015,436,3,2,1790,6800,1,0,0,4,7,1240,550,1964,1964,98133,47.728,122.34,1470,6800,51,0,5,3260,8590
3.5e+05,2015,485,5,3,2320,8400,1,0,0,3,7,1510,810,1963,1963,98106,47.557,122.36,1200,4800,52,0,8,3520,7120
4.2875e+05,2014,129,3,1,1620,30736,1,0,0,4,7,1620,0,1911,1977,98006,47.572,122.12,2440,28826,103,1,4,4060,30446
3.2978e+05,2014,262,3,2.5,1730,3600,2,0,0,3,8,1730,0,2014,2014,98146,47.501,122.34,2030,3600,0,0,5.5,3760,5330
5.6e+05,2014,346,4,2.5,1790,9787,1,0,2,4,8,1240,550,1983,1983,98056,47.534,122.19,1790,9787,31,0,6.5,3580,11577
1.25e+06,2015,446,4,2.5,4040,11350,2,0,2,4,10,3690,350,1984,1984,98006,47.559,122.16,3770,12382,31,0,6.5,7810,16422
2.12e+05,2014,297,3,1.5,1690,9600,1,0,0,3,7,1210,480,1976,1976,98038,47.386,122.08,1450,9647,38,0,4.5,3140,11337
5.45e+05,2014,216,4,2.5,2040,7412,2,0,0,3,8,2040,0,1988,1988,98074,47.635,122.03,2050,7830,26,0,6.5,4090,9870
2.52e+05,2015,452,3,1.5,1400,6865,1,0,0,4,7,1400,0,1986,1986,98038,47.364,122.05,1480,8125,29,0,4.5,2880,9525
7.25e+05,2014,242,3,2.5,2980,16996,2,0,0,3,10,2980,0,1992,1992,98075,47.595,122.02,2980,15438,22,0,5.5,5960,18418
5.75e+05,2014,255,4,2.25,2060,12155,1,0,0,4,8,2060,0,1968,1968,98008,47.638,122.12,2360,8625,46,0,6.25,4420,10685
4.299e+05,2014,176,3,2.5,2370,5353,2,0,0,3,8,2370,0,2009,2009,98019,47.733,121.97,2130,6850,5,0,5.5,4500,9220
8.05e+05,2014,215,4,2.5,3020,3600,2,0,0,3,9,3020,0,2009,2009,98029,47.541,121.99,2570,3600,5,0,6.5,5590,6620
2.166e+05,2015,481,3,1.75,2200,7700,1,0,0,3,7,1240,960,1975,1975,98031,47.412,122.18,1770,7360,40,0,4.75,3970,9560
4.75e+05,2014,324,4,1.75,2160,19283,2,0,0,3,8,2160,0,1981,1981,98011,47.76,122.17,1990,9744,33,0,5.75,4150,11904
4.295e+05,2015,383,3,2.75,1650,7272,1,0,0,4,7,1230,420,1972,1972,98034,47.723,122.17,1770,7272,43,0,5.75,3420,8922
5.55e+05,2014,332,4,1.75,2350,6200,1,0,0,4,7,1410,940,1946,1946,98116,47.559,122.4,1800,6150,68,0,5.75,4150,8500
1.2e+06,2014,185,4,2.5,2700,4275,2,0,0,3,9,2700,0,2004,2004,98115,47.672,122.33,1810,4500,10,0,6.5,4510,7200
5.25e+05,2014,266,3,1.75,1520,7875,1,0,0,5,8,1520,0,1969,1969,98006,47.557,122.18,2150,9428,45,0,4.75,3670,10948
2.15e+05,2014,259,3,1,1150,7560,1,0,0,4,6,1150,0,1958,1958,98058,47.461,122.18,1230,7560,56,0,4,2380,8710
2.8e+05,2014,162,1,0.75,420,6720,1,0,0,3,5,420,0,1922,1922,98108,47.552,122.31,1420,6720,92,0,1.75,1840,7140
3.225e+05,2015,413,3,2,1190,6445,1,0,0,3,7,1190,0,1996,1996,98056,47.506,122.17,1920,8195,19,0,5,3110,9385
3.1945e+05,2014,305,5,2,2250,5472,1,0,0,5,7,1750,500,1930,1930,98002,47.306,122.22,1540,5472,84,0,7,3790,7722
4.31e+05,2014,236,2,2,1390,12530,1,0,0,3,8,970,420,1959,1959,98155,47.75,122.29,1940,12530,55,0,4,3330,13920
4.599e+05,2014,338,3,2.25,2250,8000,1,0,0,3,8,1460,790,1976,1976,98034,47.723,122.2,1930,9000,38,0,5.25,4180,11250
2.8e+05,2015,393,2,1.5,800,1196,2,0,0,3,8,800,0,2003,2003,98103,47.697,122.34,1020,1087,12,0,3.5,1820,1887
6.73e+05,2015,438,4,2.25,2580,2875,2,0,0,3,9,2580,0,2015,2015,98116,47.567,122.39,1290,5750,0,0,6.25,3870,8330
3.2e+05,2015,424,2,1,820,5400,1,0,0,3,6,820,0,1940,1940,98117,47.698,122.38,1370,5632,75,0,3,2190,6452
2.13e+05,2015,474,2,1,740,7380,1,0,0,4,6,740,0,1951,1951,98188,47.448,122.28,1500,10075,64,0,3,2240,10815
6.5e+05,2014,338,3,1,1430,4240,1,0,0,3,7,1430,0,1924,1924,98103,47.66,122.34,1660,4240,90,0,4,3090,5670
3.2e+05,2014,177,4,2.5,2570,4865,2,0,0,3,8,2570,0,2005,2005,98038,47.359,122.04,2570,4933,9,0,6.5,5140,7503
3.125e+05,2014,162,2,1.5,1070,1200,2,0,0,3,7,1070,0,1999,1999,98103,47.697,122.35,1070,1200,15,0,3.5,2140,2270
5.89e+05,2014,211,3,2.5,2320,5663,2,0,0,3,8,2320,0,2003,2003,98027,47.539,122.07,2500,4500,11,0,5.5,4820,6820
2.73e+05,2015,452,3,1.75,2050,9045,2,0,0,4,6,2050,0,1959,1959,98058,47.457,122.18,1200,9045,56,0,4.75,3250,11095
2.7495e+05,2014,214,3,1.75,1840,16679,1,0,0,3,8,1840,0,1989,1989,98001,47.321,122.28,1910,15571,25,0,4.75,3750,17411
6.98e+05,2015,484,2,1,1510,4080,1,0,0,3,7,1010,500,1923,1923,98103,47.674,122.33,1660,4080,92,0,3,3170,5590
4.556e+05,2014,147,3,2.5,2420,8252,2,0,0,3,7,2420,0,1998,1998,98065,47.538,121.87,2420,5818,16,0,5.5,4840,8238
3.4e+05,2015,446,2,2,1250,1178,2,0,0,3,7,980,270,1996,1996,98136,47.543,122.39,1270,1242,19,0,4,2520,2492
3.75e+05,2015,477,3,1.5,1290,1213,3,0,0,3,8,1290,0,2007,2007,98103,47.697,122.34,1360,1227,8,0,4.5,2650,2517
3e+05,2015,480,3,2.5,1640,5707,2,0,0,3,7,1640,0,1995,1995,98031,47.402,122.21,1850,5827,20,0,5.5,3490,7467
1.285e+06,2014,286,4,3.5,3440,3800,3,0,0,3,9,3440,0,2014,2014,98112,47.641,122.31,1760,3800,0,0,7.5,5200,7240
7e+05,2015,452,3,1.5,1460,78408,1,0,0,4,7,1460,0,1963,1963,98075,47.59,122.06,3320,7787,52,0,4.5,4780,9247
4.6e+05,2015,467,4,1.75,1870,8663,1,0,0,5,7,1870,0,1949,1949,98133,47.737,122.35,1560,7800,66,0,5.75,3430,9670
1.26e+05,2014,236,1,1,610,4400,1,0,0,3,5,610,0,1922,1922,98055,47.486,122.2,1090,4930,92,0,2,1700,5540
4.65e+05,2015,446,2,1,1120,4000,1,0,0,3,7,1120,0,1926,1926,98105,47.657,122.33,1620,4000,89,0,3,2740,5120
9.36e+05,2015,452,4,2.5,3330,8897,2,0,0,3,10,3330,0,2001,2001,98074,47.648,122.08,3150,7515,14,0,6.5,6480,10845
3.99e+05,2014,150,2,1,940,4800,1,0,0,4,6,940,0,1911,1955,98116,47.576,122.41,980,5900,103,1,3,1920,6840
4.1e+05,2014,187,3,2.25,1450,19206,2,0,0,3,7,1450,0,1989,1989,98074,47.62,122.05,1710,21485,25,0,5.25,3160,22935
3.35e+05,2014,273,3,1,1030,7200,1,0,0,3,6,880,150,1948,1948,98126,47.526,122.38,1030,7200,66,0,4,2060,8230
2.66e+05,2014,352,3,2.25,1550,6022,2,0,0,3,8,1550,0,1989,1989,98003,47.352,122.3,1650,5627,25,0,5.25,3200,7177
3.995e+05,2015,388,4,2.5,2560,7492,2,0,0,3,8,2560,0,2014,2014,98188,47.447,122.29,1260,11541,1,0,6.5,3820,14101
4.99e+05,2015,446,3,1,1270,6250,1,0,0,3,7,910,360,1955,1955,98116,47.569,122.4,2000,6250,60,0,4,3270,7520
3.75e+05,2014,231,2,1,1810,8527,1,0,0,4,7,1810,0,1943,1943,98133,47.727,122.34,1490,6800,71,0,3,3300,8610
6.15e+05,2014,125,4,1.75,2300,11700,1,0,0,4,9,1960,340,1977,1977,98052,47.633,122.09,2840,12000,37,0,5.75,5140,14300
2.85e+05,2014,301,3,1.75,1560,9514,1,0,0,4,7,1560,0,1967,1967,98031,47.409,122.21,1550,9600,47,0,4.75,3110,11160
1.61e+06,2014,143,4,3.5,4390,11600,2,0,3,3,11,3060,1330,1990,1990,98040,47.586,122.25,3240,12000,24,0,7.5,7630,16390
3.47e+05,2014,205,4,2.5,2770,9751,2,0,0,3,8,2770,0,1989,1989,98042,47.374,122.13,2370,6950,25,0,6.5,5140,9720
2.6e+05,2015,464,3,2.5,1500,7401,2,0,0,3,8,1500,0,1998,1998,98092,47.263,122.22,1720,7171,17,0,5.5,3220,8671
3e+05,2014,257,6,3,2744,9926,2,0,0,3,7,2744,0,2006,2006,98002,47.277,122.22,2470,9926,8,0,9,5214,12670
4.9e+05,2015,412,4,2,1650,6480,2,0,0,5,7,1650,0,1947,1947,98125,47.712,122.29,1650,6350,68,0,6,3300,8000
3.09e+05,2014,349,3,1,1820,8142,1,0,0,3,7,1040,780,1961,1961,98168,47.505,122.32,1820,8142,53,0,4,3640,9962
7.525e+05,2014,217,2,2.5,2280,6230,1,0,0,3,8,2280,0,2005,2005,98053,47.706,122.01,1640,5931,9,0,4.5,3920,8211
5.5e+05,2014,194,3,1.75,1410,5000,1,0,0,4,7,810,600,1923,1923,98107,47.673,122.39,1760,5000,91,0,4.75,3170,6410
2.35e+05,2014,230,3,1,2230,8163,1,0,0,3,7,1230,1000,1966,1966,98118,47.522,122.28,2380,6874,48,0,4,4610,9104
3.87e+05,2014,321,2,1.5,1010,948,3,0,0,3,8,1010,0,1999,1999,98103,47.653,122.36,1330,1318,15,0,3.5,2340,2328
3.2e+05,2014,188,3,3.25,1450,1387,2,0,0,3,8,1180,270,2013,2013,98106,47.556,122.36,1450,1198,1,0,6.25,2900,2648
3.25e+05,2015,400,3,1.75,2420,14862,1,0,0,3,8,1380,1040,1977,1977,98023,47.33,122.36,2550,14675,38,0,4.75,4970,17095
3.95e+05,2014,232,3,1.75,1740,6220,1,0,0,4,6,1740,0,1954,1954,98177,47.762,122.36,1630,8418,60,0,4.75,3370,10158
8e+05,2015,476,2,2.5,2395,6143,1,0,0,3,8,2395,0,2003,2003,98053,47.711,122.03,2170,6162,12,0,4.5,4565,8557
6.705e+05,2014,143,4,2,1590,6750,1,0,0,3,7,1590,0,1951,1951,98102,47.641,122.32,2370,4500,63,0,6,3960,6090
7.65e+05,2014,349,4,2.5,3230,4290,2,0,0,3,9,3230,0,2004,2004,98033,47.687,122.16,3220,5083,10,0,6.5,6450,8313
5.72e+05,2015,447,4,2.75,2700,7992,2,0,0,3,9,2700,0,2012,2012,98059,47.483,122.14,2840,7992,3,0,6.75,5540,10692
7.3e+05,2015,465,3,1.75,1650,5000,1,0,0,4,8,1650,0,1900,1900,98107,47.674,122.37,1630,5000,115,0,4.75,3280,6650
5.925e+05,2014,341,2,2,1340,5350,1,0,0,3,8,1340,0,1941,1941,98199,47.638,122.4,2210,5350,73,0,4,3550,6690
4.6e+05,2014,245,3,1.75,1420,8250,1,0,0,4,7,1420,0,1960,1960,98007,47.611,122.13,2020,8250,54,0,4.75,3440,9670
3.12e+05,2014,135,3,2.25,1490,974,2,0,0,3,7,1220,270,2009,2009,98106,47.557,122.36,1490,1283,5,0,5.25,2980,2773
5.65e+05,2014,348,3,2.5,4040,8653,2,0,0,3,9,2900,1140,2006,2006,98019,47.738,121.97,3360,8653,8,0,5.5,7400,12693
3.8e+05,2015,485,4,2.5,2110,5306,2,0,0,3,8,2110,0,2012,2012,98038,47.356,122.06,2250,5306,3,0,6.5,4360,7416
3.3e+05,2015,376,4,1.5,1250,8400,1,0,0,3,7,960,290,1951,1951,98155,47.751,122.31,1560,8400,64,0,5.5,2810,9650
6.065e+05,2015,484,3,2.5,2170,5500,2,0,0,3,8,2170,0,2000,2000,98075,47.597,122.02,2170,5862,15,0,5.5,4340,8032
2.7e+05,2014,332,5,1.5,1930,7480,2,0,0,3,7,1930,0,1966,1966,98058,47.45,122.16,1480,7705,48,0,6.5,3410,9635
4.6255e+05,2015,464,2,1.75,1070,1276,3,0,0,3,8,1070,0,2006,2006,98107,47.672,122.39,1290,2057,9,0,3.75,2360,3127
8.6e+05,2014,277,4,4.5,4040,8400,2,0,0,3,9,3220,820,2006,2006,98052,47.707,122.13,3940,8400,8,0,8.5,7980,12440
1.264e+06,2014,132,4,3.75,3490,9170,2,0,0,3,9,3490,0,2012,2012,98004,47.599,122.2,1810,8470,2,0,7.75,5300,11960
1.355e+06,2014,189,4,3.5,3550,11000,1,0,2,3,11,2260,1290,1999,1999,98006,47.551,122.13,4100,10012,15,0,7.5,7650,13562
3.98e+05,2015,388,4,2.5,2820,5510,2,0,0,3,9,2820,0,2005,2005,98038,47.348,122.02,2820,5510,10,0,6.5,5640,8330
4.9e+05,2014,257,4,2.5,3480,12696,1,0,0,4,9,1980,1500,1977,1977,98042,47.382,122.15,3480,14175,37,0,6.5,6960,17655
1.475e+06,2015,374,5,4,4770,31570,2,0,0,3,12,4770,0,1990,1990,98006,47.547,122.12,4520,32070,25,0,9,9290,36840
2.35e+05,2014,177,1,1.5,1170,1456,2,0,0,3,8,1070,100,2007,2007,98126,47.549,122.37,1360,1730,7,0,2.5,2530,2900
2.22e+05,2015,437,3,1,990,7520,1,0,0,4,7,990,0,1958,1958,98002,47.285,122.21,990,7440,57,0,4,1980,8430
5.145e+05,2015,362,4,2.5,2990,9614,1,0,2,4,9,1740,1250,1976,1976,98003,47.342,122.33,3370,12085,39,0,6.5,6360,15075
5.635e+05,2014,159,4,2.5,2800,12831,2,0,0,3,8,2800,0,2001,2001,98019,47.739,121.97,2810,10235,13,0,6.5,5610,13035
7e+05,2015,463,3,2.25,2330,11424,2,0,0,4,8,2330,0,1984,1984,98052,47.639,122.11,2050,11448,31,0,5.25,4380,13778
2.05e+05,2015,393,3,1.75,1200,8631,1,0,0,3,7,1200,0,1959,1959,98198,47.386,122.31,1564,8115,56,0,4.75,2764,9315
4.825e+05,2014,170,4,3,1630,7626,1,0,0,5,7,1110,520,1990,1990,98125,47.717,122.31,1630,8082,24,0,7,3260,9712
2.75e+05,2015,424,2,1,920,7688,1,0,0,3,6,920,0,1955,1955,98106,47.528,122.36,1040,7440,60,0,3,1960,8360
5.48e+05,2014,224,4,2,2100,8880,1,0,0,4,7,2100,0,1958,1958,98008,47.611,122.12,1280,9102,56,0,6,3380,11202
4.301e+05,2015,467,3,2.25,1400,1078,2,0,0,3,8,940,460,2009,2009,98144,47.57,122.29,1420,1230,6,0,5.25,2820,2630
3.6889e+05,2015,456,3,1.5,1490,12186,1,0,0,4,7,1490,0,1950,1950,98155,47.774,122.32,1180,14285,65,0,4.5,2670,15775
6.25e+05,2015,424,3,2,2140,3600,2,0,0,3,8,1680,460,1911,1997,98116,47.585,122.38,2340,5400,104,1,5,4480,7540
4.46e+05,2014,228,4,2.5,1530,8375,1,0,0,3,7,1020,510,1974,1974,98034,47.717,122.24,1650,9794,40,0,6.5,3180,11324
6.75e+05,2015,392,4,1.75,2220,7230,1,0,1,3,8,1280,940,1950,1950,98125,47.706,122.28,2210,7230,65,0,5.75,4430,9450
7.35e+05,2015,452,3,2.5,2540,6762,2,0,0,3,10,2540,0,1998,1998,98007,47.624,122.14,2870,6631,17,0,5.5,5410,9171
2.96e+05,2015,464,2,1,1370,8400,1,0,0,3,7,1370,0,1948,1948,98133,47.734,122.34,1330,8396,67,0,3,2700,9766
2.5e+05,2014,291,4,2,2600,9000,1,0,0,3,8,1410,1190,1959,1959,98032,47.381,122.3,2600,7200,55,0,6,5200,9800
6.6e+05,2014,215,3,2.5,2680,28243,2,0,0,3,9,2680,0,1993,1993,98077,47.764,122.05,2670,32130,21,0,5.5,5350,34810
5.45e+05,2014,190,2,2,2930,14057,1,0,2,4,8,1680,1250,1980,1980,98070,47.403,122.46,2234,61011,34,0,4,5164,63941
6.047e+05,2014,142,4,2.75,2750,14982,1,0,3,3,9,1720,1030,1981,1981,98198,47.357,122.32,2860,16344,33,0,6.75,5610,19094
5.7e+05,2015,446,4,3,2460,10401,1,0,0,5,7,1700,760,1947,1947,98125,47.711,122.28,1470,7727,68,0,7,3930,10187
8e+05,2014,191,4,2.25,3220,8436,2,0,0,3,8,3220,0,1968,1968,98008,47.638,122.12,2500,7632,46,0,6.25,5720,10852
1.1e+06,2014,224,3,3,3700,16857,1,0,0,3,10,2170,1530,2000,2000,98117,47.696,122.39,2320,12000,14,0,6,6020,15700
4.6e+05,2015,472,3,2,1200,7320,1,0,0,3,7,1200,0,1955,1955,98115,47.699,122.29,1750,8220,60,0,5,2950,9420
7e+05,2014,353,3,1.5,1580,5000,1,0,0,3,8,1290,290,1939,1939,98117,47.687,122.39,1570,4500,75,0,4.5,3150,6080
4.5e+05,2015,495,5,2,1870,7344,1,0,0,3,7,1870,0,1960,1960,98007,47.595,122.14,1870,7650,55,0,7,3740,9520
1.65e+05,2014,230,3,1,1120,5000,1,0,0,3,6,1120,0,1917,1917,98146,47.511,122.36,1050,5000,97,0,4,2170,6120
5.4e+05,2014,244,4,3.5,3510,6005,2,0,0,3,8,2750,760,2010,2010,98065,47.517,121.87,3090,5866,4,0,7.5,6600,9376
3.6181e+05,2014,257,3,1.75,1240,7620,1,0,0,3,7,1240,0,1968,2014,98166,47.458,122.35,1150,7620,46,1,4.75,2390,8860
3.2195e+05,2014,128,2,1.25,860,1277,2,0,0,3,7,860,0,2007,2007,98144,47.584,122.31,1280,1265,7,0,3.25,2140,2125
3.72e+05,2015,459,4,1,2300,7680,1,0,0,3,7,1270,1030,1959,1959,98106,47.524,122.36,1840,5120,56,0,5,4140,7420
1.3e+06,2015,452,5,3.75,4450,7680,2,0,0,3,9,3460,990,2010,2010,98199,47.642,122.39,2550,6400,5,0,8.75,7000,10850
3.598e+05,2014,290,5,2.5,2170,2752,2,0,0,3,8,2170,0,2014,2014,98106,47.517,122.35,1800,2752,0,0,7.5,3970,4922
7.6e+05,2014,280,5,1.75,2660,10637,1,0,0,5,7,1670,990,1922,1922,98115,47.694,122.29,1570,6825,92,0,6.75,4230,9485
4.5e+05,2014,297,3,2.5,2480,5647,2,0,0,3,7,2480,0,2002,2002,98065,47.535,121.88,2510,5018,12,0,5.5,4990,7498
4.02e+05,2014,263,3,2.5,1970,12205,2,0,0,4,8,1970,0,1990,1990,98011,47.74,122.21,2640,9636,24,0,5.5,4610,11606
4.6e+05,2015,415,5,4.5,3100,7260,2,0,0,3,8,3100,0,1963,2000,98059,47.5,122.16,1650,7700,52,1,9.5,4750,10800
3.321e+05,2014,278,5,3.5,2660,6978,2,0,0,3,8,1980,680,1996,1996,98092,47.263,122.21,2220,7294,18,0,8.5,4880,9954
2.4e+05,2014,255,3,2,1300,5000,1,0,0,4,7,1300,0,1983,1983,98198,47.384,122.3,1630,7500,31,0,5,2930,8800
2.6135e+05,2014,173,3,1.75,1390,18200,1,0,0,4,7,1390,0,1962,1962,98023,47.321,122.34,1810,9675,52,0,4.75,3200,11065
4.4e+05,2014,230,3,1.75,1430,8400,1,0,0,4,7,1430,0,1961,1961,98008,47.607,122.13,1570,7800,53,0,4.75,3000,9230
2.75e+05,2014,173,2,1,1180,6552,1,0,0,4,6,1180,0,1949,1949,98133,47.748,122.34,1070,7200,65,0,3,2250,8380
8.51e+05,2014,273,3,2.75,2660,10350,1,0,4,4,8,1330,1330,1971,1971,98008,47.587,122.12,2820,10043,43,0,5.75,5480,12703
8e+05,2015,478,3,2.5,2100,4440,2,0,4,3,7,2100,0,1945,1945,98116,47.587,122.4,2100,6000,70,0,5.5,4200,8100
5.3995e+05,2014,223,3,2,1560,3200,1,0,0,3,7,1560,0,1910,2007,98109,47.64,122.36,1240,3600,104,1,5,2800,5160
7.5e+05,2015,479,5,3.5,2160,2323,3,0,0,3,9,2160,0,2007,2007,98107,47.673,122.39,1750,4650,8,0,8.5,3910,6810
5.19e+05,2014,245,5,2.75,2620,8861,1,0,0,5,8,1350,1270,1979,1979,98056,47.523,122.18,1940,10800,35,0,7.75,4560,13420
3.9e+05,2014,238,2,1,1270,8164,1,0,0,4,6,1270,0,1941,1941,98125,47.712,122.31,1580,9095,73,0,3,2850,10365
7.19e+05,2015,375,3,1.75,1800,5816,1,0,0,5,7,900,900,1947,1947,98199,47.653,122.41,1650,5816,68,0,4.75,3450,7616
4.2e+05,2014,297,4,1,1510,1501,1,0,0,3,7,1510,0,1906,1906,98103,47.653,122.34,1560,1602,108,0,5,3070,3112
2.15e+05,2014,187,3,1,960,9563,1,0,0,5,7,960,0,1967,1967,98023,47.286,122.36,1280,9600,47,0,4,2240,10560
3.68e+05,2014,338,4,2.5,2720,7350,2,0,0,3,9,2720,0,1989,1989,98023,47.303,122.35,2570,8336,25,0,6.5,5290,11056
9.4e+05,2014,127,4,2.25,1890,5940,1,0,1,3,9,1470,420,1963,1963,98112,47.632,122.3,2430,5940,51,0,6.25,4320,7830
3.45e+05,2014,318,3,1.5,1030,6969,1,0,0,4,6,1030,0,1921,1921,98108,47.549,122.3,1420,6000,93,0,4.5,2450,7030
3.75e+05,2015,429,3,2.5,1770,5146,2,0,0,3,7,1770,0,1992,1992,98106,47.526,122.36,1230,5160,23,0,5.5,3000,6930
1.22e+06,2014,173,4,3.75,3520,3944,1,0,0,5,8,2200,1320,1913,1913,98109,47.642,122.35,2310,4725,101,0,7.75,5830,8245
3.48e+05,2015,471,3,2.5,1730,4004,2,0,0,3,7,1730,0,1999,1999,98148,47.432,122.33,1730,5523,16,0,5.5,3460,7253
3.306e+05,2014,274,1,1,580,1799,1,0,0,3,7,580,0,1908,2005,98117,47.683,122.38,1260,4000,106,1,2,1840,4580
7.7e+05,2014,190,5,2.5,3000,7912,1,0,0,3,9,1610,1390,2007,2007,98033,47.676,122.17,2700,7205,7,0,7.5,5700,10205
5.45e+05,2015,474,4,2.75,2180,8480,1,0,3,4,7,1210,970,1959,1959,98146,47.496,122.37,2240,8497,56,0,6.75,4420,10677
3.5495e+05,2014,176,4,2.75,2530,7350,1,0,0,5,8,1280,1250,1977,1977,98023,47.313,122.37,2280,7350,37,0,6.75,4810,9880
5.55e+05,2014,155,4,2.75,2020,10720,1,0,0,4,8,1420,600,1976,1976,98052,47.637,122.1,2190,10164,38,0,6.75,4210,12184
6.86e+05,2014,152,3,1.5,1840,9990,2,0,0,5,8,1840,0,1961,1961,98177,47.715,122.37,2100,12474,53,0,4.5,3940,14314
4e+05,2014,142,3,1,1040,6250,1,0,0,3,7,1040,0,1942,1942,98136,47.553,122.39,1770,6250,72,0,4,2810,7290
8.35e+05,2014,265,5,2.75,2460,7830,1,0,0,5,9,1490,970,1955,1955,98115,47.694,122.31,2050,7830,59,0,7.75,4510,10290
2.1355e+05,2014,291,3,2.5,1580,8541,2,0,0,3,7,1580,0,1990,1990,98001,47.333,122.29,1640,7542,24,0,5.5,3220,9122
2.55e+05,2014,269,3,1,1160,8636,1,0,0,3,6,1160,0,1923,1923,98146,47.51,122.36,1300,8636,91,0,4,2460,9796
6.75e+05,2015,472,4,2.5,2990,5400,2,0,0,3,8,2990,0,2005,2005,98074,47.612,122.01,2890,6538,10,0,6.5,5880,9528
5.935e+05,2015,365,3,1,1370,4000,2,0,0,4,8,1370,0,1918,1918,98105,47.671,122.32,1370,4000,97,0,4,2740,5370
4.9e+05,2014,129,2,1,1840,3300,1,0,0,4,6,1130,710,1910,1910,98107,47.676,122.36,1320,4000,104,0,3,3160,5840
4.47e+05,2014,264,3,1,1310,7000,1,0,0,4,7,1310,0,1958,1958,98008,47.602,122.12,1280,7300,56,0,4,2590,8610
8.99e+05,2015,459,4,2.5,4080,10295,2,0,0,3,10,4080,0,1998,1998,98075,47.593,121.98,3470,10295,17,0,6.5,7550,14375
2.1995e+05,2015,443,3,1,1060,10042,1,0,0,4,7,1060,0,1957,1957,98188,47.443,122.28,1130,10925,58,0,4,2190,11985
5.85e+05,2014,263,4,2.5,1950,3720,2,0,0,3,8,1950,0,2004,2004,98029,47.55,122,1720,3720,10,0,6.5,3670,5670
5.32e+05,2014,154,4,1.75,2020,7029,1,0,0,4,7,1430,590,1979,1979,98052,47.698,122.13,1780,7200,35,0,5.75,3800,9220
6.8553e+05,2015,430,4,2.5,3130,60467,2,0,0,3,9,3130,0,1996,1996,98014,47.662,121.96,2780,44224,19,0,6.5,5910,47354
4.55e+05,2014,205,3,2.25,2180,6850,1,0,0,3,7,1750,430,1973,1973,98034,47.725,122.22,1740,7016,41,0,5.25,3920,9196
6.65e+05,2015,415,3,3.5,2460,14155,2,0,0,3,8,1900,560,2014,2014,98155,47.774,122.28,2440,14080,1,0,6.5,4900,16540
2.85e+05,2015,418,3,2.25,1840,6214,1,0,0,4,7,1270,570,1983,1983,98031,47.404,122.19,1840,6214,32,0,5.25,3680,8054
4.55e+05,2014,166,2,1.5,1310,12196,1,0,0,3,6,1310,0,1970,1970,98052,47.649,122.12,2970,12196,44,0,3.5,4280,13506
4.65e+05,2015,481,3,1,1210,4872,1,0,0,4,6,1210,0,1949,1949,98118,47.555,122.27,1070,4872,66,0,4,2280,6082
3.35e+05,2015,369,2,1.5,1170,5248,1,0,0,5,6,1170,0,1941,1941,98126,47.532,122.37,1170,5120,74,0,3.5,2340,6290
5.58e+05,2015,437,2,1.75,1930,4601,1,0,0,3,8,1930,0,2006,2006,98053,47.72,122.02,1670,4500,9,0,3.75,3600,6430
2.95e+05,2014,304,1,1,520,5600,1,0,0,3,6,520,0,1918,1918,98116,47.558,122.39,1030,5265,96,0,2,1550,5785
3.3e+05,2015,409,3,1.5,1690,10250,1,0,0,4,7,1690,0,1955,1955,98166,47.453,122.34,1990,11084,60,0,4.5,3680,12774
4.935e+05,2015,395,3,1.75,1800,16026,1,0,0,3,8,1390,410,1972,1972,98008,47.581,122.12,2210,13959,43,0,4.75,4010,15759
1.16e+06,2014,239,4,3.5,4190,15724,2,0,2,3,11,4190,0,1994,1994,98027,47.552,122.1,3300,10113,20,0,7.5,7490,14303
2.19e+05,2014,195,3,1.5,1060,9600,1,0,0,4,7,1060,0,1962,1962,98023,47.323,122.35,1440,9600,52,0,4.5,2500,10660
4.575e+05,2015,453,3,1,960,4600,1,0,0,4,6,960,0,1927,1927,98118,47.555,122.29,1380,5175,88,0,4,2340,6135
7.44e+05,2014,156,3,2.5,2670,12187,2,0,0,3,8,2670,0,1986,1986,98052,47.668,122.15,2400,8999,28,0,5.5,5070,11669
4.5e+05,2014,344,4,1.5,1860,7808,1,0,0,3,7,1080,780,1953,1953,98125,47.731,122.3,1530,7884,61,0,5.5,3390,9744
2.8e+05,2014,259,4,2.5,1934,5677,2,0,0,3,8,1934,0,2013,2013,98001,47.26,122.25,1919,5049,1,0,6.5,3853,6983
4.99e+05,2014,166,3,1.75,1750,12325,1,0,0,4,7,1470,280,1968,1968,98052,47.683,122.12,1820,9750,46,0,4.75,3570,11500
1.325e+06,2014,271,3,2.25,2360,5504,2,0,0,4,8,2080,280,1913,1913,98122,47.617,122.29,2840,5470,101,0,5.25,5200,7830
5.26e+05,2014,259,3,3.25,1220,1281,2,0,0,3,8,930,290,2014,2014,98105,47.67,122.32,1303,3810,0,0,6.25,2523,5030
2.3e+05,2014,133,2,0.75,650,5360,1,0,0,4,5,650,0,1931,1931,98133,47.728,122.33,1110,6700,83,0,2.75,1760,7350
5.39e+05,2015,460,5,1,1700,11727,1,0,0,4,7,1700,0,1954,1954,98033,47.686,122.17,1740,8212,61,0,6,3440,9912
2.45e+05,2014,215,3,2,1850,8208,1,0,0,4,7,1180,670,1970,1970,98023,47.311,122.36,1790,8174,44,0,5,3640,10024
2.33e+05,2014,332,2,2.25,850,1656,2,0,0,3,8,850,0,2001,2001,98133,47.706,122.34,850,1312,13,0,4.25,1700,2162
3.91e+05,2015,401,4,2.25,2190,3850,2,0,0,3,7,2190,0,2006,2006,98059,47.486,122.16,2190,3980,9,0,6.25,4380,6170
1.7e+05,2014,195,3,1.5,1350,81549,1,0,0,2,7,1350,0,1966,1966,98092,47.31,122.09,2220,93825,48,0,4.5,3570,95175
5.51e+05,2014,136,2,2,2260,9604,1,0,0,3,9,2260,0,1990,1990,98011,47.772,122.21,2260,10747,24,0,4,4520,13007
5.925e+05,2014,273,4,1.5,2080,4400,1,0,0,3,7,2080,0,1925,1925,98122,47.606,122.3,1680,4400,89,0,5.5,3760,6480
3.39e+05,2014,191,3,2.25,2090,10120,1,0,0,4,7,1290,800,1979,1979,98058,47.465,122.17,1820,7983,35,0,5.25,3910,10073
7.75e+05,2015,486,3,1,1460,6198,1,0,0,4,7,1460,0,1916,1916,98107,47.663,122.36,2280,5160,99,0,4,3740,6620
2.6e+05,2015,407,3,1,1910,8710,1,0,0,3,7,1080,830,1954,1954,98168,47.504,122.3,1460,8944,61,0,4,3370,10854
4.3e+05,2014,336,3,2.25,2160,6527,2,0,0,4,7,1580,580,1987,1987,98034,47.729,122.21,1950,9675,27,0,5.25,4110,11835
3.0495e+05,2014,264,2,1,670,6720,1,0,0,5,6,670,0,1942,1942,98126,47.515,122.37,710,6720,72,0,3,1380,7390
1.662e+06,2014,285,4,2.75,3520,19200,1,1,4,4,9,1950,1570,1951,1951,98136,47.525,122.39,2450,7000,63,0,6.75,5970,10520
6.48e+05,2014,159,4,2.5,2380,13435,2,0,0,3,10,2380,0,1992,1992,98075,47.583,122.03,2730,9677,22,0,6.5,5110,12057
3.9e+05,2014,290,3,2.5,2250,8076,2,0,0,3,8,2250,0,1995,1995,98038,47.367,122.04,2180,7244,19,0,5.5,4430,9494
8.315e+05,2014,173,5,2.5,4470,35124,2,0,0,3,11,4470,0,1984,1984,98072,47.738,122.08,4050,34118,30,0,7.5,8520,38588
2.35e+05,2015,463,2,1,930,10505,1,0,0,3,6,930,0,1930,1930,98148,47.434,122.33,1520,8881,85,0,3,2450,9811
6.405e+05,2015,486,3,1,1070,4505,1,0,2,4,7,1070,0,1919,1919,98136,47.531,122.38,1380,4505,96,0,4,2450,5575
8.0995e+05,2014,214,4,3.5,3660,4903,2,0,0,3,9,2760,900,2014,2014,98034,47.718,122.16,3630,4992,0,0,7.5,7290,8652
4.39e+05,2015,464,4,2.5,2800,17279,1,0,2,3,7,1560,1240,1957,1957,98028,47.76,122.27,3060,13423,58,0,6.5,5860,16223
4.83e+05,2014,239,3,1.75,2110,10454,1,0,0,4,8,1440,670,1978,1978,98028,47.734,122.25,1990,10890,36,0,4.75,4100,13000
3.35e+05,2014,201,4,2.25,2280,7500,1,0,0,4,7,1140,1140,1963,1963,98198,47.418,122.33,1660,8000,51,0,6.25,3940,10280
5.85e+05,2014,250,4,2,2400,12753,1,0,0,4,7,2400,0,1962,1962,98033,47.695,122.18,1830,12060,52,0,6,4230,14460
1.5e+05,2014,153,3,1,1320,8220,1,0,0,3,7,1320,0,1959,1959,98198,47.37,122.31,1320,7920,55,0,4,2640,9240
8.225e+05,2014,222,2,1,1450,7098,1,0,4,3,7,1450,0,1924,1924,98109,47.63,122.35,2390,6098,90,0,3,3840,7548
1.95e+05,2014,259,3,1,1510,4350,1,0,0,5,6,1510,0,1913,1913,98022,47.205,121.99,1210,5500,101,0,4,2720,7010
5.34e+05,2015,421,4,1.75,2040,2750,1,0,0,4,6,1260,780,1926,1926,98105,47.67,122.3,1940,3750,89,0,5.75,3980,5790
5.6e+05,2014,211,3,3.5,2270,4088,2,0,0,3,8,1880,390,1996,1996,98136,47.536,122.38,1760,5425,18,0,6.5,4030,7695
1.348e+06,2014,301,5,3.25,3540,5971,1,0,2,3,10,2000,1540,2005,2005,98033,47.664,122.2,2820,6029,9,0,8.25,6360,9569
3.8e+05,2015,477,3,1,1220,3000,1,0,0,3,6,1220,0,1901,1901,98103,47.651,122.35,1350,3000,114,0,4,2570,4220
2.572e+05,2014,134,3,2,1850,8250,1,0,0,4,7,1150,700,1952,1952,98002,47.307,122.21,1580,7153,62,0,5,3430,9003
4.15e+05,2014,251,2,1,910,3750,1,0,0,3,7,910,0,1904,1904,98117,47.677,122.37,1160,4000,110,0,3,2070,4910
2.94e+05,2015,477,3,2.25,1700,9600,2,0,0,3,7,1700,0,1984,1984,98042,47.39,122.16,1930,9600,31,0,5.25,3630,11300
5.25e+05,2015,415,4,2.5,2740,12106,1,0,0,3,8,1980,760,1992,1992,98133,47.765,122.36,2170,11156,23,0,6.5,4910,13896
3.96e+05,2014,325,3,1,1980,9540,1,0,0,3,7,1080,900,1949,1949,98133,47.755,122.35,1680,9529,65,0,4,3660,11509
2.35e+05,2014,236,2,1,2150,4500,1,0,0,3,7,1260,890,1917,1917,98118,47.516,122.27,1590,5010,97,0,3,3740,7160
5.5e+05,2014,238,3,1.75,1650,3200,1,0,0,3,8,1650,0,1901,1901,98102,47.621,122.32,1500,2400,113,0,4.75,3150,4050
4.145e+05,2014,313,2,1.5,1210,1278,2,0,0,3,8,1020,190,2007,2007,98117,47.676,122.38,1210,1118,7,0,3.5,2420,2328
3.925e+05,2014,230,3,3.25,1600,1289,3,0,0,3,8,1600,0,1998,1998,98117,47.696,122.38,1600,1376,16,0,6.25,3200,2976
1.55e+06,2014,287,2,2.25,2950,15593,1,0,0,4,8,1560,1390,1942,1986,98039,47.621,122.24,2060,19855,72,1,4.25,5010,22805
8.05e+05,2015,431,4,1.75,2360,4750,2,0,0,5,7,1660,700,1911,1911,98115,47.673,122.29,1810,4750,104,0,5.75,4170,7110
4.3e+05,2014,152,2,1,990,4802,1,0,0,3,7,990,0,1947,1947,98117,47.688,122.39,1180,5000,67,0,3,2170,5990
2.2135e+05,2015,408,3,2,1580,6655,1,0,0,3,6,790,790,1944,1944,98178,47.493,122.25,1090,6655,71,0,5,2670,8235
1.25e+06,2014,342,4,2.5,2960,20240,2,0,4,4,10,2960,0,1985,1985,98146,47.508,122.39,2500,14960,29,0,6.5,5460,17920
4.4e+05,2014,174,3,1.75,2000,9900,1,0,2,4,8,1480,520,1957,1957,98166,47.444,122.34,2310,10200,57,0,4.75,4310,12200
5.5e+05,2014,292,3,2.5,1550,1092,3,0,0,3,8,1390,160,2004,2004,98102,47.636,122.32,1550,1079,10,0,5.5,3100,2629
4.45e+05,2014,129,2,2,1150,6634,1,0,0,3,7,860,290,1940,1940,98115,47.7,122.31,1680,6892,74,0,4,2830,8042
8.6e+05,2015,453,4,1.75,1890,4500,2,0,0,5,7,1490,400,1937,1937,98115,47.675,122.29,1890,5000,78,0,5.75,3780,6890
5.3e+05,2014,251,3,2.25,2120,40518,1,0,0,3,8,2120,0,1967,1967,98075,47.59,122.01,2480,13492,47,0,5.25,4600,15612
4.71e+05,2014,153,4,2.5,3030,9687,2,0,0,3,8,2020,1010,1998,1998,98045,47.485,121.8,2050,10193,16,0,6.5,5080,13223
2.1495e+05,2014,300,3,1,1400,6600,1,0,0,3,6,1280,120,1954,1954,98168,47.484,122.33,1730,6600,60,0,4,3130,8000
6.8e+05,2015,452,3,2.25,2300,9914,2,0,0,4,8,2300,0,1980,1980,98027,47.568,122.09,2240,9032,35,0,5.25,4540,11332
3.7e+05,2014,238,3,2.5,2490,4244,2,0,0,3,9,2490,0,2005,2005,98042,47.37,122.13,2490,4748,9,0,5.5,4980,7238
2.82e+05,2014,195,3,2.5,2010,5399,2,0,0,3,7,2010,0,2006,2006,98042,47.334,122.05,2280,5141,8,0,5.5,4290,7151
4.61e+05,2014,168,3,3.25,2770,6278,2,0,0,3,9,1980,790,2006,2006,98056,47.523,122.2,1900,7349,8,0,6.25,4670,10119
4.3e+05,2014,183,3,1.5,1810,5080,1,0,0,3,7,1030,780,1958,1958,98115,47.682,122.29,1780,7620,56,0,4.5,3590,9430
6.468e+05,2015,465,3,3,2230,1407,2,0,0,3,8,1850,380,2014,2014,98027,47.545,122.02,2230,1407,1,0,6,4460,3637
5.25e+05,2014,294,3,1.75,1560,6000,1,0,0,3,6,780,780,1944,1944,98199,47.65,122.38,1560,1734,70,0,4.75,3120,3294
3.85e+05,2014,342,3,1.75,1560,14288,1,0,0,3,6,780,780,1944,1944,98125,47.718,122.31,1320,8928,70,0,4.75,2880,10488
2.69e+05,2015,471,4,2.5,2060,3608,2,0,0,3,7,2060,0,2004,2004,98198,47.362,122.31,2060,3608,11,0,6.5,4120,5668
3.122e+05,2014,259,4,2.5,2910,8596,2,0,0,3,8,2910,0,2004,2004,98003,47.26,122.3,2770,8602,10,0,6.5,5680,11512
4.7e+05,2014,237,4,2,2180,17180,2,0,0,4,7,2180,0,1977,1977,98014,47.698,121.92,1880,14043,37,0,6,4060,16223
5e+05,2014,232,3,2.5,1650,5683,2,0,0,3,7,1650,0,2003,2003,98053,47.683,122.03,1650,4193,11,0,5.5,3300,5843
2.19e+05,2014,332,3,1,970,7790,1,0,0,3,6,970,0,1967,1967,98003,47.316,122.33,1150,8160,47,0,4,2120,9130
1.05e+06,2014,126,3,2.5,2200,1970,2,0,0,3,9,1610,590,2008,2008,98102,47.643,122.33,1890,3505,6,0,5.5,4090,5705
4.6e+05,2014,196,5,2,1910,12264,1,0,0,4,7,1010,900,1963,1963,98007,47.601,122.13,1700,9179,51,0,7,3610,11089
8.62e+05,2014,166,4,2.5,3190,14565,2,0,0,3,11,3190,0,1990,1990,98077,47.713,122.07,3420,20475,24,0,6.5,6610,23665
5e+05,2014,354,2,1,1440,7130,1,0,2,3,7,1210,230,1948,1948,98115,47.678,122.27,1970,7130,66,0,3,3410,8570
2.78e+05,2014,342,4,2,1480,6324,1,0,0,3,7,1480,0,1943,1943,98122,47.615,122.3,1480,3600,71,0,6,2960,5080
1.199e+06,2014,313,4,2.75,4110,8400,2,0,1,3,9,3130,980,1928,2013,98125,47.717,122.28,2820,8400,86,1,6.75,6930,12510
4.15e+05,2014,167,4,2,1610,9600,1,0,0,5,7,1610,0,1967,1967,98056,47.533,122.19,1450,9600,47,0,6,3060,11210
3.59e+05,2014,264,4,3.5,2770,8763,2,0,0,3,8,2100,670,1996,1996,98003,47.263,122.31,2030,7242,18,0,7.5,4800,10012
6e+05,2015,467,4,2.5,2710,6474,2,0,0,3,8,2710,0,2004,2004,98065,47.538,121.88,2870,6968,11,0,6.5,5580,9678
5.55e+05,2014,303,5,2.5,2090,8712,1,0,0,3,8,1420,670,1966,1966,98008,47.597,122.13,2490,8712,48,0,7.5,4580,10802
5.72e+05,2014,154,3,2.25,1830,7897,1,0,0,4,8,1290,540,1986,1986,98052,47.691,122.1,1990,8306,28,0,5.25,3820,10136
5.6e+05,2015,471,3,2.5,2180,7169,2,0,0,3,8,2180,0,1990,1990,98029,47.571,122,2150,5914,25,0,5.5,4330,8094
2.435e+05,2014,224,3,3,2110,7794,1,0,0,3,6,2110,0,1981,1981,98198,47.401,122.29,1330,10044,33,0,6,3440,12154
5.925e+05,2014,139,2,2,1420,9191,1,0,2,5,7,1420,0,1928,1928,98115,47.698,122.32,1420,6816,86,0,4,2840,8236
7.49e+05,2014,160,3,1,1580,5000,1,0,0,3,7,1580,0,1926,1926,98117,47.684,122.39,1280,4000,88,0,4,2860,5580
3.95e+05,2015,478,1,1,900,6380,1,0,0,3,6,900,0,1947,1947,98125,47.702,122.31,1830,6380,68,0,2,2730,7280
5.791e+05,2014,300,2,1,1070,2754,1,0,0,3,7,830,240,1924,1924,98103,47.675,122.33,1760,4080,90,0,3,2830,5150
2.9995e+05,2014,255,2,1,800,3000,1,0,0,3,6,800,0,1904,1904,98118,47.56,122.29,1640,3400,110,0,3,2440,4200
2.555e+06,2014,133,4,2.5,5300,26211,2,1,2,2,10,4570,730,1923,1923,98105,47.661,122.27,3890,19281,91,0,6.5,9190,24581
5.2e+05,2015,478,3,2.25,1770,7667,1,0,0,3,8,1270,500,1966,1966,98177,47.772,122.36,2180,8103,49,0,5.25,3950,9873
4.5e+05,2014,287,3,1.75,3150,9258,1,0,1,3,8,2370,780,1970,1970,98027,47.557,122.08,2740,10274,44,0,4.75,5890,13424
2.94e+05,2014,319,3,1.5,2060,15050,1,0,0,4,7,2060,0,1938,1938,98023,47.332,122.37,1900,15674,76,0,4.5,3960,17734
2.5e+05,2014,303,2,1,800,5220,1,0,0,3,6,800,0,1943,1943,98125,47.704,122.32,1910,5376,71,0,3,2710,6176
5.1e+05,2014,334,3,1.75,2060,58341,1,0,4,3,8,1100,960,1982,1982,98070,47.419,122.44,1230,14904,32,0,4.75,3290,16964
4.174e+05,2014,339,3,3,2680,12285,1,0,0,4,8,2680,0,1970,1970,98055,47.463,122.2,2610,9558,44,0,6,5290,12238
3.35e+05,2015,494,3,2,1410,44866,1,0,0,4,7,1410,0,1985,1985,98023,47.327,122.37,2950,29152,30,0,5,4360,30562
7.45e+05,2014,312,4,2.5,3130,10860,2,0,0,3,10,3130,0,1990,1990,98075,47.56,122.04,3130,10860,24,0,6.5,6260,13990
5.49e+05,2014,312,5,1,1500,3978,2,0,0,3,7,1500,0,1929,1929,98117,47.681,122.38,1350,4080,85,0,6,2850,5580
3.9995e+05,2014,236,3,1,1470,7930,1,0,0,3,7,1070,400,1950,1950,98177,47.701,122.37,1440,8100,64,0,4,2910,9570
2.3e+05,2014,359,2,1,720,5913,1,0,0,3,6,720,0,1920,1920,98118,47.545,122.27,1560,6600,94,0,3,2280,7320
5.725e+05,2014,348,3,2,2290,11200,2,0,0,3,9,2290,0,1979,1979,98052,47.652,122.12,2250,10000,35,0,5,4540,12290
1.65e+06,2015,481,4,4.5,5550,16065,2,0,0,3,9,3880,1670,2003,2003,98040,47.545,122.21,3470,16488,12,0,8.5,9020,22038
7.25e+05,2014,332,3,1,940,8377,1,0,0,4,7,940,0,1952,1952,98004,47.597,122.2,1710,6900,62,0,4,2650,7840
6.99e+05,2014,196,3,1.75,1670,5375,1,0,0,3,7,1270,400,1952,1952,98199,47.642,122.4,1460,6125,62,0,4.75,3130,7795
2.9845e+05,2014,139,5,3,2100,9752,1,0,0,3,8,1200,900,2007,2007,98003,47.334,122.3,1270,10200,7,0,8,3370,12300
2.135e+05,2014,256,3,1.5,1150,11571,1,0,0,3,7,1150,0,1961,1961,98168,47.493,122.3,1630,11571,53,0,4.5,2780,12721
2.15e+05,2014,173,3,2,1340,8505,1,0,0,3,6,1340,0,1931,1931,98168,47.473,122.3,1370,9000,83,0,5,2710,10340
4.3e+05,2014,140,3,1.75,1200,4500,1,0,0,5,7,1200,0,1906,1906,98108,47.555,122.32,1340,4500,108,0,4.75,2540,5700
7.05e+05,2014,276,4,2.25,2620,10536,1,0,0,3,8,1520,1100,1979,1979,98075,47.585,122.08,2760,12431,35,0,6.25,5380,15051
6.18e+05,2014,286,4,2.25,2470,7350,1,0,0,3,7,1600,870,1978,1978,98052,47.694,122.13,1970,7700,36,0,6.25,4440,10170
2.05e+05,2014,209,4,2,2200,13320,1,0,0,3,6,1100,1100,1944,1944,98168,47.481,122.29,1330,6099,70,0,6,3530,8299
1.43e+05,2014,342,3,1,1090,3315,1,0,0,4,6,1090,0,1969,1969,98092,47.316,122.18,960,3120,45,0,4,2050,4210
5.85e+05,2015,446,4,2.5,2820,5612,2,0,0,3,9,2820,0,2007,2007,98028,47.748,122.24,1620,14881,8,0,6.5,4440,17701
4.16e+05,2015,447,2,1,940,4264,1,0,0,5,7,940,0,1949,1949,98126,47.531,122.38,1630,4472,66,0,3,2570,5412
9.4e+05,2014,183,4,2,2490,9525,2,0,0,5,9,2490,0,1968,1968,98040,47.564,122.22,2770,9525,46,0,6,5260,12015
2.595e+05,2015,423,3,2,1330,35060,1,0,0,3,7,1330,0,1989,1989,98092,47.313,122.13,1660,35100,26,0,5,2990,36430
8.3e+05,2015,451,4,3,2020,6000,1,0,0,3,8,1220,800,1968,2015,98199,47.656,122.4,1400,6000,47,1,7,3420,8020
2.38e+05,2014,195,4,1,1400,7242,1,0,0,3,7,1400,0,1959,1959,98188,47.434,122.29,1310,7314,55,0,5,2710,8714
5.39e+05,2015,475,3,2.25,1280,1187,2,0,0,3,8,1080,200,2008,2008,98107,47.665,122.37,1280,1681,7,0,5.25,2560,2961
2.7e+05,2015,456,3,2.5,1780,5015,2,0,0,3,7,1780,0,2010,2010,98042,47.335,122.05,2010,5250,5,0,5.5,3790,7030
8.2e+05,2015,460,4,2.5,2440,5737,2,0,0,4,8,1700,740,1929,1929,98119,47.647,122.37,2020,5543,86,0,6.5,4460,7983
6.8e+05,2014,252,3,2.5,2620,14248,2,0,0,4,8,1830,790,1977,1977,98004,47.628,122.19,2620,12343,37,0,5.5,5240,14963
1.28e+06,2014,186,4,2.5,3160,4620,1,0,4,3,9,2020,1140,1917,2005,98116,47.587,122.38,2790,5308,97,1,6.5,5950,8468
2.55e+05,2014,230,2,1,1260,7810,2,0,0,3,6,1260,0,1945,1945,98178,47.5,122.25,1260,7755,69,0,3,2520,9015
2.5e+05,2015,457,4,2.75,1920,7102,1,0,0,3,7,1130,790,1992,1992,98106,47.539,122.36,1830,6440,23,0,6.75,3750,8360
7.62e+05,2014,175,4,3.5,4000,15253,2,0,0,3,9,4000,0,2007,2007,98065,47.543,121.89,3550,8747,7,0,7.5,7550,12747
4.2895e+05,2014,306,2,1,1760,4441,1,0,0,3,8,1310,450,1950,1950,98126,47.531,122.38,1350,5748,64,0,3,3110,7508
2.849e+05,2015,474,2,1.5,1160,982,2,0,0,3,7,890,270,2006,2006,98155,47.767,122.31,1160,1008,9,0,3.5,2320,2168
4.31e+05,2014,287,3,2.5,2440,71002,1,0,0,4,9,2440,0,1996,1996,98022,47.269,122.01,3170,84000,18,0,5.5,5610,86440
3.45e+05,2014,163,2,1.5,1800,26615,1,0,0,5,7,1240,560,1987,1987,98092,47.302,122.12,2010,26337,27,0,3.5,3810,28137
2.7495e+05,2015,453,3,2.5,1608,4000,2,0,0,3,8,1608,0,2014,2014,98092,47.258,122.2,2009,4983,1,0,5.5,3617,6591
8.52e+05,2015,446,4,1,2220,3588,1,0,0,4,7,1470,750,1927,1927,98115,47.685,122.31,1740,3588,88,0,5,3960,5808
4.36e+05,2015,380,4,1,1200,6600,1,0,2,3,7,1200,0,1908,1908,98136,47.537,122.38,1810,6600,107,0,5,3010,7800
9.7e+05,2014,252,4,3.5,3780,20023,2,0,2,3,10,3780,0,2001,2001,98029,47.549,122.01,2150,3675,13,0,7.5,5930,7455
4.35e+05,2014,166,3,2.5,2300,9521,2,0,0,3,8,2300,0,2003,2003,98019,47.745,121.98,3020,10042,11,0,5.5,5320,12342
3.25e+05,2015,487,3,1.5,1060,7488,1,0,0,5,7,1060,0,1977,1977,98106,47.555,122.36,1300,6780,38,0,4.5,2360,7840
4.745e+05,2015,437,5,2.5,2000,3600,1,0,0,3,6,1150,850,1987,1987,98144,47.597,122.3,1410,3600,28,0,7.5,3410,5600
5.65e+05,2014,339,4,2.75,1960,48787,1,0,0,4,9,1960,0,1983,1983,98072,47.748,122.11,1970,36425,31,0,6.75,3930,38385
1.0525e+06,2014,223,4,2.75,3950,12840,2,0,0,5,8,3950,0,1960,1960,98040,47.549,122.22,2350,12507,54,0,6.75,6300,16457
3.7988e+05,2014,123,3,2.5,1650,14054,1,0,0,4,7,1130,520,1986,1986,98027,47.482,122.02,1940,87555,28,0,5.5,3590,89205
4.2e+05,2014,276,4,1,1750,9600,1,0,0,4,7,1750,0,1954,1954,98006,47.576,122.14,1750,10530,60,0,5,3500,12280
8.7e+05,2014,232,4,2.75,3410,23000,2,0,0,4,10,3410,0,1982,1982,98006,47.556,122.15,2490,15512,32,0,6.75,5900,18922
4.75e+05,2014,255,4,2.5,3150,5757,2,0,0,3,9,3150,0,2004,2004,98058,47.457,122.12,3100,5757,10,0,6.5,6250,8907
8.7e+05,2015,491,4,1.75,2370,5000,1,0,2,3,8,1770,600,1919,1919,98103,47.678,122.36,2100,4550,96,0,5.75,4470,6920
3.5e+05,2014,257,6,4.5,3500,8504,2,0,0,3,7,3500,0,1980,1980,98155,47.735,122.3,1550,8460,34,0,10.5,5050,11960
5.8995e+05,2014,339,3,2.75,1670,1350,3,0,0,3,9,1350,320,2014,2014,98116,47.576,122.41,1520,4800,0,0,5.75,3190,6470
1.68e+05,2014,194,3,1.5,1370,7439,1,0,0,4,6,1370,0,1963,1963,98055,47.45,122.19,2350,3370,51,0,4.5,3720,4740
7.05e+05,2014,271,2,2,1650,6840,1,0,0,5,7,1650,0,1916,1916,98103,47.651,122.34,1700,4560,98,0,4,3350,6210
4.35e+05,2014,283,3,1,1120,9656,1,0,0,5,7,1120,0,1955,1955,98006,47.567,122.14,1720,9908,59,0,4,2840,11028
3.95e+05,2014,175,2,2.25,1350,1493,2,0,0,3,8,1050,300,2007,2007,98136,47.542,122.39,1250,1202,7,0,4.25,2600,2552
2.999e+05,2015,461,3,1.75,1730,9893,1,0,0,4,9,1730,0,1988,1988,98042,47.375,122.16,2120,9108,27,0,4.75,3850,10838
4.5e+05,2015,399,2,1.5,1530,1012,2,0,0,3,8,1200,330,2005,2005,98122,47.602,122.31,1530,1425,10,0,3.5,3060,2955
5.39e+05,2015,407,3,2.75,2130,1400,2,0,0,3,9,1080,1050,2010,2010,98118,47.566,122.29,1520,3132,5,0,5.75,3650,5262
2.8e+05,2014,287,4,2,1710,5440,1,0,0,5,8,1030,680,1976,1976,98042,47.366,122.09,1620,6696,38,0,6,3330,8406
3.4e+05,2015,415,2,1,690,5200,1,0,0,3,6,690,0,1918,1918,98136,47.556,122.39,1380,5700,97,0,3,2070,6390
3.46e+05,2015,409,5,1,1790,30456,1,0,0,4,7,1350,440,1964,1964,98030,47.347,122.19,2420,35647,51,0,6,4210,37437
8.525e+05,2014,245,4,2.5,3480,6315,2,0,0,3,9,2360,1120,2000,2000,98052,47.684,122.16,3620,5233,14,0,6.5,7100,8713
4.966e+05,2014,305,3,2.5,1910,5562,2,0,0,3,8,1910,0,1988,1988,98029,47.574,122.02,1940,4647,26,0,5.5,3850,6557
8.5e+05,2014,204,2,2.5,3360,6750,2,0,0,3,9,3360,0,2004,2004,98053,47.711,122.03,2510,6750,10,0,4.5,5870,10110
4.57e+05,2015,450,2,2,1440,9985,1,0,0,3,8,1440,0,2006,2006,98053,47.722,122.03,1510,4560,9,0,4,2950,6000
2.89e+05,2014,304,3,1.75,1580,9750,1,0,0,5,7,1580,0,1954,1954,98148,47.427,122.33,1460,9750,60,0,4.75,3040,11330
4.18e+05,2014,272,5,2.5,1980,10205,1,0,0,4,7,1080,900,1929,1929,98115,47.699,122.31,1310,5413,85,0,7.5,3290,7393
2.2e+05,2014,359,3,1,1230,9720,1,0,0,5,7,1230,0,1969,1969,98042,47.327,122.14,1230,9720,45,0,4,2460,10950
3.05e+05,2014,204,3,1.75,1400,10350,1,0,0,4,7,1400,0,1976,1976,98059,47.479,122.13,1780,10457,38,0,4.75,3180,11857
9.22e+05,2014,299,4,2.5,2620,14126,1,0,4,4,8,1620,1000,1941,1941,98117,47.698,122.4,2620,8905,73,0,6.5,5240,11525
6.35e+05,2015,413,3,1.75,1340,3900,2,0,0,5,7,1340,0,1900,1900,98107,47.671,122.38,1470,1611,115,0,4.75,2810,2951
2.03e+05,2014,231,2,1,1440,6650,1,0,0,3,7,970,470,1980,1980,98023,47.29,122.37,1600,6847,34,0,3,3040,8287
2.58e+05,2015,409,2,2,750,6553,1,0,2,3,7,750,0,1945,1945,98178,47.498,122.22,1140,7500,70,0,4,1890,8250
2.51e+05,2015,471,3,1,840,4495,1,0,0,3,6,840,0,1921,1921,98146,47.496,122.35,1260,7434,94,0,4,2100,8274
3.6276e+05,2014,195,3,2,1460,4350,2,0,0,3,7,1460,0,2008,2008,98053,47.696,122.03,1740,4622,6,0,5,3200,6082
4.25e+05,2014,173,3,2.25,1580,39189,1,0,0,3,7,1180,400,1992,1992,98053,47.636,121.97,1580,29649,22,0,5.25,3160,31229
3.12e+05,2015,456,4,2.5,1790,10584,1,0,0,4,7,1290,500,1981,1981,98031,47.406,122.19,1730,9120,34,0,6.5,3520,10910
5.5e+05,2015,481,4,2.5,3220,9328,2,0,0,3,8,3220,0,2006,2006,98019,47.727,121.96,3020,9300,9,0,6.5,6240,12520
7.36e+05,2014,291,3,2.5,1980,2975,3,0,2,3,8,1980,0,1993,1993,98109,47.629,122.34,1980,3144,21,0,5.5,3960,5124
2.1495e+05,2014,161,3,1.75,1570,4875,1,0,0,4,7,1310,260,1977,1977,98042,47.362,122.09,1380,5200,37,0,4.75,2950,6770
4.38e+05,2014,128,2,1,980,1179,2,0,0,3,8,980,0,2010,2010,98119,47.638,122.38,1190,1600,4,0,3,2170,2580
6.35e+05,2015,429,5,1.75,2240,4750,1,0,0,4,7,1120,1120,1920,1920,98115,47.673,122.29,1980,4750,95,0,6.75,4220,6990
4.75e+05,2015,433,3,1.75,1520,8100,1,0,0,5,6,760,760,1945,1945,98117,47.697,122.38,1040,8100,70,0,4.75,2560,9620
2.93e+05,2015,413,3,2.5,1990,7577,2,0,0,3,7,1990,0,1990,1990,98023,47.291,122.35,1900,7152,25,0,5.5,3890,9142
5.65e+05,2014,230,5,1.75,1910,9720,1,0,0,4,7,1390,520,1955,1955,98006,47.577,122.16,1750,9720,59,0,6.75,3660,11630
2.78e+05,2014,352,3,2.25,1590,9425,1,0,0,3,7,1170,420,1985,1985,98058,47.429,122.16,1590,9394,29,0,5.25,3180,10984
2.759e+05,2015,479,3,1.75,1380,8400,1,0,0,3,7,1380,0,1967,1967,98003,47.312,122.32,1540,8400,48,0,4.75,2920,9780
4.35e+05,2014,167,3,2.25,1230,1238,2,0,0,3,8,1080,150,2009,2009,98199,47.652,122.38,1230,953,5,0,5.25,2460,2183
3.15e+05,2014,262,3,2.5,1950,9618,2,0,0,3,7,1950,0,1992,1992,98031,47.407,122.18,1890,7133,22,0,5.5,3840,9083
3e+05,2014,235,3,2.5,1750,4200,2,0,0,3,7,1750,0,2005,2005,98038,47.361,122.04,1890,4048,9,0,5.5,3640,5798
3.57e+05,2014,283,3,1.75,1250,17493,1,0,0,3,7,1250,0,1972,1972,98155,47.761,122.27,2180,19553,42,0,4.75,3430,20803
2.0595e+05,2014,221,3,1,1490,8239,1,0,0,4,6,1490,0,1963,1963,98023,47.306,122.37,1200,8470,51,0,4,2690,9960
3.6e+05,2014,215,3,1.5,1170,4080,1,0,0,5,6,1170,0,1917,1917,98126,47.534,122.38,920,4242,97,0,4.5,2090,5412
5.1e+05,2015,396,3,2.5,1890,5929,2,0,0,3,8,1890,0,1993,1993,98029,47.57,121.99,2060,5775,22,0,5.5,3950,7665
1.7e+05,2015,409,3,1.5,1370,10176,1,0,0,3,6,1370,0,1947,1947,98168,47.474,122.26,1650,10176,68,0,4.5,3020,11546
5.728e+05,2015,387,3,2.5,3310,4682,2,0,0,3,9,2380,930,2015,2015,98065,47.52,121.89,2660,5166,0,0,5.5,5970,8476
4.9995e+05,2015,396,4,2.25,2160,8817,1,0,0,3,7,1460,700,1965,1965,98133,47.76,122.36,1880,8817,50,0,6.25,4040,10977
2.8e+05,2015,445,3,2.5,1600,6700,2,0,0,3,8,1600,0,1991,1991,98042,47.362,122.07,1790,7577,24,0,5.5,3390,9177
4.272e+05,2015,450,3,1,1030,8400,1,0,0,4,7,1030,0,1963,1963,98056,47.536,122.17,1270,8400,52,0,4,2300,9430
4.05e+05,2014,176,4,2.5,2220,4652,2,0,0,3,7,2220,0,2001,2001,98059,47.49,122.15,1840,4500,13,0,6.5,4060,6720
8.645e+05,2014,314,4,2.5,3520,35991,2,0,0,4,10,3520,0,1992,1992,98077,47.744,122.03,3210,35991,22,0,6.5,6730,39511
3.2e+05,2014,264,4,2.75,2110,13260,1,0,0,4,7,1290,820,1979,1979,98058,47.451,122.16,1980,11016,35,0,6.75,4090,13126
6.65e+05,2015,429,4,2.5,2480,15411,2,0,2,3,8,2480,0,1994,1994,98059,47.538,122.16,2940,14679,21,0,6.5,5420,17159
2.95e+05,2014,128,2,1.75,2200,89298,1,0,0,3,7,1100,1100,1973,1973,98027,47.463,121.98,2590,89298,41,0,3.75,4790,91498
2.87e+05,2015,362,4,1.5,1300,10050,1,0,0,3,7,1300,0,1963,1963,98059,47.49,122.12,1730,10050,52,0,5.5,3030,11350
3.99e+05,2014,298,5,2,2620,7030,1,0,0,3,8,1420,1200,1965,1965,98133,47.734,122.35,1360,7964,49,0,7,3980,10584
4.75e+05,2015,437,3,3,2010,2554,2,0,0,3,7,1860,150,2001,2001,98118,47.553,122.27,1370,5100,14,0,6,3380,7110
4.75e+05,2014,263,3,2.25,1190,1137,2,0,0,3,7,960,230,1999,1999,98115,47.677,122.33,1190,1080,15,0,5.25,2380,2270
1.5e+06,2014,245,3,3.25,3990,8505,2,0,2,3,9,2870,1120,1922,1999,98144,47.574,122.28,3640,8505,92,1,6.25,7630,12495
1.9995e+05,2014,345,2,1.75,870,18537,1,0,0,4,6,870,0,1946,1946,98001,47.275,122.28,1300,22800,68,0,3.75,2170,23670
3.07e+05,2015,429,3,1,770,6552,1,0,0,3,6,670,100,1942,1942,98146,47.513,122.37,920,7200,73,0,4,1690,7970
2.29e+05,2015,386,3,2,1540,6000,1,0,0,4,6,1540,0,1953,1953,98155,47.737,122.31,1490,8213,62,0,5,3030,9753
4.05e+05,2015,480,5,2.75,2400,4900,2,0,0,3,8,2400,0,2011,2011,98038,47.355,122.06,2110,5696,4,0,7.75,4510,8096
6.75e+05,2014,182,5,2.25,2900,10300,1,0,0,3,8,1450,1450,1985,1985,98006,47.546,122.15,2310,10300,29,0,7.25,5210,13200
5.85e+05,2014,321,5,2.25,2480,12614,1,0,0,4,8,1860,620,1979,1979,98011,47.739,122.2,2470,12392,35,0,7.25,4950,14872
6.05e+05,2015,465,3,2.25,1960,10139,2,0,0,3,8,1960,0,1984,1984,98074,47.648,122.06,2080,9753,31,0,5.25,4040,11713
5.15e+05,2015,373,5,2.5,3810,15916,1,0,0,5,8,3810,0,1967,1967,98058,47.452,122.14,2470,11662,48,0,7.5,6280,15472
3.6e+05,2014,129,2,1,1420,81892,1,0,0,3,7,1180,240,1956,1956,98055,47.434,122.19,1490,1863,58,0,3,2910,3283
2.23e+05,2014,153,3,1,1030,9120,1,0,0,3,7,1030,0,1961,1961,98032,47.361,122.29,1470,10220,53,0,4,2500,11250
6.6e+05,2014,151,3,2.25,2675,40910,2,0,0,3,8,2675,0,1984,1984,98075,47.592,122.06,2300,39438,30,0,5.25,4975,42113
5.3e+05,2014,244,3,2,3080,17700,1,0,0,4,8,1740,1340,1965,1965,98166,47.469,122.37,2100,15100,49,0,5,5180,18180
4.05e+05,2014,133,4,1.75,2180,13529,1,0,0,3,7,1090,1090,1956,1956,98155,47.752,122.29,2000,13529,58,0,5.75,4180,15709
2.5e+05,2015,477,3,1,1220,5038,1,0,0,5,6,1220,0,1942,1942,98056,47.496,122.19,1140,5038,73,0,4,2360,6258
4.55e+05,2014,320,2,2,1350,1209,3,0,0,3,8,1350,0,2013,2013,98199,47.649,122.38,1310,982,1,0,4,2660,2332
2.715e+05,2014,231,3,1.75,1995,18360,2,0,0,3,7,1995,0,1957,1957,98198,47.413,122.32,1980,13640,57,0,4.75,3975,15635
6.71e+05,2015,471,4,2.75,1890,1475,2,0,0,3,9,1200,690,2015,2015,98199,47.647,122.38,1650,1682,0,0,6.75,3540,3572
6.75e+05,2014,194,2,1.75,2140,5000,1,0,0,3,7,1000,1140,1930,1991,98112,47.628,122.29,2250,4000,84,1,3.75,4390,6140
2.8e+05,2014,264,3,1.75,2630,6500,1,0,0,3,7,1330,1300,1958,1958,98055,47.488,122.22,2520,6500,56,0,4.75,5150,9130
6.6e+05,2014,176,3,1,1210,9622,1,0,1,3,8,1210,0,1955,2009,98006,47.573,122.18,1580,9714,59,1,4,2790,10924
6.25e+05,2014,122,4,2.5,2820,8408,2,0,0,3,9,2820,0,2014,2014,98155,47.754,122.33,1300,8408,0,0,6.5,4120,11228
3.06e+05,2014,339,2,1.75,1200,2622,1,0,0,5,7,800,400,1956,1956,98125,47.718,122.29,1310,1926,58,0,3.75,2510,3126
4.4e+05,2015,421,3,1.75,1570,5120,1,0,2,3,7,980,590,1947,1947,98177,47.717,122.36,2420,7200,68,0,4.75,3990,8770
4.15e+05,2015,376,3,1,1560,4500,1,0,0,3,7,1560,0,1903,1903,98122,47.612,122.31,1660,4500,112,0,4,3220,6060
3.53e+05,2014,301,3,2.5,1250,864,3,0,0,3,8,1250,0,2004,2004,98115,47.698,122.32,1330,2298,10,0,5.5,2580,3548
6.65e+05,2014,205,3,2.5,3136,54450,1,0,0,5,8,3136,0,1910,1910,98070,47.4,122.47,2300,54450,104,0,5.5,5436,57586
3.599e+05,2015,463,4,2.5,2600,5188,2,0,0,3,8,2600,0,2005,2005,98038,47.345,122.04,2610,5188,10,0,6.5,5210,7788
1.8e+05,2014,217,3,1,1010,10215,1,0,0,3,6,1010,0,1955,1955,98146,47.487,122.34,1320,10245,59,0,4,2330,11255
5.18e+05,2014,243,4,2.5,2160,9750,2,0,0,3,8,2160,0,1983,1983,98028,47.744,122.25,2840,10535,31,0,6.5,5000,12695
6.25e+05,2014,143,3,2.5,2600,10092,1,0,0,3,9,2600,0,1984,1984,98074,47.622,122.03,2440,9298,30,0,5.5,5040,11898
5.25e+05,2014,197,3,2.25,2110,2850,3,0,0,3,8,2110,0,2001,2001,98103,47.691,122.34,1340,5001,13,0,5.25,3450,7111
6e+05,2014,169,4,2.25,3070,8400,2,0,0,4,8,3070,0,1970,1970,98034,47.732,122.17,1880,8000,44,0,6.25,4950,11070
5.2e+05,2014,174,3,1.75,2300,35722,1,0,0,3,9,2300,0,1984,1984,98072,47.745,122.11,2600,34798,30,0,4.75,4900,37098
3.35e+05,2014,331,3,1,980,9903,1,0,0,4,7,980,0,1966,1966,98028,47.775,122.24,1830,9903,48,0,4,2810,10883
4.98e+05,2014,250,3,3,2360,2750,2,0,1,3,7,1780,580,1983,1983,98125,47.714,122.28,1970,5800,31,0,6,4330,8160
2.8e+05,2015,400,3,1.5,1670,11610,1,0,0,4,7,1670,0,1963,1963,98055,47.44,122.19,1930,10200,52,0,4.5,3600,11870
3.7e+05,2014,298,3,1.75,1620,37913,2,0,0,4,7,1620,0,1953,1975,98001,47.288,122.29,2190,21518,61,1,4.75,3810,23138
3.98e+05,2014,304,3,1.75,1830,27468,1,0,0,3,7,1830,0,1954,1954,98028,47.775,122.23,1860,10180,60,0,4.75,3690,12010
1.169e+06,2014,299,5,2.5,2810,6000,2,0,0,3,9,2810,0,1907,1907,98109,47.637,122.35,2240,4800,107,0,7.5,5050,7610
2.25e+05,2015,437,3,1,1010,15701,1,0,0,4,7,1010,0,1949,1949,98188,47.452,122.29,1260,9800,66,0,4,2270,10810
2.5e+05,2014,170,1,1,800,16306,1,0,0,2,6,680,120,1931,1931,98168,47.492,122.31,1270,8666,83,0,2,2070,9466
4.35e+05,2014,303,4,2.5,2130,10375,2,0,0,4,8,2130,0,1986,1986,98058,47.438,122.16,2220,8508,28,0,6.5,4350,10638
4.81e+05,2015,431,4,2.5,2480,9869,1,0,0,4,8,1240,1240,1963,1963,98028,47.761,122.23,2230,10310,52,0,6.5,4710,12790
1.5e+06,2014,191,4,3.5,4410,12426,2,0,2,3,12,3420,990,1996,1996,98006,47.552,122.11,4090,12127,18,0,7.5,8500,16537
3.95e+05,2014,152,1,1,730,3000,1,0,0,3,7,730,0,1911,1911,98107,47.674,122.4,1520,5000,103,0,2,2250,5730
2e+05,2015,366,3,1,1230,4380,1,0,0,3,6,1230,0,1947,1947,98106,47.535,122.36,1525,6026,68,0,4,2755,7256
3.465e+05,2014,272,4,2.5,2150,5100,1,0,0,3,7,1290,860,1991,1991,98106,47.534,122.36,1920,5100,23,0,6.5,4070,7250
7.5e+05,2014,272,4,2.75,3190,9023,2,0,0,3,9,3190,0,2005,2005,98075,47.59,121.99,3159,5615,9,0,6.75,6349,8805
3.07e+05,2014,142,3,1.5,2320,7500,1,0,0,3,7,2320,0,1976,1976,98019,47.741,121.98,1480,10000,38,0,4.5,3800,12320
4.12e+05,2014,271,2,1,1040,5120,1,0,0,3,7,1040,0,1901,1901,98122,47.605,122.31,1250,4000,113,0,3,2290,5040
1.8e+05,2014,313,3,1,940,11055,1,0,0,4,7,940,0,1959,1959,98032,47.373,122.3,1420,9100,55,0,4,2360,10040
2.65e+05,2015,399,2,1,820,8423,1,0,2,3,6,820,0,1957,1957,98055,47.474,122.2,1960,9140,58,0,3,2780,9960
7.0411e+05,2015,430,4,2.75,2460,9520,1,0,1,3,8,1680,780,1976,1976,98034,47.702,122.23,2380,9600,39,0,6.75,4840,12060
2.9205e+05,2014,147,5,3,2840,7199,1,0,0,3,7,1710,1130,2003,2003,98178,47.507,122.28,2210,10800,11,0,8,5050,13640
3.65e+05,2014,153,3,2.5,1720,99916,2,0,0,4,7,1720,0,1990,1990,98042,47.339,122.09,1340,73180,24,0,5.5,3060,74900
3.45e+05,2014,182,5,2.5,2450,6994,2,0,0,3,8,2450,0,2002,2002,98030,47.357,122.19,1940,6035,12,0,7.5,4390,8485
5.5e+05,2015,470,3,1.75,1890,1.0062e+05,1,0,3,3,8,1890,0,1978,1978,98053,47.645,121.98,2110,50529,37,0,4.75,4000,52419
9.7e+05,2014,208,4,4.5,3890,5906,2,0,3,3,11,3060,830,2004,2004,98029,47.543,122,4170,6052,10,0,8.5,8060,9942
6.5e+05,2014,279,4,1.75,2640,8215,1,0,0,4,7,1500,1140,1966,1966,98008,47.582,122.13,2070,7875,48,0,5.75,4710,10515
4.165e+05,2014,211,3,1,1100,4184,1,0,0,4,7,1100,0,1965,1965,98136,47.531,122.38,1630,4366,49,0,4,2730,5466
2.6e+05,2015,445,4,2.5,2360,9647,1,0,2,3,8,1530,830,1964,1964,98003,47.337,122.33,2580,9680,51,0,6.5,4940,12040
6.5e+05,2014,242,4,3,2900,15535,1,0,2,4,7,1870,1030,1961,1961,98008,47.612,122.12,2330,10217,53,0,7,5230,13117
4.867e+05,2015,445,2,1,1200,6278,1,0,0,3,7,1080,120,1942,1942,98103,47.7,122.35,1200,6211,73,0,3,2400,7411
5.09e+05,2014,263,2,2,1560,4675,1,0,0,3,8,1560,0,2006,2006,98053,47.709,122.02,1870,6361,8,0,4,3430,7921
3.05e+05,2014,208,4,2.5,2250,9091,1,0,0,3,7,1340,910,1982,1982,98001,47.336,122.27,1540,7802,32,0,6.5,3790,10052
4.2e+05,2014,148,3,1.75,1820,22320,1,0,0,3,7,1250,570,1977,1977,98053,47.644,121.96,2030,22320,37,0,4.75,3850,24140
5.8e+05,2015,465,3,1.5,1320,1250,3,0,0,3,8,1320,0,2008,2008,98103,47.654,122.34,1560,1694,7,0,4.5,2880,3014
6.75e+05,2015,374,3,3.25,1510,2064,2,0,0,3,8,1220,290,2008,2008,98109,47.64,122.34,1670,2594,7,0,6.25,3180,4104
5.1e+05,2014,279,3,2,1990,7405,1,0,0,5,7,1990,0,1971,1971,98006,47.542,122.17,2120,6462,43,0,5,4110,8452
5.8e+05,2015,433,3,2.25,1580,8506,2,0,0,3,7,1580,0,1987,1987,98033,47.686,122.19,2253,8515,28,0,5.25,3833,10095
4.215e+05,2015,472,4,3,2793,5703,2,0,0,3,9,2793,0,2009,2009,98030,47.368,122.18,2793,5704,6,0,7,5586,8497
5.05e+05,2014,285,2,2.5,1430,1201,3,0,0,3,8,1430,0,2009,2009,98107,47.671,122.38,1430,1249,5,0,4.5,2860,2679
5.2989e+05,2015,408,4,2.5,3140,8455,2,0,0,3,8,3140,0,2003,2003,98059,47.487,122.15,3140,7391,12,0,6.5,6280,10531
6.5e+05,2014,352,3,1.5,1380,4290,1,0,0,3,7,1080,300,1955,1955,98107,47.674,122.38,1510,3900,59,0,4.5,2890,5280
3.85e+05,2014,166,4,1.75,1690,4080,1,0,0,4,7,870,820,1984,1984,98144,47.572,122.29,1320,4080,30,0,5.75,3010,5770
9.6e+05,2014,215,5,3.5,4510,16305,2,0,0,3,10,2820,1690,2003,2003,98074,47.635,122.01,4330,18741,11,0,8.5,8840,23251
3.15e+05,2014,251,3,1,1210,8505,1,0,0,3,7,1210,0,1958,1958,98106,47.539,122.35,1430,8505,56,0,4,2640,9715
5.675e+05,2015,487,4,1.75,2190,5060,1,0,0,3,7,1190,1000,1950,1950,98116,47.585,122.39,1510,4600,65,0,5.75,3700,6790
1.64e+05,2014,303,3,1,1070,8250,1,0,0,3,7,1070,0,1961,1961,98092,47.29,122.19,1190,8250,53,0,4,2260,9320
7.18e+05,2014,319,3,1.75,2280,3446,2,0,0,3,8,2280,0,1949,1991,98125,47.715,122.28,1610,6670,65,1,4.75,3890,8950
3.6399e+05,2014,153,4,2.5,2240,3712,2,0,0,3,8,2240,0,2014,2014,98038,47.355,122.06,2530,4315,0,0,6.5,4770,6555
3.175e+05,2015,432,4,2.5,2233,6025,2,0,0,3,7,2233,0,2012,2012,98001,47.26,122.26,1544,6036,3,0,6.5,3777,8269
6.7e+05,2015,469,3,1.75,1850,8160,1,0,0,3,8,1850,0,1952,1952,98177,47.724,122.36,1600,8160,63,0,4.75,3450,10010
5.35e+05,2014,143,3,2.5,2210,7620,2,0,0,3,8,2210,0,1994,1994,98052,47.694,122.13,1920,7440,20,0,5.5,4130,9650
3.35e+05,2014,192,3,1,950,8000,1,0,0,3,7,950,0,1968,1968,98034,47.719,122.18,2270,8540,46,0,4,3220,9490
6.6e+05,2014,174,2,2.25,2550,6000,2,0,0,5,7,1860,690,1902,1902,98115,47.674,122.32,2010,4000,112,0,4.25,4560,6550
9.98e+05,2014,311,4,3.5,3500,43560,2,0,0,3,9,2850,650,2014,2014,98006,47.548,122.1,3640,40545,0,0,7.5,7140,44045
8.125e+05,2014,218,4,2.75,2810,10300,1,0,0,4,9,1810,1000,1978,1978,98006,47.563,122.15,2710,9900,36,0,6.75,5520,12710
6.2e+05,2014,125,3,1.75,1480,2185,2,0,0,3,9,1480,0,2005,2005,98034,47.694,122.17,1480,2441,9,0,4.75,2960,3921
3.575e+05,2015,368,5,3,3270,9146,2,0,0,3,7,3270,0,2002,2002,98092,47.334,122.17,3200,6300,13,0,8,6470,9570
2.9e+05,2015,374,4,2.5,2050,9015,2,0,0,4,7,2050,0,1973,1973,98058,47.436,122.17,1780,8820,42,0,6.5,3830,10870
4.55e+05,2014,245,5,2.25,3470,28212,1,0,0,4,8,2790,680,1978,1978,98042,47.334,122.11,2020,28177,36,0,7.25,5490,31647
1.135e+06,2015,430,4,3.25,2960,4296,2,0,0,3,9,2190,770,2007,2007,98119,47.653,122.37,2150,6000,8,0,7.25,5110,8960
6.9e+05,2014,288,4,3.5,2980,2147,2,0,0,3,10,2490,490,2006,2006,98029,47.546,122,2880,2428,8,0,7.5,5860,5408
2.6e+05,2014,230,3,1.75,1340,8000,1,0,0,3,7,1340,0,1980,1980,98038,47.365,122.04,1690,8000,34,0,4.75,3030,9340
1.5e+05,2014,360,2,1,870,5700,1,0,0,4,6,870,0,1957,1957,98056,47.498,122.17,1020,5700,57,0,3,1890,6570
2.5e+05,2015,409,2,1,850,6370,1,0,0,3,6,850,0,1951,1951,98126,47.52,122.37,850,5170,64,0,3,1700,6020
4.15e+05,2014,229,5,1.75,1960,3748,1,0,0,3,7,980,980,1965,1965,98133,47.703,122.35,1410,3844,49,0,6.75,3370,5804
2.35e+05,2014,286,3,1,1270,7153,1,0,0,5,6,1270,0,1949,1949,98055,47.481,122.23,1650,7153,65,0,4,2920,8423
7.85e+05,2014,122,5,3.25,3660,11995,2,0,2,3,10,3660,0,2006,2006,98065,47.534,121.86,3320,11241,8,0,8.25,6980,14901
5.485e+05,2015,456,4,2,1820,7200,1,0,0,3,7,1300,520,1976,1976,98136,47.516,122.39,1770,8149,39,0,6,3590,9969
4.15e+05,2015,479,4,2,1960,10559,2,0,0,4,7,1960,0,1955,1955,98133,47.749,122.34,1580,7769,60,0,6,3540,9729
2.13e+05,2014,159,4,1.75,1980,9000,1,0,0,2,7,1480,500,1978,1978,98023,47.307,122.38,1980,9360,36,0,5.75,3960,11340
2.89e+05,2014,255,4,2.25,1930,8925,1,0,0,4,8,1930,0,1974,1974,98058,47.45,122.13,1930,8400,40,0,6.25,3860,10330
6.75e+05,2014,349,4,2.5,2940,14071,2,0,0,3,9,2940,0,1986,1986,98029,47.563,122.02,2670,10982,28,0,6.5,5610,13922
4.27e+05,2015,486,3,2.5,2620,1.0846e+05,2,0,0,4,8,2620,0,1990,1990,98038,47.458,122.04,3190,1.0585e+05,25,0,5.5,5810,1.0847e+05
7.781e+05,2015,486,2,1,1480,4080,1,0,0,3,7,1050,430,1949,1949,98117,47.684,122.39,1310,4080,66,0,3,2790,5560
3.25e+05,2014,211,3,1,1410,8250,1,0,0,3,7,1410,0,1954,1954,98177,47.762,122.36,1580,8250,60,0,4,2990,9660
3.29e+05,2014,140,4,2.5,1600,6765,1,0,0,3,7,830,770,1947,2011,98106,47.547,122.36,1600,8942,67,1,6.5,3200,10542
6.035e+05,2014,173,6,2.75,2660,8400,1,0,0,5,8,1550,1110,1962,1962,98006,47.549,122.17,2280,8400,52,0,8.75,4940,11060
5.65e+05,2015,458,5,1.5,1940,3430,1,0,0,4,6,1220,720,1926,1926,98117,47.685,122.36,1830,4120,89,0,6.5,3770,6060
2.825e+05,2014,203,3,2.25,1670,7150,2,0,0,4,7,1670,0,1990,1990,98042,47.36,122.09,1570,7040,24,0,5.25,3240,8710
6.5e+05,2014,161,2,1,1030,5750,1,0,0,5,8,1030,0,1928,1928,98116,47.586,122.39,1570,5750,86,0,3,2600,6780
4.36e+05,2015,413,3,2.25,1480,1384,3,0,0,3,8,1480,0,2008,2008,98103,47.691,122.34,1310,1329,7,0,5.25,2790,2809
3.6e+05,2014,143,3,2,1270,1323,3,0,0,3,8,1270,0,2006,2006,98103,47.693,122.34,1330,1323,8,0,5,2600,2593
4.19e+05,2015,372,4,1.5,2150,23568,1,0,0,4,7,2150,0,1950,1950,98166,47.452,122.36,2150,10125,65,0,5.5,4300,12275
3.4e+05,2015,491,4,1.75,1400,8374,1,0,0,3,7,1400,0,1953,1953,98166,47.474,122.34,1420,8360,62,0,5.75,2820,9760
2.15e+05,2014,134,2,1,1240,7200,1,0,0,3,7,1240,0,1967,1967,98168,47.497,122.28,1130,9200,47,0,3,2370,10440
4.1099e+05,2015,452,3,1.75,1000,14061,1,0,0,4,7,1000,0,1967,1967,98072,47.742,122.09,1260,12635,48,0,4.75,2260,13635
5.06e+05,2014,169,2,1,1570,8210,1,0,0,4,8,1150,420,1952,1952,98177,47.722,122.37,1680,8196,62,0,3,3250,9766
6.1e+05,2014,299,4,2.25,2200,7200,1,0,2,4,8,1220,980,1958,1958,98144,47.582,122.3,1940,6000,56,0,6.25,4140,8200
5.55e+05,2014,187,3,1.5,1740,4200,1,0,0,4,7,1640,100,1920,1920,98117,47.678,122.36,1660,3750,94,0,4.5,3400,5490
3.5e+05,2014,266,3,1,1180,7455,1,0,0,4,7,1180,0,1964,1964,98034,47.728,122.24,1450,8154,50,0,4,2630,9334
3.8e+05,2015,444,2,1,1140,75132,1,0,0,3,7,1140,0,1956,1956,98077,47.735,122.07,2570,35200,59,0,3,3710,36340
4.425e+05,2014,139,3,1.75,1800,10200,1,0,0,3,8,1800,0,1967,1967,98058,47.45,122.15,2140,10128,47,0,4.75,3940,11928
7e+05,2015,464,4,2.75,3350,7857,2,0,2,3,9,3350,0,2004,2004,98065,47.54,121.86,3870,7886,11,0,6.75,7220,11236
2.82e+05,2014,170,4,2,1890,6302,2,0,0,3,7,1890,0,1997,1997,98030,47.385,122.2,1690,5369,17,0,6,3580,7259
6.85e+05,2014,196,4,2.5,2170,8680,1,0,0,3,7,1220,950,1959,1959,98004,47.608,122.19,2010,8680,55,0,6.5,4180,10850
1.3e+05,2014,225,2,1,880,9000,1,0,0,3,5,880,0,1928,1928,98188,47.467,122.29,1410,10000,86,0,3,2290,10880
3.799e+05,2014,194,3,2.5,1800,2791,2,0,0,3,8,1800,0,2011,2011,98126,47.544,122.37,1580,2617,3,0,5.5,3380,4417
6.48e+05,2014,216,4,2.5,2620,5450,2,0,0,3,9,2620,0,2001,2001,98074,47.63,122.02,2590,5371,13,0,6.5,5210,7991
3.69e+05,2014,150,3,2,1550,8509,1,0,0,3,7,1150,400,1959,1959,98106,47.53,122.34,1840,7620,55,0,5,3390,9170
2.35e+05,2014,191,3,2.5,2350,9051,1,0,0,4,8,1570,780,1966,1966,98023,47.313,122.36,2270,8748,48,0,5.5,4620,11098
4.2e+05,2014,189,3,1.75,1510,6360,1,0,0,4,7,1510,0,1954,1954,98133,47.732,122.35,1480,7260,60,0,4.75,2990,8770
4.35e+05,2014,189,4,2.5,2550,5200,2,0,0,3,7,2550,0,2009,2009,98059,47.492,122.15,2550,4660,5,0,6.5,5100,7210
5e+05,2014,257,3,1.5,2040,6750,1,0,0,3,7,1280,760,1950,1950,98117,47.701,122.37,1970,6750,64,0,4.5,4010,8790
5.66e+05,2014,129,3,2.25,1660,10140,1,0,0,4,8,1370,290,1980,1980,98052,47.689,122.13,2100,10125,34,0,5.25,3760,11785
5.15e+05,2014,331,2,1,910,4725,1,0,0,3,7,910,0,1949,1949,98115,47.676,122.28,1600,5200,65,0,3,2510,6110
3.25e+05,2015,492,3,2.25,1330,969,3,0,0,3,7,1330,0,2007,2007,98125,47.718,122.29,1310,1941,8,0,5.25,2640,3271
5.6e+05,2015,467,4,1.75,2150,8555,1,0,2,4,7,1460,690,1982,1982,98106,47.534,122.34,1480,7405,33,0,5.75,3630,9555
2.89e+05,2014,174,3,2.5,1970,9607,2,0,0,3,7,1090,880,1988,1988,98001,47.346,122.29,2020,9608,26,0,5.5,3990,11578
3.09e+05,2015,478,3,1,1300,7200,1,0,0,4,7,1300,0,1952,1952,98146,47.506,122.37,1740,7100,63,0,4,3040,8400
4.75e+05,2014,239,2,1,870,7975,1,0,2,3,7,870,0,1946,1946,98107,47.67,122.36,1080,5722,68,0,3,1950,6592
4.17e+05,2014,230,3,2.5,1300,877,2,0,0,3,7,1060,240,2008,2008,98199,47.659,122.39,1320,1414,6,0,5.5,2620,2714
5.375e+05,2014,128,4,2.5,2550,4630,2,0,0,3,7,2550,0,2005,2005,98075,47.593,122,2550,5151,9,0,6.5,5100,7701
7.395e+05,2014,285,3,3.25,4460,51177,2,0,0,3,9,4460,0,2005,2005,98042,47.365,122.14,2670,38925,9,0,6.25,7130,43385
8.5e+05,2015,426,3,2.5,2340,1919,2,0,2,4,9,2340,0,1981,1981,98033,47.651,122.2,2415,2166,34,0,5.5,4755,4506
5.85e+05,2015,443,4,3,3400,5100,2,0,0,3,9,3400,0,2006,2006,98038,47.355,122,3400,5672,9,0,7,6800,9072
5.9e+05,2014,218,3,2.5,2210,8622,2,0,0,3,8,2210,0,1988,1988,98029,47.572,122.02,2340,7192,26,0,5.5,4550,9402
5.78e+05,2014,228,3,1,1500,4500,1,0,0,3,7,1120,380,1938,1938,98117,47.687,122.39,1440,4500,76,0,4,2940,6000
6.1e+05,2015,400,3,1.75,1110,10402,1,0,0,4,7,1110,0,1967,1967,98006,47.568,122.18,2050,9660,48,0,4.75,3160,10770
3.3995e+05,2014,314,5,2,1890,6050,2,0,0,4,7,1890,0,1944,1944,98178,47.502,122.24,1170,6050,70,0,7,3060,7940
5.65e+05,2014,318,5,3.25,2860,20790,1,0,0,4,7,1800,1060,1965,1965,98155,47.776,122.3,1920,9612,49,0,8.25,4780,12472
6.2e+05,2015,438,5,3.25,3160,10587,1,0,0,5,7,2190,970,1960,1960,98034,47.724,122.17,2200,7761,55,0,8.25,5360,10921
2.4e+05,2014,175,3,2.25,1481,2820,2,0,0,3,7,1481,0,2012,2012,98002,47.346,122.22,1481,3028,2,0,5.25,2962,4509
2.95e+05,2015,480,2,1.5,988,1080,3,0,0,3,7,988,0,2007,2007,98125,47.712,122.3,1128,1080,8,0,3.5,2116,2068
3.25e+05,2015,424,3,2.25,1890,9646,1,0,0,3,8,1890,0,1966,1966,98168,47.484,122.3,1580,9488,49,0,5.25,3470,11378
6.267e+05,2015,484,3,1.5,1410,3600,1,0,0,3,7,1410,0,1906,1906,98109,47.64,122.36,1370,3600,109,0,4.5,2780,5010
2.5795e+05,2014,122,3,1.75,1370,5858,1,0,0,3,7,1370,0,1987,1987,98198,47.382,122.31,1400,7500,27,0,4.75,2770,8870
9.25e+05,2015,443,4,2.25,2110,6375,1,0,2,4,8,1600,510,1941,1941,98115,47.682,122.27,2760,6375,74,0,6.25,4870,8485
2.12e+05,2014,195,3,1,1040,6800,1,0,0,5,6,1040,0,1951,1951,98178,47.492,122.22,1430,6080,63,0,4,2470,7120
5.37e+05,2015,450,4,2.5,1990,2660,2,0,0,3,8,1990,0,2012,2012,98034,47.732,122.18,1990,2665,3,0,6.5,3980,4655
2.15e+05,2014,201,4,2,1540,7575,1,0,0,4,7,1040,500,1978,1978,98032,47.366,122.28,1720,7575,36,0,6,3260,9115
8.25e+05,2015,480,3,2.25,2980,86636,1,0,0,3,9,2230,750,1989,1989,98053,47.663,122,2980,1.0716e+05,26,0,5.25,5960,1.1014e+05
4.57e+05,2014,320,2,1.75,2060,7192,1,0,0,3,7,1420,640,1940,1940,98125,47.704,122.32,1860,7140,74,0,3.75,3920,9200
2.15e+05,2014,279,3,1,810,5240,1,0,0,3,6,810,0,1942,1942,98166,47.473,122.35,1700,5245,72,0,4,2510,6055
4.75e+05,2014,126,6,3,3470,1.1761e+05,1,0,0,3,7,3470,0,1924,1924,98028,47.766,122.23,2120,17100,90,0,9,5590,20570
5.75e+05,2015,386,5,2.5,1970,12375,1,0,0,3,8,1570,400,1959,1959,98133,47.741,122.35,1970,8941,56,0,7.5,3940,10911
3.85e+05,2014,216,4,1.75,1800,10890,1,0,0,4,6,1800,0,1912,1912,98027,47.531,122.04,1530,9818,102,0,5.75,3330,11618
4.8e+05,2015,387,4,2.5,2480,5100,2,0,0,3,8,2480,0,2007,2007,98019,47.738,121.97,2270,5115,8,0,6.5,4750,7595
6.75e+05,2014,252,4,2.75,2280,3200,1,0,0,5,8,1520,760,1931,1931,98105,47.671,122.28,1970,4687,83,0,6.75,4250,6967
2.071e+05,2014,238,2,1,1000,4500,1,0,0,3,6,1000,0,1916,1916,98055,47.49,122.2,980,4837,98,0,3,1980,5837
5.125e+05,2014,141,3,2.5,1900,7604,2,0,0,3,8,1900,0,1990,1990,98033,47.7,122.19,1980,9583,24,0,5.5,3880,11483
4.27e+05,2014,150,5,2.75,2220,4000,1,0,0,3,7,1230,990,1973,1973,98144,47.575,122.31,1580,4000,41,0,7.75,3800,6220
5.4e+05,2014,224,4,2.5,1850,7850,2,0,0,3,8,1850,0,1985,1985,98052,47.691,122.1,1830,8140,29,0,6.5,3680,9990
5.277e+05,2014,188,5,2.5,2820,9375,1,0,0,4,8,1550,1270,1968,1968,98006,47.571,122.13,2820,9375,46,0,7.5,5640,12195
1.899e+05,2014,202,2,1,1000,4179,1,0,0,5,5,1000,0,1914,1914,98002,47.297,122.23,1010,6327,100,0,3,2010,7327
3.8e+05,2014,211,3,2,2010,16736,2,0,0,4,6,2010,0,1929,1929,98133,47.764,122.35,1890,11477,85,0,5,3900,13487
3.12e+05,2014,319,3,2.5,2280,6386,2,0,0,3,8,2280,0,2008,2008,98042,47.386,122.1,2550,4835,6,0,5.5,4830,7115
5.7e+05,2015,479,4,2,2000,46902,2,0,0,3,8,2000,0,1978,1978,98075,47.585,122.07,2420,38130,37,0,6,4420,40130
6.765e+05,2014,255,3,1.75,1300,2446,1,0,3,3,8,880,420,1961,1961,98122,47.607,122.28,2440,5051,53,0,4.75,3740,6351
2.1e+05,2015,477,4,1.75,2090,6485,1,0,0,3,7,1280,810,1956,1956,98178,47.496,122.27,2190,9600,59,0,5.75,4280,11690
4.32e+05,2014,142,3,2.75,2200,14925,1,0,0,3,6,1100,1100,1982,1982,98053,47.661,122.06,1520,14212,32,0,5.75,3720,16412
2.355e+05,2014,235,3,1.5,1380,7600,1,0,0,4,7,790,590,1971,1971,98003,47.349,122.31,1570,7904,43,0,4.5,2950,9284
3.2995e+05,2015,422,3,2.25,2070,7995,1,0,0,3,7,1350,720,1987,1987,98031,47.403,122.17,1620,6799,28,0,5.25,3690,8869
8.96e+05,2014,180,5,2.75,2520,16100,1,0,3,4,8,1570,950,1960,1960,98040,47.528,122.22,2760,16988,54,0,7.75,5280,19508
2.2712e+06,2014,182,4,3.25,4040,18916,1,0,0,4,9,4040,0,1954,1954,98039,47.615,122.24,3000,18831,60,0,7.25,7040,22871
9.7e+05,2015,433,4,2.75,3600,5040,2,0,0,3,9,2610,990,2004,2004,98199,47.649,122.39,1590,5040,11,0,6.75,5190,8640
2.36e+05,2014,265,3,1,1300,5898,1,0,0,3,7,1300,0,1961,1961,98178,47.505,122.25,1320,7619,53,0,4,2620,8919
5.7e+05,2014,194,4,2.5,2640,4200,2,0,0,3,8,2640,0,1998,1998,98074,47.604,122.02,2460,4200,16,0,6.5,5100,6840
8e+05,2014,196,3,2.5,1630,2640,2,0,0,5,8,1630,0,1919,1919,98119,47.645,122.37,1630,3000,95,0,5.5,3260,4630
4.725e+05,2014,249,3,2.5,1650,3711,2,0,0,3,8,1650,0,1996,1996,98052,47.686,122.09,1760,3762,18,0,5.5,3410,5412
3.065e+05,2014,300,2,1,840,892,2,0,0,3,7,840,0,2006,2006,98136,47.54,122.39,1030,1007,8,0,3,1870,1847
6.5e+05,2014,201,3,2.5,2430,12997,2,0,0,3,9,2430,0,1992,1992,98011,47.744,122.19,2720,12500,22,0,5.5,5150,14930
2.6e+05,2015,409,4,3,1530,8306,2,0,0,3,7,1530,0,2010,2010,98042,47.353,122.15,1930,6925,5,0,7,3460,8455
7.2e+05,2014,167,4,2.5,2650,11520,2,0,0,3,8,2110,540,1988,1988,98033,47.683,122.19,2000,7680,26,0,6.5,4650,10330
2.0495e+05,2014,167,4,1.75,1740,9344,1,0,0,3,7,1180,560,1978,1978,98023,47.32,122.4,1440,12884,36,0,5.75,3180,14624
4.85e+05,2014,310,5,1.5,1420,9900,1,0,0,3,7,1050,370,1964,1964,98008,47.635,122.12,1580,8075,50,0,6.5,3000,9495
2.9895e+05,2014,258,5,2.25,2300,11505,1,0,0,3,8,1300,1000,1963,1963,98030,47.381,122.22,2350,11505,51,0,7.25,4650,13805
3.35e+05,2014,277,2,1.75,1060,1202,2,0,0,3,7,760,300,2003,2003,98136,47.543,122.39,1060,1493,11,0,3.75,2120,2553
5.15e+05,2015,458,3,1.5,2200,7620,1,0,0,4,7,1130,1070,1942,1942,98177,47.726,122.36,2170,7672,73,0,4.5,4370,9872
3.55e+05,2015,439,4,1.5,2020,6000,1,0,0,4,7,1010,1010,1953,1953,98178,47.502,122.23,1710,6000,62,0,5.5,3730,8020
1.6e+05,2014,265,4,1,1520,7298,1,0,0,3,7,1520,0,1960,1960,98198,47.371,122.31,1520,7298,54,0,5,3040,8818
3.31e+05,2015,410,2,2.25,1240,720,2,0,0,3,7,1150,90,2008,2008,98027,47.532,122.07,1260,810,7,0,4.25,2500,2050
4.175e+05,2014,228,3,1,1160,7491,1,0,0,4,6,1160,0,1917,1917,98177,47.702,122.36,1800,2267,97,0,4,2960,3427
2.65e+05,2015,486,3,1,1070,9000,1,0,0,4,7,1070,0,1950,1950,98198,47.406,122.33,1840,12000,65,0,4,2910,13070
2.37e+05,2014,170,3,1,1300,8160,1,0,0,4,7,1300,0,1960,1960,98056,47.511,122.17,1290,8970,54,0,4,2590,10270
2.265e+05,2014,127,3,1.75,1640,10762,1,0,0,3,7,1130,510,1988,1988,98042,47.359,122.07,1680,10259,26,0,4.75,3320,11899
2.1e+05,2014,352,1,1,1050,7583,1,0,0,4,6,1050,0,1947,1947,98133,47.729,122.34,1420,7560,67,0,2,2470,8610
3.4995e+05,2014,269,4,2.5,1820,3134,2,0,0,3,7,1820,0,1999,1999,98019,47.735,121.98,1820,3751,15,0,6.5,3640,5571
5.5e+05,2015,471,3,2.25,1850,37264,2,0,0,3,8,1850,0,1981,1981,98053,47.649,122.03,2390,36036,34,0,5.25,4240,37886
4.35e+05,2014,217,3,1,1050,5500,1,0,0,3,6,930,120,1920,1920,98126,47.54,122.38,1410,5834,94,0,4,2460,6884
1.83e+05,2014,211,3,1.5,1280,4366,2,0,0,4,6,1280,0,1985,1985,98002,47.335,122.22,1280,4366,29,0,4.5,2560,5646
3.62e+05,2014,310,3,1.75,1120,9730,1,0,0,3,7,1120,0,1944,1989,98011,47.737,122.22,2530,8717,70,1,4.75,3650,9837
4.138e+05,2014,141,3,2,1440,4421,1,0,0,3,8,1440,0,2007,2007,98053,47.719,122.02,1440,4157,7,0,5,2880,5597
3.1495e+05,2015,478,3,1,1590,8470,1,0,0,4,7,1140,450,1967,1967,98058,47.447,122.16,1570,9375,48,0,4,3160,10965
5.1e+05,2015,491,3,1.75,1950,8325,1,0,0,4,7,1950,0,1962,1962,98011,47.769,122.2,1950,8325,53,0,4.75,3900,10275
2.99e+05,2014,314,2,1.5,830,1276,2,0,0,3,7,830,0,2005,2005,98122,47.617,122.3,1540,1484,9,0,3.5,2370,2314
3.35e+05,2014,292,3,2.5,2588,5701,2,0,0,3,8,2588,0,2008,2008,98042,47.345,122.15,2389,5702,6,0,5.5,4977,8290
6.7995e+05,2015,387,3,2.5,2230,3939,2,0,0,3,8,2230,0,2014,2014,98133,47.73,122.33,2230,4200,1,0,5.5,4460,6430
6.5e+05,2014,165,3,1.75,2140,9484,1,0,0,3,7,1290,850,1953,1953,98004,47.623,122.19,1960,9630,61,0,4.75,4100,11770
9.8e+05,2014,194,5,2.5,2750,6000,1,0,0,3,8,1750,1000,1904,1994,98103,47.673,122.33,1520,4158,110,1,7.5,4270,6908
6.25e+05,2015,383,3,1.75,1780,4500,1,0,0,4,7,920,860,1922,1922,98117,47.683,122.36,1360,4000,93,0,4.75,3140,5780
8.75e+05,2015,432,6,3.5,4430,11453,2,0,0,3,9,3000,1430,2001,2001,98056,47.516,122.2,2730,5661,14,0,9.5,7160,10091
5.65e+05,2015,410,4,2,2070,7980,1,0,0,4,7,2070,0,1940,1940,98146,47.509,122.39,1600,7980,75,0,6,3670,10050
7.6e+05,2015,401,5,1.5,3050,2992,1,0,0,4,8,1920,1130,1931,1931,98112,47.621,122.3,1200,1209,84,0,6.5,4250,4259
4.79e+05,2015,433,3,1.75,1470,6018,1,0,0,3,8,1470,0,1987,1987,98074,47.617,122.04,1720,6584,28,0,4.75,3190,8054
8.25e+05,2014,292,4,1.5,2040,6900,2,0,0,3,9,2040,0,1903,1903,98112,47.619,122.28,3150,8220,111,0,5.5,5190,10260
1.15e+06,2015,452,4,3,4160,13170,2,0,0,3,11,3040,1120,2001,2001,98059,47.518,122.15,3780,13148,14,0,7,7940,17308
1.05e+06,2015,399,3,1.75,2650,5512,2,0,0,3,9,2250,400,1984,1984,98112,47.627,122.3,1440,5100,31,0,4.75,4090,7750
1.0547e+06,2014,237,4,3.5,4210,6481,2,0,3,3,9,3260,950,2014,2014,98075,47.577,122.07,3920,5331,0,0,7.5,8130,9541
6.725e+05,2015,484,3,1.75,1580,5750,1,0,2,4,8,1330,250,1947,1947,98199,47.634,122.39,2480,5750,68,0,4.75,4060,7330
3.55e+05,2014,228,2,1,840,6720,1,0,0,3,7,840,0,1952,1952,98116,47.571,122.4,1250,6720,62,0,3,2090,7560
8.4e+05,2014,214,4,1.75,2480,11010,1,0,0,4,9,1630,850,1966,1966,98040,47.538,122.22,2770,10744,48,0,5.75,5250,13224
2.765e+05,2015,492,4,2.25,2380,1.2894e+05,1,0,0,4,7,2380,0,1960,1960,98038,47.425,122.04,1030,1.15e+05,55,0,6.25,3410,1.1738e+05
7.0905e+05,2014,229,4,3.5,2720,9000,2,0,0,3,8,2670,50,1997,1997,98125,47.703,122.3,1960,7772,17,0,7.5,4680,10492
6.1e+05,2015,466,4,2.5,2950,9010,2,0,0,3,9,2950,0,2004,2004,98065,47.531,121.86,3160,8813,11,0,6.5,6110,11763
2.3995e+05,2015,447,3,2.5,1560,4800,2,0,0,4,7,1560,0,1974,1974,98001,47.265,122.28,1510,12240,41,0,5.5,3070,13800
6.47e+05,2015,423,4,2.5,2390,5800,2,0,0,3,9,2390,0,2000,2000,98075,47.596,122.04,2590,6507,15,0,6.5,4980,8897
3.5e+05,2014,331,4,2.25,2190,3850,2,0,0,3,7,2190,0,2006,2006,98059,47.485,122.16,1900,3850,8,0,6.25,4090,6040
3.55e+05,2015,478,3,1.75,1870,8250,2,0,0,3,7,1870,0,1956,1979,98188,47.445,122.28,1350,8714,59,1,4.75,3220,10584
4.4e+05,2014,153,2,1,1230,6600,1,0,0,3,7,1130,100,1906,1906,98118,47.557,122.28,1260,5060,108,0,3,2490,6290
1.275e+06,2014,211,4,2.75,3820,8850,2,0,0,3,10,3820,0,2014,2014,98033,47.651,122.19,2330,12000,0,0,6.75,6150,15820
2.67e+05,2014,307,3,2,1390,6005,2,0,0,3,8,1390,0,2005,2005,98022,47.212,121.99,1264,5550,9,0,5,2654,6940
5.76e+05,2014,166,4,2.5,2440,28405,2,0,0,3,8,2440,0,2002,2002,98028,47.739,122.24,2480,11429,12,0,6.5,4920,13869
3.5e+05,2015,480,3,1,1250,9786,1,0,0,4,7,1250,0,1969,1969,98072,47.762,122.16,1660,9621,46,0,4,2910,10871
5.415e+05,2015,467,2,2.5,1900,3690,2,0,0,3,8,1900,0,2006,2006,98053,47.708,122.02,1900,5153,9,0,4.5,3800,7053
2.02e+05,2014,320,3,1.5,1420,9081,1,0,0,4,6,1420,0,1990,1990,98022,47.195,122,1090,8410,24,0,4.5,2510,9830
5.3e+05,2014,134,4,2.75,2450,15002,1,0,0,5,9,2450,0,1974,1974,98166,47.427,122.34,2650,15055,40,0,6.75,5100,17505
4.9e+05,2014,197,2,1.5,1590,4500,1,0,0,4,7,920,670,1946,1946,98116,47.583,122.39,1900,4450,68,0,3.5,3490,6040
3.66e+05,2014,239,3,2.25,1445,1028,2,0,0,3,7,1300,145,2005,2005,98027,47.534,122.07,1445,1377,9,0,5.25,2890,2822
3.975e+05,2014,249,3,1.75,1300,8480,1,0,0,3,7,1300,0,1969,1969,98052,47.699,122.13,1740,7280,45,0,4.75,3040,8580
4.3e+05,2014,270,2,2.25,1040,1516,2,0,0,3,8,1040,0,2008,2008,98122,47.604,122.31,1560,1920,6,0,4.25,2600,2960
3.35e+05,2014,251,2,1,1510,3844,1,0,0,4,7,1510,0,1923,1970,98133,47.704,122.35,1170,3844,91,1,3,2680,5354
6.55e+05,2014,196,3,2,1410,4800,1,0,0,4,8,1410,0,1927,1927,98118,47.56,122.27,1820,7200,87,0,5,3230,8610
3.6e+05,2015,479,4,3,2483,6870,2,0,0,3,8,2483,0,2005,2005,98030,47.363,122.2,1943,6434,10,0,7,4426,8917
1.088e+06,2015,437,5,3.75,4170,8142,2,0,2,3,10,4170,0,2006,2006,98056,47.535,122.18,3030,7980,9,0,8.75,7200,12150
2.1e+05,2014,265,2,1,880,9750,1,0,0,5,6,880,0,1938,1938,98168,47.489,122.3,1220,9406,76,0,3,2100,10286
6.21e+05,2015,458,4,2.5,2030,9905,1,0,0,4,8,2030,0,1959,1959,98006,47.552,122.18,2130,10008,56,0,6.5,4160,12038
4.3165e+05,2014,314,5,2.5,1710,7700,1,0,0,3,7,1710,0,1962,1962,98007,47.592,122.15,1530,7700,52,0,7.5,3240,9410
3.8e+05,2014,283,4,1.75,1760,7300,1,0,0,3,7,880,880,1956,1956,98008,47.603,122.13,1680,7500,58,0,5.75,3440,9260
2.5e+05,2015,463,3,2,1500,5200,1,0,0,3,7,1060,440,1977,1977,98042,47.365,122.09,1640,5200,38,0,5,3140,6700
5e+05,2015,440,2,2.5,1950,2162,2,0,0,3,9,1500,450,2012,2012,98118,47.562,122.29,1800,2457,3,0,4.5,3750,4407
2.6025e+05,2015,382,3,1.75,1490,8357,1,0,0,4,7,1490,0,1993,1993,98038,47.347,122.04,1490,7376,22,0,4.75,2980,8866
4.05e+05,2014,188,3,1.5,1010,7683,1,0,0,5,7,1010,0,1953,1953,98125,47.72,122.32,1550,7271,61,0,4.5,2560,8281
3.55e+05,2014,190,3,2.5,2110,4038,2,0,0,4,8,2110,0,1989,1989,98042,47.388,122.15,2110,3727,25,0,5.5,4220,5837
3e+05,2014,198,4,1.5,1460,8760,1,0,0,3,7,1460,0,1958,1958,98166,47.47,122.36,1610,9375,56,0,5.5,3070,10835
3.45e+05,2015,425,4,1,2020,18150,1,0,0,4,7,2020,0,1955,1955,98028,47.739,122.25,1530,11970,60,0,5,3550,13990
4.35e+05,2014,181,3,2.5,2530,13446,2,0,0,3,9,2530,0,1993,1993,98019,47.734,121.96,2450,13446,21,0,5.5,4980,15976
8.1e+05,2014,172,4,2.5,2810,10613,2,0,0,3,9,2810,0,1989,1989,98006,47.542,122.14,2800,9933,25,0,6.5,5610,12743
5e+05,2014,265,2,1,1510,4000,1,0,0,3,6,930,580,1924,1924,98117,47.692,122.38,1300,4000,90,0,3,2810,5510
3e+06,2014,168,4,4.25,4850,12445,2,1,4,5,10,3850,1000,1989,1989,98034,47.701,122.24,3350,12210,25,0,8.25,8200,17060
4.325e+05,2014,320,3,1.75,1470,7350,1,0,0,3,8,1470,0,1963,1963,98052,47.669,122.15,1470,7350,51,0,4.75,2940,8820
6.6e+05,2014,321,5,3.5,3160,5175,2,0,0,3,9,3160,0,2014,2014,98011,47.755,122.22,2100,9351,0,0,8.5,5260,12511
3.19e+05,2015,369,4,2.5,2020,5100,2,0,0,3,7,2020,0,2010,2010,98023,47.282,122.36,2300,5685,5,0,6.5,4320,7705
3.2995e+05,2015,432,3,1.75,1360,13320,1,0,0,4,7,1360,0,1985,1985,98059,47.462,122.07,1580,13625,30,0,4.75,2940,14985
4.79e+05,2014,167,2,2.25,1230,932,2,0,0,3,8,1020,210,2004,2004,98112,47.619,122.3,1230,1064,10,0,4.25,2460,2294
2.2e+05,2014,311,4,2.25,1950,7280,2,0,0,4,8,1950,0,1979,1979,98023,47.296,122.37,1910,7280,35,0,6.25,3860,9230
5.62e+05,2014,126,5,2.25,3040,8111,2,0,0,3,8,3040,0,1984,1984,98052,47.716,122.1,2020,8304,30,0,7.25,5060,11344
6.18e+05,2014,210,4,2.25,2530,8736,1,0,0,4,7,1210,1320,1958,1958,98008,47.605,122.13,1720,8500,56,0,6.25,4250,11030
1.03e+06,2014,163,4,2.5,2750,4800,2,0,0,3,9,1960,790,1905,2005,98103,47.671,122.34,2400,5300,109,1,6.5,5150,8050
3.7995e+05,2014,292,3,1,1270,6900,1,0,0,3,7,1270,0,1977,1977,98034,47.728,122.19,1480,7280,37,0,4,2750,8550
5.15e+05,2014,181,2,1,1050,5000,1,0,0,5,7,1050,0,1907,1907,98107,47.67,122.37,1340,5000,107,0,3,2390,6050
6.5e+05,2015,451,4,2.25,2330,7220,2,0,1,3,8,1600,730,1988,1988,98177,47.776,122.39,2220,9100,27,0,6.25,4550,11430
2.9445e+05,2014,335,4,2.25,1400,7341,1,0,0,3,7,1300,100,1961,1961,98155,47.757,122.31,2090,7410,53,0,6.25,3490,8810
5.18e+05,2015,458,5,2.5,2890,13104,2,0,0,3,8,2890,0,2006,2006,98019,47.728,121.96,3020,9300,9,0,7.5,5910,12190
5.95e+05,2015,446,3,2.5,2550,6677,2,0,0,3,8,2550,0,2002,2002,98028,47.734,122.23,1930,7217,13,0,5.5,4480,9767
3.115e+05,2015,403,4,2.5,1940,10133,2,0,0,3,8,1940,0,1992,1992,98031,47.388,122.17,1940,7265,23,0,6.5,3880,9205
2.95e+05,2015,396,4,1.75,1800,28650,1,0,0,4,7,1800,0,1975,1975,98031,47.393,122.17,1800,5234,40,0,5.75,3600,7034
4.1213e+05,2014,319,2,1,920,4400,1,0,0,3,7,920,0,1948,1948,98103,47.69,122.33,1560,4600,66,0,3,2480,5520
4.98e+05,2014,195,3,2.5,1620,2640,2,0,0,4,7,1620,0,1900,1993,98122,47.604,122.31,1370,3840,114,1,5.5,2990,5460
6.85e+05,2014,173,2,1.5,1300,1676,1,0,2,3,7,1300,0,1943,1943,98122,47.613,122.31,1260,1740,71,0,3.5,2560,3040
9.3281e+05,2014,345,5,4.5,4690,6705,2,0,0,3,10,3450,1240,1995,1995,98006,47.554,122.11,4070,11505,19,0,9.5,8760,16195
4.1e+05,2014,234,3,1.75,1760,3520,1,0,0,3,7,1160,600,1966,1966,98144,47.577,122.3,1840,5000,48,0,4.75,3600,6760
6.24e+05,2014,255,3,2.5,2510,47044,1,0,0,4,7,1910,600,1975,1975,98072,47.753,122.14,2510,42803,39,0,5.5,5020,45313
8.2e+05,2014,225,3,2.5,2970,9600,2,0,0,3,9,2970,0,1994,1994,98006,47.542,122.13,2970,9707,20,0,5.5,5940,12677
3.55e+05,2014,221,3,2.5,1590,4242,2,0,0,3,7,1590,0,2000,2000,98065,47.531,121.88,1590,3702,14,0,5.5,3180,5292
2.925e+05,2015,393,3,2.5,1440,1068,2,0,0,3,8,1160,280,2006,2006,98106,47.539,122.36,1580,1483,9,0,5.5,3020,2923
3.125e+05,2015,414,4,1.75,2280,7840,1,0,0,3,7,1280,1000,1957,1957,98055,47.481,122.22,2120,7260,58,0,5.75,4400,9540
9.263e+05,2014,142,3,1.5,1660,4800,2,0,0,3,8,1660,0,1907,1907,98119,47.635,122.36,1690,4000,107,0,4.5,3350,5660
7.2017e+05,2014,338,4,2.25,2120,3794,2,0,0,4,7,1420,700,1926,1926,98117,47.689,122.36,1420,3840,88,0,6.25,3540,5960
4.36e+05,2014,232,4,2,1600,15044,1,0,0,3,7,1600,0,1972,1972,98034,47.72,122.22,1660,8102,42,0,6,3260,9702
5.59e+05,2014,168,2,1,1240,6400,1,0,1,4,7,1060,180,1938,1938,98126,47.549,122.38,1240,6400,76,0,3,2480,7640
7.1952e+05,2015,433,4,1.75,1920,9500,1,0,0,4,7,1470,450,1966,1966,98006,47.568,122.18,1820,10091,49,0,5.75,3740,12011
4.7e+05,2014,262,4,2.5,2470,8536,2,0,0,3,8,2470,0,2002,2002,98155,47.77,122.29,1690,8840,12,0,6.5,4160,11310
5.19e+05,2014,182,5,2.25,2570,13054,1,0,1,3,8,1470,1100,1950,1992,98166,47.449,122.35,2570,19807,64,1,7.25,5140,22377
4.05e+05,2015,424,5,1.75,1550,10500,1,0,0,3,7,1100,450,1961,1961,98011,47.757,122.22,1420,9823,54,0,6.75,2970,11373
4.374e+05,2015,394,3,1.75,2150,8925,1,0,0,4,7,2150,0,1960,1960,98008,47.625,122.12,1100,7875,55,0,4.75,3250,10025
4.15e+05,2015,447,2,1,880,5100,1,0,0,4,7,880,0,1941,1941,98103,47.694,122.35,980,5100,74,0,3,1860,5980
2.38e+05,2014,286,5,2.25,2240,9652,2,0,0,3,7,2240,0,1990,1990,98055,47.425,122.21,2180,11644,24,0,7.25,4420,13884
2.51e+05,2015,465,3,1.75,1350,10125,1,0,0,3,8,1350,0,1967,1967,98003,47.333,122.3,1520,9720,48,0,4.75,2870,11070
5.95e+05,2015,478,2,1,980,3600,1,0,0,3,6,980,0,1907,1907,98119,47.637,122.36,1690,3600,108,0,3,2670,4580
5.15e+05,2015,457,3,2.25,1820,13362,1,0,0,3,8,1220,600,1977,1977,98075,47.59,122.05,2050,15000,38,0,5.25,3870,16820
3.5445e+05,2015,444,4,2.75,2140,9920,2,0,0,3,8,2140,0,1993,1993,98001,47.353,122.27,2130,9920,22,0,6.75,4270,12060
3.73e+05,2014,225,3,2,1400,2445,1,0,0,3,7,840,560,2002,2002,98144,47.593,122.3,1400,3200,12,0,5,2800,4600
2.5e+05,2014,303,3,2.25,1620,10850,1,0,0,3,7,1620,0,1966,1966,98055,47.444,122.19,1910,10568,48,0,5.25,3530,12188
2.5495e+05,2014,262,3,2.5,1794,4769,2,0,0,3,7,1794,0,2005,2005,98001,47.305,122.28,3557,4807,9,0,5.5,5351,6601
4.67e+05,2015,394,4,2.75,2170,5024,2,0,0,3,8,2170,0,2012,2012,98059,47.495,122.14,2460,5024,3,0,6.75,4630,7194
1.25e+06,2015,386,3,2.5,2710,13120,1,0,0,3,10,2710,0,1959,1959,98105,47.672,122.26,3130,13566,56,0,5.5,5840,16276
2.25e+05,2014,153,3,1,1200,9936,1,0,0,4,6,1200,0,1969,1969,98038,47.361,122.03,1200,10189,45,0,4,2400,11389
3.7e+05,2015,487,2,1,910,5525,1,0,0,2,6,910,0,1910,1910,98126,47.532,122.38,1620,5525,105,0,3,2530,6435
89000,2014,284,3,1,900,4750,1,0,0,4,6,900,0,1969,1969,98023,47.303,122.36,900,3404,45,0,4,1800,4304
4.4e+05,2014,139,2,1.5,1010,1968,1,0,0,5,5,1010,0,1906,1906,98107,47.676,122.39,1760,4200,108,0,3.5,2770,5210
7.335e+05,2014,340,3,1.5,2120,4370,1,0,0,3,8,2120,0,1904,1904,98122,47.606,122.31,1960,5120,110,0,4.5,4080,7240
3.875e+05,2014,264,3,1,1220,8329,1,0,0,3,6,1220,0,1946,1946,98115,47.698,122.3,1490,8322,68,0,4,2710,9542
4.1e+05,2014,180,1,1.5,1010,5750,1,0,0,3,7,1010,0,1911,1948,98136,47.541,122.39,1230,5750,103,1,2.5,2240,6760
7.65e+05,2014,230,4,2.5,3190,38119,2,0,0,3,9,3190,0,1988,1988,98053,47.67,122.04,2560,36280,26,0,6.5,5750,39470
4.35e+05,2015,374,3,2.5,1560,3987,2,0,0,3,7,1560,0,2002,2002,98053,47.687,122.04,1600,3152,13,0,5.5,3160,4712
2.4e+05,2014,201,3,1,1090,10000,1,0,0,3,6,1090,0,1961,1961,98014,47.65,121.91,1040,7500,53,0,4,2130,8590
4.398e+05,2014,152,3,1.5,1120,6900,1,0,0,5,7,1120,0,1956,1956,98007,47.602,122.13,1300,7000,58,0,4.5,2420,8120
4.25e+05,2015,463,3,2.75,2600,10874,2,0,0,3,9,2600,0,1994,1994,98042,47.382,122.15,2800,11504,21,0,5.75,5400,14104
3e+05,2014,142,5,2.5,2760,6000,2,0,0,3,8,2760,0,2006,2006,98108,47.529,122.32,1360,6000,8,0,7.5,4120,8760
4.4543e+05,2014,160,2,1,1470,7137,1,0,0,3,7,1020,450,1941,1941,98103,47.701,122.35,1470,7067,73,0,3,2940,8537
1.85e+05,2014,132,3,1.5,1370,8470,1,0,0,4,7,1370,0,1961,1961,98092,47.287,122.19,1710,8800,53,0,4.5,3080,10170
2.475e+05,2015,423,4,2,1760,8400,1,0,0,3,7,1060,700,1962,1962,98003,47.326,122.32,1280,8415,53,0,6,3040,10175
4.27e+05,2014,231,4,2.5,1600,14000,1,0,0,3,8,1310,290,1950,1950,98125,47.726,122.33,1600,10200,64,0,6.5,3200,11800
2.85e+05,2015,414,2,1,890,7250,1,0,0,3,7,890,0,1943,1943,98125,47.712,122.31,900,7000,72,0,3,1790,7890
6.93e+05,2014,340,4,2.5,3160,13063,2,0,0,3,10,3160,0,1999,1999,98075,47.6,122.02,3350,14213,15,0,6.5,6510,17373
4.25e+05,2014,258,3,2.25,1620,997,2,0,0,3,8,1540,80,2010,2010,98027,47.54,122.03,1620,1068,4,0,5.25,3240,2688
4.45e+05,2014,318,4,2,1700,21780,1,0,0,4,6,1080,620,1940,1940,98052,47.629,122.11,2070,12054,74,0,6,3770,13754
3.37e+05,2014,202,4,2.5,2610,5240,2,0,0,3,8,2610,0,2004,2004,98038,47.345,122.04,2480,5240,10,0,6.5,5090,7850
2.43e+05,2014,256,3,1,1500,6600,1,0,0,2,6,1500,0,1970,1970,98168,47.484,122.33,1730,6600,44,0,4,3230,8100
2.79e+05,2014,177,3,2.5,1630,7950,1,0,0,3,8,1320,310,1985,1985,98042,47.422,122.16,1650,7952,29,0,5.5,3280,9582
3.32e+05,2014,150,2,1,1000,4776,1,0,0,4,6,1000,0,1942,1942,98108,47.562,122.31,1500,4800,72,0,3,2500,5800
4.64e+05,2014,221,3,2.5,2460,5400,1,0,0,4,8,1520,940,2001,2001,98056,47.523,122.2,1745,5400,13,0,5.5,4205,7860
3.685e+05,2014,280,2,1.75,2510,19141,2,0,0,3,9,2510,0,1977,1977,98092,47.31,122.2,2400,13030,37,0,3.75,4910,15540
2.25e+05,2014,300,3,1.75,1460,8372,1,0,0,4,7,1460,0,1981,1981,98042,47.368,122.09,1220,7803,33,0,4.75,2680,9263
2.6395e+05,2015,444,3,1.75,1700,11613,1,0,0,5,7,1180,520,1977,1977,98092,47.287,122.19,1500,12377,38,0,4.75,3200,14077
8.4e+05,2014,150,7,4.5,4290,37607,1,0,0,5,10,4290,0,1982,1982,98027,47.481,122.03,2810,40510,32,0,11.5,7100,44800
6.95e+05,2014,135,3,2.5,4560,17622,2,0,0,4,9,3800,760,1986,1986,98074,47.621,122.03,2360,15000,28,0,5.5,6920,19560
6.1e+05,2014,269,3,2.25,2320,38186,2,0,0,3,8,2320,0,1980,1980,98053,47.664,122.07,2875,37523,34,0,5.25,5195,39843
2.9925e+05,2014,300,3,2.5,2530,8669,2,0,0,3,9,2530,0,1990,1990,98023,47.307,122.39,2530,9469,24,0,5.5,5060,11999
3.65e+05,2014,215,3,1.5,1640,8301,1,0,0,3,7,1290,350,1958,1958,98155,47.744,122.33,1640,8955,56,0,4.5,3280,10595
3.75e+05,2014,356,3,2.5,2750,37096,2,0,0,3,9,2750,0,1989,1989,98038,47.373,122.02,2700,40091,25,0,5.5,5450,42841
5.01e+05,2015,481,2,2,1300,2500,1,0,0,4,7,770,530,1926,1926,98117,47.683,122.37,1160,5000,89,0,4,2460,6300
3.0286e+05,2015,431,2,1,970,3279,2,0,0,3,7,790,180,2007,2007,98136,47.547,122.38,1150,1351,8,0,3,2120,2321
2.5e+05,2014,190,3,1,1010,8711,1,0,0,5,6,1010,0,1944,1944,98056,47.491,122.19,1250,8053,70,0,4,2260,9063
2.17e+05,2014,307,2,1,720,4760,1,0,0,5,5,720,0,1942,1942,98056,47.496,122.19,840,4760,72,0,3,1560,5480
9.99e+05,2014,148,7,4,3150,34830,1,0,0,3,9,3150,0,1957,2005,98007,47.603,122.15,2390,12054,57,1,11,5540,15204
1.225e+06,2014,126,4,2.25,3490,6906,2,0,0,4,10,2280,1210,1928,1928,98199,47.642,122.41,2540,6223,86,0,6.25,6030,9713
8.2e+05,2014,168,4,2.5,3170,8523,2,0,0,3,9,3170,0,2008,2008,98033,47.685,122.18,3230,8523,6,0,6.5,6400,11693
5.45e+05,2015,400,4,2,1700,2350,1,0,0,3,6,850,850,1926,2014,98117,47.687,122.37,1600,4160,89,1,6,3300,5860
5.55e+05,2014,244,3,2.5,2160,7584,2,0,0,3,8,2160,0,1988,1988,98029,47.575,122.01,2160,7372,26,0,5.5,4320,9532
5.85e+05,2014,303,3,1,1450,5378,1,0,0,3,7,1190,260,1939,1939,98199,47.644,122.41,1810,5559,75,0,4,3260,7009
6.45e+05,2015,409,4,3.5,2910,5260,2,0,0,3,9,2910,0,2012,2012,98065,47.517,121.88,2910,5260,3,0,7.5,5820,8170
7.7e+05,2014,299,5,3,2370,6000,1,0,2,3,8,1340,1030,1926,2003,98107,47.664,122.36,1350,4500,88,1,8,3720,6870
4.695e+05,2015,365,4,2.75,1930,13041,1,0,0,4,8,1180,750,1980,1980,98072,47.75,122.08,1880,10234,35,0,6.75,3810,12164
4.5e+05,2014,308,3,1.75,1160,6120,1,0,0,3,7,1040,120,1941,1941,98115,47.693,122.29,1530,6120,73,0,4.75,2690,7280
2.07e+05,2015,461,3,1,990,10800,1,0,0,4,6,990,0,1959,1959,98002,47.293,122.22,1060,10364,56,0,4,2050,11354
5.25e+05,2014,245,4,2,2420,10735,1,0,0,3,7,2420,0,1967,1967,98052,47.69,122.12,1570,9540,47,0,6,3990,11960
1.6e+06,2014,195,3,2.25,3170,5000,2,0,0,5,10,2230,940,1975,1975,98102,47.635,122.32,3170,5400,39,0,5.25,6340,8570
3e+06,2015,392,5,3.25,5370,14091,2,0,0,3,10,3850,1520,1918,2008,98004,47.65,122.22,2410,12047,97,1,8.25,7780,17417
1.775e+05,2014,176,3,1.5,1220,6000,1,0,0,3,7,1220,0,1968,1968,98055,47.49,122.22,1660,6000,46,0,4.5,2880,7220
4.1e+05,2014,209,3,1,1020,6903,1,0,0,3,7,1020,0,1951,1951,98116,47.571,122.39,1440,6678,63,0,4,2460,7698
5.5e+05,2015,389,2,1.5,900,5750,1,0,2,3,7,900,0,1940,1940,98116,47.562,122.38,1300,1413,75,0,3.5,2200,2313
4.89e+05,2015,471,4,2.5,2170,4587,2,0,0,3,7,2170,0,2006,2006,98065,47.54,121.89,2170,5211,9,0,6.5,4340,7381
6.78e+05,2014,263,3,2.75,2770,10000,1,0,1,5,8,1640,1130,1962,1962,98033,47.701,122.21,2450,10000,52,0,5.75,5220,12770
1.062e+06,2015,465,4,2.75,2720,4000,1,0,2,5,8,1840,880,1928,1928,98117,47.68,122.36,1600,4000,87,0,6.75,4320,6720
9.95e+05,2014,346,5,4,5610,22529,2,0,0,3,11,4090,1520,1996,1996,98072,47.724,122.09,3860,24751,18,0,9,9470,30361
6.5e+05,2014,340,3,2.25,2150,21235,1,0,3,4,8,1590,560,1959,1959,98166,47.434,122.34,2570,18900,55,0,5.25,4720,21050
1.378e+06,2014,339,5,3.5,5150,12230,2,0,2,3,10,3700,1450,2007,2007,98008,47.625,122.09,2940,13462,7,0,8.5,8090,18612
2.2e+06,2014,235,3,2,3570,30456,1,0,1,3,8,2070,1500,1946,1982,98039,47.641,122.24,3570,27418,68,1,5,7140,30988
4.5e+05,2014,266,3,2.5,2820,10208,1,0,1,4,8,1410,1410,1954,1954,98028,47.761,122.26,1540,10684,60,0,5.5,4360,13504
3.44e+05,2014,352,4,2.5,2400,4848,2,0,0,3,8,2400,0,2004,2004,98038,47.363,122.04,1980,5199,10,0,6.5,4380,7599
4.49e+05,2015,445,2,1,1250,4576,1,0,0,3,6,1040,210,1925,1925,98118,47.539,122.27,1550,5000,90,0,3,2800,6250
3.45e+05,2014,300,2,1,970,10423,1,0,0,3,7,970,0,1947,1947,98133,47.725,122.33,1200,7857,67,0,3,2170,8827
3.65e+05,2014,312,2,1.5,1160,8060,1,0,0,4,7,1160,0,1950,1950,98136,47.515,122.39,1500,8060,64,0,3.5,2660,9220
3.64e+05,2014,331,4,1,1020,11383,1,0,0,5,6,1020,0,1947,1947,98155,47.743,122.32,1290,11213,67,0,5,2310,12233
3.022e+05,2015,443,4,1.5,1730,10396,1,0,0,3,7,1730,0,1964,1964,98058,47.45,122.17,1510,10396,51,0,5.5,3240,12126
3.1e+05,2015,444,3,1,1020,55756,1,0,0,3,7,1020,0,1961,1961,98042,47.384,122.08,1490,12745,54,0,4,2510,13765
3.8e+05,2015,493,2,1,760,4000,1,0,0,3,6,760,0,1910,1910,98108,47.546,122.32,1130,4000,105,0,3,1890,4760
9.1389e+05,2014,175,5,2.25,2370,15512,2,0,0,4,9,2370,0,1981,1981,98006,47.556,122.15,2380,15100,33,0,7.25,4750,17470
4e+05,2014,149,4,1.5,1390,7200,1,0,0,3,7,1140,250,1965,1965,98133,47.722,122.33,1630,7702,49,0,5.5,3020,9092
2.485e+05,2014,127,4,1.75,1720,10018,1,0,0,5,7,1720,0,1960,1960,98042,47.361,122.12,1220,10018,54,0,5.75,2940,11738
5.9e+05,2015,453,3,2.5,2290,4203,2,0,0,3,9,2290,0,2001,2001,98006,47.544,122.17,2290,5089,14,0,5.5,4580,7379
3.35e+05,2014,202,2,2,1380,5840,1,0,0,3,7,1380,0,1988,1988,98011,47.773,122.17,1810,5035,26,0,4,3190,6415
5.85e+05,2014,129,4,3.25,2400,29252,2,0,0,4,8,2400,0,1982,1982,98072,47.743,122.13,2280,45000,32,0,7.25,4680,47400
2.34e+05,2015,410,3,1.75,1480,8475,1,0,0,4,7,1480,0,1968,1968,98023,47.313,122.36,1800,8800,47,0,4.75,3280,10280
1.989e+06,2014,161,3,2.5,2880,13500,1,0,4,5,8,1520,1360,1950,1950,98004,47.628,122.22,3710,20486,64,0,5.5,6590,23366
2.3e+05,2014,225,4,2,1670,5200,1,0,0,4,7,1030,640,1977,1977,98042,47.365,122.09,1500,5200,37,0,6,3170,6870
4.75e+05,2014,301,3,2.5,2480,6031,2,0,0,3,8,2480,0,2001,2001,98155,47.772,122.3,1850,7704,13,0,5.5,4330,10184
5.95e+05,2014,181,4,2.5,1820,20011,2,0,0,3,8,1820,0,1987,1987,98075,47.584,122.05,2710,33915,27,0,6.5,4530,35735
1.3e+06,2014,156,4,4,4270,6002,2,0,3,3,10,3180,1090,2004,2004,98029,47.544,121.99,4280,5942,10,0,8,8550,10212
2.87e+05,2014,307,3,2.5,1600,6315,2,0,0,3,8,1600,0,2013,2013,98092,47.261,122.2,1608,4300,1,0,5.5,3208,5900
5.35e+05,2014,221,3,1,1660,5100,1,0,0,3,7,1260,400,1957,1957,98136,47.532,122.38,1230,5100,57,0,4,2890,6760
8.48e+05,2015,446,5,1.75,2290,4320,2,0,0,3,7,1980,310,1928,1928,98105,47.664,122.31,2870,4320,87,0,6.75,5160,6610
7.09e+05,2015,414,3,2.75,2780,7200,1,0,0,4,8,1870,910,1913,1913,98118,47.563,122.27,1700,7200,102,0,5.75,4480,9980
4.225e+05,2015,445,2,1,800,4046,1,0,0,3,7,800,0,1940,1940,98117,47.69,122.38,1400,4046,75,0,3,2200,4846
5.85e+05,2015,445,3,1.75,1840,7350,1,0,0,3,8,1370,470,1974,1974,98033,47.673,122.17,1920,8518,41,0,4.75,3760,10358
4.65e+05,2014,222,4,2.25,3360,10810,2,0,0,4,9,3360,0,1988,1988,98092,47.332,122.2,2590,10810,26,0,6.25,5950,14170
3.42e+05,2014,216,3,2,1640,4802,1,0,0,3,8,1640,0,2010,2010,98038,47.354,122.02,1940,4802,4,0,5,3580,6442
6.2e+05,2014,135,4,2.5,2680,9185,2,0,0,3,9,2680,0,1989,1989,98029,47.574,121.99,2810,8505,25,0,6.5,5490,11185
7.2495e+05,2015,444,4,1.75,1960,4340,1,0,0,5,8,980,980,1912,1912,98117,47.685,122.37,1630,4360,103,0,5.75,3590,6320
5.66e+05,2014,166,4,2.25,2170,7737,2,0,0,3,8,2170,0,1987,1987,98074,47.637,122.03,1850,8869,27,0,6.25,4020,11039
4.62e+05,2015,374,4,2.5,2640,47480,1,0,0,4,8,1590,1050,1979,1979,98038,47.426,122.02,2390,67415,36,0,6.5,5030,70055
3.83e+05,2014,132,4,2.5,2160,6223,2,0,0,3,8,2160,0,2010,2010,98038,47.349,122.04,2160,5555,4,0,6.5,4320,7715
4.23e+05,2014,251,4,2.5,2660,5539,2,0,0,3,8,2660,0,2004,2004,98059,47.498,122.16,2380,5539,10,0,6.5,5040,8199
2.25e+05,2015,433,3,1.5,1240,5506,1,0,0,4,7,1240,0,1971,1971,98118,47.529,122.28,1670,5589,44,0,4.5,2910,6829
5.03e+05,2014,305,4,2.5,2940,1.5699e+05,2,0,2,3,9,1870,1070,1996,1996,98014,47.621,121.95,2940,71002,18,0,6.5,5880,73942
1.75e+05,2015,464,3,1,1460,11880,1,0,0,2,7,1460,0,1961,1961,98030,47.376,122.22,1310,9315,54,0,4,2770,10775
3.35e+05,2014,285,4,2.5,1900,3301,2,0,0,3,7,1900,0,2007,2007,98178,47.489,122.25,1960,3379,7,0,6.5,3860,5279
3.299e+05,2014,270,4,2.75,2475,4000,2,0,0,3,7,2475,0,2014,2014,98002,47.345,122.21,2475,4000,0,0,6.75,4950,6475
3.425e+05,2015,366,3,2.5,1810,5192,2,0,0,3,8,1810,0,1993,1993,98038,47.372,122.04,1810,6200,22,0,5.5,3620,8010
5.62e+05,2014,359,4,2.75,2560,83200,1,0,0,3,8,1860,700,1980,1980,98072,47.751,122.11,1990,38332,34,0,6.75,4550,40892
3.25e+05,2014,229,3,2.5,1740,5267,2,0,0,3,7,1740,0,1999,1999,98038,47.378,122.02,2180,5000,15,0,5.5,3920,6740
3.86e+05,2014,161,3,1.5,1270,1318,2,0,0,3,7,1080,190,2004,2004,98199,47.653,122.38,1360,1488,10,0,4.5,2630,2758
4.55e+05,2014,152,2,1,1140,5720,1,0,0,3,7,850,290,1947,1947,98115,47.683,122.3,1410,5832,67,0,3,2550,6972
2.425e+05,2014,263,3,2.25,1770,10000,1,0,0,3,7,1340,430,1978,1978,98198,47.381,122.32,1270,5055,36,0,5.25,3040,6825
9.5e+05,2014,245,6,1,2330,5000,1,0,0,4,7,2330,0,1920,1920,98117,47.679,122.4,1570,5000,94,0,7,3900,7330
3.1e+05,2014,169,4,1.5,1220,9600,1,0,0,3,6,1220,0,1980,1980,98014,47.646,121.91,1180,9000,34,0,5.5,2400,10220
5.3e+05,2014,216,3,2.25,1264,1536,2,0,0,3,8,1264,0,2003,2003,98105,47.669,122.28,1264,2067,11,0,5.25,2528,3331
1.475e+05,2015,403,3,1,1530,8498,1,0,0,3,7,1530,0,1959,1959,98031,47.404,122.2,1380,8498,56,0,4,2910,10028
1.34e+06,2014,127,3,3,2960,5500,2,0,2,3,10,2440,520,1937,1990,98199,47.636,122.4,2960,5876,77,1,6,5920,8836
7.15e+05,2014,321,3,3.25,3060,9055,2,0,0,3,10,2460,600,1994,1994,98052,47.697,122.1,2990,9598,20,0,6.25,6050,12658
4.9995e+05,2014,211,3,1,1870,4984,1,0,0,3,7,1120,750,1955,1955,98116,47.577,122.39,1650,5750,59,0,4,3520,7620
3.8245e+05,2014,196,3,2.5,2220,20531,2,0,0,3,8,2220,0,1998,1998,98001,47.286,122.26,2420,19249,16,0,5.5,4640,21469
2.72e+05,2014,324,3,3,2430,10500,1,0,0,4,8,2150,280,1983,1983,98003,47.258,122.31,1670,9800,31,0,6,4100,12230
4e+05,2014,154,3,1.75,1530,10731,1,0,0,3,7,1530,0,1986,1986,98028,47.766,122.24,2100,12593,28,0,4.75,3630,14123
1.9e+06,2014,211,4,2.5,3680,13351,2,0,2,5,9,3680,0,1946,1982,98004,47.615,122.21,3410,11700,68,1,6.5,7090,15380
3.85e+05,2014,293,4,2.5,1620,5280,2,0,0,4,7,1620,0,1924,1971,98146,47.513,122.38,1590,5280,90,1,6.5,3210,6900
3.499e+05,2014,173,3,2,2420,38781,1,0,0,5,7,1210,1210,1949,1949,98027,47.451,121.98,2650,88426,65,0,5,5070,90846
3.75e+05,2014,290,3,2.25,1140,1557,3,0,0,3,8,1140,0,2007,2007,98103,47.695,122.34,1140,1245,7,0,5.25,2280,2385
2.85e+05,2014,238,3,1.75,1020,5000,1,0,0,5,6,1020,0,1954,1954,98118,47.533,122.29,1360,5000,60,0,4.75,2380,6020
7.5e+05,2014,122,3,2.5,2390,6550,1,0,2,4,8,1440,950,1955,1955,98116,47.571,122.41,2010,6550,59,0,5.5,4400,8940
4.8e+05,2015,425,4,2.5,2600,7787,2,0,0,3,8,2600,0,2005,2005,98059,47.488,122.14,2830,7787,10,0,6.5,5430,10387
7.58e+05,2014,127,4,2.75,2410,9549,1,0,0,4,7,1780,630,1956,1956,98033,47.65,122.2,2090,9549,58,0,6.75,4500,11959
2.9e+05,2014,183,3,1,1440,11250,1,0,0,3,7,1440,0,1967,1967,98055,47.463,122.21,2200,11250,47,0,4,3640,12690
6.46e+05,2015,444,3,2.75,2460,6413,2,0,0,3,9,2460,0,2004,2004,98028,47.75,122.25,2440,6092,11,0,5.75,4900,8552
5.92e+05,2015,388,4,2.5,2300,11165,2,0,0,4,8,2300,0,1979,1979,98008,47.579,122.12,2170,11165,36,0,6.5,4470,13465
4.8995e+05,2014,162,4,2.25,2640,31941,1,0,0,4,9,2640,0,1986,1986,98092,47.31,122.12,2780,35365,28,0,6.25,5420,38005
4.1995e+05,2015,394,3,3,2150,3962,1,0,0,3,7,1540,610,1949,1949,98125,47.718,122.28,1730,4609,66,0,6,3880,6759
4.75e+05,2014,312,3,1.75,2270,13000,1,0,0,5,8,2270,0,1968,1968,98058,47.447,122.14,2440,10000,46,0,4.75,4710,12270
2.5e+05,2014,151,1,1,750,4000,1,0,0,3,6,750,0,1918,1918,98136,47.524,122.39,1770,4850,96,0,2,2520,5600
1.9e+05,2014,175,1,0.75,930,29258,1,0,0,3,6,930,0,1941,1941,98178,47.484,122.24,2000,18321,73,0,1.75,2930,19251
6.9e+05,2014,188,4,2.5,3220,35400,2,0,0,3,9,3220,0,1991,1991,98072,47.755,122.11,3050,35252,23,0,6.5,6270,38472
4.4e+05,2014,229,3,1.75,2000,11880,2,0,0,3,8,2000,0,1979,1979,98075,47.588,122.05,1820,15120,35,0,4.75,3820,17120
3.41e+05,2014,183,3,1,1390,4814,1,0,0,3,6,1390,0,1908,1908,98115,47.688,122.32,1730,3990,106,0,4,3120,5380
4.8e+05,2014,187,3,2.25,1680,9090,1,0,0,4,7,1130,550,1959,1959,98008,47.607,122.13,1960,9090,55,0,5.25,3640,10770
3.25e+05,2015,370,4,2.5,2240,5105,2,0,0,4,8,2240,0,2002,2002,98042,47.392,122.17,1920,5288,13,0,6.5,4160,7528
4.4e+05,2015,376,3,2.5,1040,1032,3,0,0,3,7,1040,0,2007,2007,98107,47.667,122.38,1290,1275,8,0,5.5,2330,2315
8.6e+05,2014,149,3,2.5,2770,9136,2,0,0,3,10,2770,0,1991,1991,98006,47.56,122.11,2890,8442,23,0,5.5,5660,11212
5.35e+05,2014,228,3,2.5,2790,19485,2,0,0,3,9,2790,0,1990,1990,98059,47.469,122.12,2580,17859,24,0,5.5,5370,20649
1.6932e+05,2015,408,2,1,790,4000,1,0,2,3,7,790,0,1908,1908,98112,47.625,122.3,1700,4200,107,0,3,2490,4990
3.3e+05,2014,345,3,2.25,1440,5150,2,0,0,3,7,1440,0,1997,1997,98106,47.546,122.36,1530,5238,17,0,5.25,2970,6678
5.38e+05,2014,128,4,1.75,1840,9600,1,0,0,3,7,1220,620,1967,1967,98052,47.658,122.13,1770,9720,47,0,5.75,3610,11560
3.935e+05,2014,283,3,1.75,1600,8156,1,0,0,5,7,1600,0,1948,1948,98155,47.74,122.3,1200,8156,66,0,4.75,2800,9756
1.12e+06,2014,163,5,1.5,2540,6660,2,0,3,4,8,2340,200,1954,1954,98136,47.514,122.39,2460,9000,60,0,6.5,5000,11540
3.47e+05,2015,492,3,2.5,1680,4308,2,0,0,3,7,1680,0,2004,2004,98056,47.48,122.18,2160,4182,11,0,5.5,3840,5862
3.3121e+05,2015,453,4,2.5,2240,4800,2,0,0,3,8,2240,0,2014,2014,98001,47.291,122.27,2240,5040,1,0,6.5,4480,7280
9.4988e+05,2014,147,4,2.25,2290,10687,2,0,0,3,9,2290,0,1978,1978,98004,47.588,122.2,2290,10300,36,0,6.25,4580,12590
2.6e+05,2014,167,3,1.5,1270,20700,1,0,0,2,7,1150,120,1948,1948,98155,47.758,122.3,1990,15000,66,0,4.5,3260,16270
2.07e+05,2014,359,2,1.5,1068,1158,2,0,0,3,7,1068,0,1990,1990,98028,47.753,122.24,1078,1278,24,0,3.5,2146,2346
1.8025e+05,2014,323,2,0.75,900,9600,1,0,0,3,6,900,0,1941,1941,98166,47.46,122.34,1250,14280,73,0,2.75,2150,15180
2.65e+05,2014,236,4,2.25,2300,9100,1,0,0,3,7,1280,1020,1977,1977,98058,47.458,122.16,1640,9100,37,0,6.25,3940,11400
8.015e+05,2015,437,4,2.25,2250,13500,2,0,0,4,9,2250,0,1980,1980,98007,47.621,122.15,2730,13500,35,0,6.25,4980,15750
2.8e+05,2015,436,4,2.5,2200,5893,2,0,0,3,7,2200,0,2008,2008,98042,47.333,122.06,2200,5757,7,0,6.5,4400,7957
5.75e+05,2014,270,3,2.5,2120,4780,2,0,0,3,7,2120,0,2004,2004,98053,47.681,122.03,1690,2650,10,0,5.5,3810,4770
7.02e+05,2014,284,4,2.75,3880,15025,2,0,0,3,7,3880,0,2004,2004,98053,47.678,122.03,2620,5300,10,0,6.75,6500,9180
1.795e+05,2015,388,3,1,900,8100,1,0,0,4,6,900,0,1959,1959,98002,47.287,122.22,1000,7830,56,0,4,1900,8730
1.22e+06,2014,141,4,2.5,3240,3600,2,0,0,3,9,2060,1180,2008,2008,98109,47.641,122.36,1820,3600,6,0,6.5,5060,6840
7.55e+05,2014,296,3,2.5,2420,8856,1,0,3,3,9,1620,800,1957,1957,98118,47.541,122.26,2650,9750,57,0,5.5,5070,12170
3.4995e+05,2014,135,3,1,1400,7066,1,0,0,3,8,1400,0,1957,1957,98125,47.713,122.33,1400,7320,57,0,4,2800,8720
2.46e+05,2015,447,5,1.75,2030,10200,1,0,0,4,7,2030,0,1958,1958,98002,47.287,122.21,1760,11550,57,0,6.75,3790,13580
2.95e+05,2014,304,3,1,1380,7575,1,0,0,4,7,1380,0,1963,1963,98056,47.514,122.19,1320,7600,51,0,4,2700,8980
2.7e+05,2014,249,3,1,1240,14110,1,0,0,4,7,1240,0,1972,1972,98058,47.458,122.09,2060,19350,42,0,4,3300,20590
7.68e+05,2014,203,5,2.75,3030,13640,2,0,0,4,8,3030,0,1980,1980,98007,47.619,122.15,2500,13225,34,0,7.75,5530,16255
4.2e+05,2015,413,5,3,2150,6117,1,0,0,3,7,1370,780,2003,2003,98106,47.538,122.36,1990,6064,12,0,8,4140,8214
5.9e+05,2014,198,4,2.5,2290,11072,2,0,0,3,9,2290,0,1986,1986,98074,47.628,122.03,2340,9774,28,0,6.5,4630,12064
2.9e+05,2014,304,4,1.75,2090,12750,1,0,0,3,8,1360,730,1967,1967,98166,47.479,122.36,2040,12300,47,0,5.75,4130,14390
4.31e+05,2015,424,3,1,1500,6240,1,0,0,4,7,1500,0,1953,1953,98125,47.728,122.31,1230,6240,62,0,4,2730,7740
5.81e+05,2014,248,3,2.5,2600,4438,2,0,0,3,7,2600,0,2004,2004,98053,47.68,122.03,2600,4904,10,0,5.5,5200,7504
7.23e+05,2015,401,4,2,2790,8793,1,0,0,4,8,1640,1150,1977,1977,98006,47.551,122.16,2400,9286,38,0,6,5190,12076
2.85e+05,2014,161,3,2.5,1870,4060,2,0,0,3,7,1870,0,2005,2005,98042,47.399,122.16,2190,4060,9,0,5.5,4060,5930
5.15e+05,2014,237,3,2.25,1640,8400,1,0,0,4,8,1640,0,1962,1962,98006,47.548,122.17,2110,8400,52,0,5.25,3750,10040
5.1e+05,2015,392,4,2.5,1840,7800,1,0,2,3,8,1240,600,1972,1972,98177,47.776,122.38,2010,9100,43,0,6.5,3850,10940
3.5e+05,2014,360,3,1.75,1490,10344,1,0,0,3,7,1490,0,1985,1985,98155,47.752,122.33,1450,8632,29,0,4.75,2940,10122
7.5e+05,2014,232,2,2.25,1890,5400,2,0,0,5,8,1610,280,1905,1905,98105,47.669,122.31,2820,4860,109,0,4.25,4710,6750
3.45e+05,2015,487,5,2.75,1940,4182,1,0,0,3,7,1240,700,2002,2002,98056,47.491,122.17,1950,4182,13,0,7.75,3890,6122
5.795e+05,2014,300,3,1.75,1250,4120,1,0,0,4,7,980,270,1925,1925,98117,47.685,122.36,1250,4120,89,0,4.75,2500,5370
4.95e+05,2014,153,4,2.25,2220,8872,1,0,0,4,8,1110,1110,1961,1961,98006,47.549,122.17,2220,9106,53,0,6.25,4440,11326
5.32e+05,2015,389,3,2.5,1830,8022,2,0,0,3,8,1830,0,1987,1987,98074,47.62,122.04,2030,7736,28,0,5.5,3860,9566
5.4901e+05,2015,401,2,1.75,1560,4141,1,0,0,4,7,880,680,1942,1942,98117,47.686,122.38,1210,4141,73,0,3.75,2770,5701
2.91e+05,2014,140,3,1.75,1560,9788,1,0,0,3,7,1560,0,1964,1964,98178,47.488,122.23,1840,11180,50,0,4.75,3400,12740
9.78e+05,2014,140,4,2.75,2620,13777,1,0,2,4,9,1720,900,1926,1926,98144,47.58,122.28,3530,9287,88,0,6.75,6150,11907
2.635e+05,2014,231,2,1,750,4515,1,0,0,3,6,750,0,1942,1942,98106,47.52,122.35,1020,5000,72,0,3,1770,5750
3.045e+05,2014,324,3,2.25,1790,6930,1,0,0,3,7,1390,400,1974,1974,98003,47.354,122.32,1810,7420,40,0,5.25,3600,9210
1.139e+06,2014,269,5,3.5,4280,6530,2,0,3,3,10,4280,0,2014,2014,98075,47.594,121.97,3960,6863,0,0,8.5,8240,11143
1.59e+05,2014,204,3,1,1360,20000,1,0,0,4,7,1360,0,1953,1953,98001,47.286,122.25,1530,9997,61,0,4,2890,11357
1.5e+06,2014,298,3,3.5,3530,3610,2,0,0,3,10,2370,1160,2008,2008,98103,47.686,122.34,1780,3610,6,0,6.5,5310,7140
6.93e+05,2014,280,3,2.25,2090,45535,1,0,2,5,8,1280,810,1952,1952,98006,47.554,122.19,3090,12889,62,0,5.25,5180,14979
8.3e+05,2015,447,4,3.25,3330,7809,2,0,0,3,9,3330,0,2004,2004,98075,47.598,121.98,3100,6465,11,0,7.25,6430,9795
5.3e+05,2014,155,3,2.5,1710,1664,2,0,0,5,8,1300,410,2003,2003,98199,47.646,122.38,1470,5400,11,0,5.5,3180,7110
4.38e+05,2015,471,3,2.25,1820,9150,1,0,0,3,7,1320,500,1961,1961,98133,47.737,122.33,1780,8055,54,0,5.25,3600,9875
1.65e+06,2015,422,3,2.75,2690,8890,2,1,4,4,10,2690,0,1975,1991,98006,47.549,122.2,2940,8890,40,1,5.75,5630,11580
9.5e+05,2014,134,4,2.5,3320,7644,2,0,0,3,10,3320,0,1995,1995,98006,47.554,122.11,3320,9472,19,0,6.5,6640,12792
5.38e+05,2014,332,3,3.5,2620,10137,2,0,0,3,8,1970,650,1992,1992,98146,47.498,122.37,1960,7680,22,0,6.5,4580,10300
5.575e+05,2014,346,4,2.5,2390,38258,2,0,0,3,8,2390,0,2001,2001,98072,47.743,122.09,1960,17113,13,0,6.5,4350,19503
1.97e+05,2015,431,4,2.25,1790,13200,1,0,0,3,7,1220,570,1979,1979,98058,47.467,122.19,1740,8950,36,0,6.25,3530,10740
3.25e+05,2014,319,4,2.5,2280,9899,2,0,0,3,8,2280,0,1987,1987,98058,47.461,122.15,1970,9451,27,0,6.5,4250,11731
1.8e+06,2015,457,4,3.5,3480,4000,2,0,0,3,9,2460,1020,2015,2015,98112,47.636,122.28,2620,4000,0,0,7.5,6100,7480
2.785e+05,2014,160,4,2.5,1940,6206,2,0,0,3,7,1940,0,1990,1990,98023,47.306,122.36,2060,7092,24,0,6.5,4000,9032
7.9e+05,2015,451,4,1.75,1820,6137,1,0,3,4,7,1690,130,1911,1911,98107,47.668,122.36,2130,5100,104,0,5.75,3950,6920
3.75e+05,2014,259,3,1,1130,12500,1,0,0,3,7,1130,0,1954,1954,98118,47.549,122.27,2280,8750,60,0,4,3410,9880
4.3e+05,2015,450,3,1,940,12521,1,0,0,4,7,940,0,1949,1949,98133,47.717,122.33,1920,9046,66,0,4,2860,9986
2.9e+05,2014,264,3,1,1210,33919,1,0,0,3,7,1210,0,1954,1954,98058,47.438,122.18,1640,14910,60,0,4,2850,16120
6.05e+05,2015,467,4,2.5,2520,3980,2,0,0,3,8,2520,0,2004,2004,98027,47.54,122.07,2580,3980,11,0,6.5,5100,6500
3.39e+05,2015,400,4,2.5,2900,6918,2,0,0,3,8,2900,0,2001,2001,98001,47.35,122.28,2720,10376,14,0,6.5,5620,13276
6.49e+05,2015,429,2,1,1280,4840,1,0,0,3,7,1200,80,1908,1908,98115,47.676,122.3,1860,5500,107,0,3,3140,6780
3.6778e+05,2014,339,5,3,2140,5937,1,0,0,3,7,1280,860,1978,1978,98118,47.546,122.27,1820,6710,36,0,8,3960,8850
3.0745e+05,2015,486,4,2.75,2690,8874,1,0,0,3,8,1370,1320,1980,1980,98023,47.308,122.38,1990,7875,35,0,6.75,4680,10565
3.405e+05,2015,367,3,2,2270,28025,1,0,0,4,7,1920,350,1947,1947,98168,47.486,122.32,1770,14833,68,0,5,4040,17103
6.65e+05,2014,152,4,2.5,2720,10000,2,0,0,3,10,2720,0,1987,1987,98074,47.629,122.05,2720,10020,27,0,6.5,5440,12740
1.6e+05,2014,174,3,1.5,1010,9600,1,0,0,4,7,1010,0,1962,1962,98198,47.41,122.32,1400,9660,52,0,4.5,2410,10670
1.62e+06,2015,493,4,2.25,2350,17709,2,0,0,4,9,2350,0,1977,1977,98039,47.623,122.24,3360,19855,38,0,6.25,5710,22205
2.25e+05,2014,176,3,2,1700,11475,1,0,0,5,6,970,730,1945,1945,98146,47.485,122.34,1560,11475,69,0,5,3260,13175
2.7e+05,2015,479,3,2.5,1430,8470,1,0,0,3,7,1190,240,1992,1992,98022,47.194,121.99,1670,8418,23,0,5.5,3100,9848
2.47e+05,2015,466,5,2,1590,9350,1,0,0,5,7,1060,530,1962,1962,98001,47.34,122.29,1460,8210,53,0,7,3050,9800
7.301e+05,2014,136,4,2.5,3120,14300,2,0,0,3,9,3120,0,2003,2003,98027,47.532,122.06,2580,10005,11,0,6.5,5700,13125
6.785e+05,2014,162,3,2,2460,6600,1,0,2,4,8,1370,1090,1952,1952,98136,47.522,122.38,2150,6600,62,0,5,4610,9060
3.5725e+05,2014,176,3,1.5,1400,8840,1,0,0,4,6,1400,0,1952,1952,98125,47.727,122.31,1260,8840,62,0,4.5,2660,10240
1.01e+06,2014,174,2,2,1460,9052,1,0,2,5,6,1460,0,1900,1900,98033,47.686,122.21,2554,7834,114,0,4,4014,9294
5.57e+05,2014,348,4,1.75,2660,11315,2,0,0,4,8,2660,0,1983,1983,98074,47.62,122.04,1980,11315,31,0,5.75,4640,13975
2.41e+05,2014,208,3,2,1520,7131,1,0,0,3,8,1520,0,1993,1993,98023,47.306,122.36,1890,7379,21,0,5,3410,8899
2.699e+05,2014,169,4,1.75,1530,8750,1,0,0,4,7,1530,0,1968,1968,98058,47.456,122.16,1390,8750,46,0,5.75,2920,10280
3.2995e+05,2014,170,3,2.5,1820,8085,2,0,0,3,7,1820,0,1983,1983,98055,47.458,122.2,1860,8625,31,0,5.5,3680,10445
4.199e+05,2015,395,5,3.5,2880,5000,2,0,0,3,8,2260,620,2012,2012,98038,47.346,122.02,2590,4800,3,0,8.5,5470,7680
2e+06,2014,236,3,2.75,3050,44867,1,0,4,3,9,2330,720,1968,1968,98040,47.532,122.23,4110,20336,46,0,5.75,7160,23386
2.0995e+05,2014,202,4,1,1630,8400,1,0,0,3,6,1630,0,1962,1962,98023,47.305,122.36,1190,8989,52,0,5,2820,10619
5.65e+05,2014,183,4,2.5,2230,8624,1,0,0,4,8,1430,800,1969,1969,98052,47.662,122.15,1970,8402,45,0,6.5,4200,10632
5.75e+05,2015,456,3,1,1220,5652,1,0,0,3,6,1220,0,1905,1905,98116,47.577,122.41,1490,2467,110,0,4,2710,3687
1.275e+06,2014,273,4,1.75,3720,8448,1,0,3,4,9,1960,1760,1947,1947,98199,47.642,122.41,2540,7064,67,0,5.75,6260,10784
5.45e+05,2015,455,5,4,1680,7268,1,0,0,3,8,1370,310,2008,2008,98106,47.557,122.36,2040,8259,7,0,9,3720,9939
5.5e+05,2015,487,4,2.25,2590,36256,2,0,0,3,8,2590,0,1978,1978,98077,47.769,122.09,2670,35657,37,0,6.25,5260,38247
4.55e+05,2014,133,4,2.5,3360,7685,2,0,0,3,9,3360,0,2001,2001,98058,47.437,122.11,3060,6567,13,0,6.5,6420,9927
5.95e+05,2015,440,5,2.75,3740,6750,1,0,0,4,8,1980,1760,1978,1978,98028,47.768,122.26,2620,7920,37,0,7.75,6360,11660
5.9e+05,2014,208,3,1,1530,2370,2,0,0,3,8,1530,0,1901,1901,98122,47.611,122.3,1310,2370,113,0,4,2840,3900
3.475e+05,2015,450,4,2.75,2290,7000,2,0,0,3,8,2290,0,1977,1977,98058,47.444,122.13,2000,7200,38,0,6.75,4290,9490
1.105e+06,2014,194,5,3.25,3070,5000,2,0,0,3,9,2050,1020,2006,2006,98103,47.674,122.36,2070,5000,8,0,8.25,5140,8070
3.475e+05,2015,429,3,1.5,1180,8353,1,0,0,3,7,1180,0,1960,1960,98155,47.765,122.27,1710,8748,55,0,4.5,2890,9928
6.55e+05,2015,459,4,2.75,2890,46609,2,0,0,4,9,2890,0,1981,1981,98077,47.745,122.06,2880,68824,34,0,6.75,5770,71714
6.5e+05,2014,269,4,2.5,2500,6005,2,0,0,3,9,2500,0,2001,2001,98033,47.692,122.17,2680,7200,13,0,6.5,5180,9700
3.3495e+05,2015,403,5,3,2230,8642,1,0,0,3,7,1330,900,2014,2014,98168,47.487,122.32,2100,11056,1,0,8,4330,13286
5.4e+05,2015,464,3,2,1580,1972,2,0,2,3,8,1180,400,2007,2007,98116,47.59,122.39,1500,1908,8,0,5,3080,3488
4.45e+05,2014,211,4,2,2630,9099,1,0,0,3,7,1830,800,1944,2009,98146,47.507,122.36,1430,6825,70,1,6,4060,9455
3.25e+05,2015,415,4,1,1640,3844,1,0,0,4,7,1460,180,1928,1928,98133,47.702,122.35,1230,3844,87,0,5,2870,5484
3.995e+05,2014,284,2,1.5,1180,1722,2,0,0,3,8,1180,0,2006,2006,98116,47.563,122.38,1490,1469,8,0,3.5,2670,2649
4.5e+05,2014,169,4,2.5,2400,7693,2,0,0,3,8,2400,0,2003,2003,98059,47.488,122.14,2400,8038,11,0,6.5,4800,10438
4.64e+05,2014,139,3,1.75,1630,28600,1,0,0,3,8,1630,0,1967,1967,98072,47.774,122.14,2260,26000,47,0,4.75,3890,27630
2.1e+05,2015,484,3,2.75,1320,15236,1,0,0,3,7,880,440,1995,1995,98030,47.365,122.18,1490,8351,20,0,5.75,2810,9671
3.5e+05,2014,244,3,2.25,2470,10290,2,0,0,3,8,2230,240,1984,1984,98058,47.446,122.12,1970,10150,30,0,5.25,4440,12620
3.25e+05,2014,222,2,1,1400,10800,1,0,0,4,7,1400,0,1974,1974,98011,47.773,122.21,1560,11280,40,0,3,2960,12680
8.599e+05,2014,221,4,2.75,3390,6298,2,0,0,3,9,3390,0,2011,2011,98074,47.591,122.06,3390,7111,3,0,6.75,6780,10501
6.225e+05,2014,163,5,2.75,3320,23760,2,0,0,4,8,2190,1130,1975,1975,98072,47.75,122.15,2520,36720,39,0,7.75,5840,40040
6.875e+05,2014,174,4,1.75,2330,5000,1,0,0,4,7,1510,820,1929,1929,98117,47.682,122.37,1460,5000,85,0,5.75,3790,7330
1.295e+06,2015,444,3,2.75,3450,5350,1,0,3,4,9,2590,860,1925,1925,98199,47.639,122.41,2910,5350,90,0,5.75,6360,8800
1.13e+06,2014,211,4,2.5,2660,11200,2,0,0,3,9,2660,0,1999,1999,98004,47.589,122.2,3290,11275,15,0,6.5,5950,13935
3.1e+05,2015,485,2,1,1020,8102,1,0,0,3,7,1020,0,1956,1956,98056,47.514,122.19,1770,7291,59,0,3,2790,8311
8.3e+05,2014,125,4,2.5,3400,9692,2,0,0,3,9,3400,0,2007,2007,98052,47.708,122.11,3070,7375,7,0,6.5,6470,10775
4.47e+05,2014,242,3,1,1270,8800,1,0,0,3,7,1270,0,1968,1968,98052,47.67,122.15,1560,8250,46,0,4,2830,9520
3.31e+05,2014,297,3,3.25,1290,1153,3,0,0,3,7,1290,0,2008,2008,98103,47.69,122.35,1290,1200,6,0,6.25,2580,2490
5.1e+05,2014,156,4,1.5,1320,14250,1,0,0,4,7,1320,0,1954,1954,98033,47.702,122.2,1720,14250,60,0,5.5,3040,15570
9.5e+05,2015,451,4,2.5,1700,4418,2,0,0,3,8,1700,0,1931,2000,98112,47.643,122.3,2090,4174,84,1,6.5,3790,5874
4.92e+05,2014,237,3,2.25,2100,7335,2,0,0,3,8,2100,0,1983,1983,98074,47.647,122.06,2050,8930,31,0,5.25,4150,11030
5.07e+05,2014,244,3,1,1180,6000,1,0,0,3,7,1180,0,1950,1950,98115,47.685,122.29,1680,6000,64,0,4,2860,7180
2.45e+05,2014,175,3,2,1410,5760,1,0,0,3,7,1410,0,1985,1985,98030,47.37,122.19,1670,6222,29,0,5,3080,7632
7.0995e+05,2014,317,4,3.25,3910,6293,2,0,0,3,9,3130,780,2006,2006,98065,47.539,121.86,4410,6015,8,0,7.25,8320,9925
7.6e+05,2015,460,6,3.75,3810,6150,2,0,0,4,8,3810,0,1977,1977,98103,47.694,122.34,1830,5125,38,0,9.75,5640,8935
5.45e+05,2014,225,3,1.75,1700,5750,1,0,2,5,7,1450,250,1925,1925,98126,47.564,122.38,1700,5750,89,0,4.75,3400,7450
7.079e+05,2014,242,3,1,1750,5355,2,0,0,4,7,1750,0,1929,1929,98115,47.679,122.31,2240,4590,85,0,4,3990,6340
1.095e+06,2014,201,5,3.5,4410,57063,2,0,0,4,9,4410,0,1990,1990,98053,47.655,122.02,2900,50529,24,0,8.5,7310,54939
3e+05,2014,290,6,2.5,3080,8163,1,0,0,3,7,1580,1500,1985,1985,98030,47.386,122.22,1850,8658,29,0,8.5,4930,11738
2.95e+06,2014,239,4,3.5,4860,23885,2,0,0,3,12,4860,0,1996,1996,98039,47.617,122.23,3580,16054,18,0,7.5,8440,20914
2.61e+05,2014,222,3,1,1660,11200,1,0,0,3,7,1660,0,1957,1957,98056,47.512,122.17,1380,10875,57,0,4,3040,12535
5.8e+05,2015,443,2,1.5,1220,5000,1,0,2,4,7,1220,0,1938,1938,98103,47.662,122.35,2090,3850,77,0,3.5,3310,5070
3.75e+05,2014,196,3,1,1520,10798,1,0,0,3,7,1520,0,1953,1953,98028,47.764,122.26,1670,9876,61,0,4,3190,11396
2.375e+05,2015,444,3,1.75,1050,7854,1,0,0,4,7,1050,0,1975,1975,98023,47.301,122.37,1360,7668,40,0,4.75,2410,8718
4.435e+05,2014,284,3,2,1920,7598,1,0,0,4,8,1920,0,1972,1972,98177,47.773,122.36,2220,7598,42,0,5,4140,9518
5.4e+05,2014,283,5,3,2570,5590,1,0,0,3,8,1580,990,2009,2009,98034,47.727,122.23,2020,10500,5,0,8,4590,13070
3.645e+05,2014,209,3,1.75,1740,8424,1,0,0,5,7,1040,700,1954,1954,98133,47.751,122.35,1370,8424,60,0,4.75,3110,10164
5.65e+05,2014,191,4,1.75,2140,7102,1,0,0,4,7,1070,1070,1948,1948,98177,47.704,122.37,1950,7102,66,0,5.75,4090,9242
95000,2014,259,2,1,1070,20450,1,0,0,2,6,1070,0,1948,1948,98058,47.434,122.18,1360,15581,66,0,3,2430,16651
5.9357e+05,2015,479,3,2.5,1770,3205,2,0,0,3,9,1770,0,2005,2005,98052,47.666,122.08,2120,4134,10,0,5.5,3890,5904
3.11e+05,2014,248,4,2.25,3340,8000,2,0,0,4,8,3340,0,1973,1973,98023,47.317,122.39,2230,8000,41,0,6.25,5570,11340
2.65e+05,2014,194,3,1.75,1170,8148,1,0,0,3,7,1170,0,1952,1952,98155,47.748,122.32,1200,8147,62,0,4.75,2370,9317
3.745e+05,2015,388,3,1,960,9531,1,0,0,5,7,960,0,1969,1969,98072,47.762,122.16,1670,9250,46,0,4,2630,10210
3.7e+05,2014,231,3,2.25,1650,4859,2,0,0,3,7,1650,0,1988,1988,98011,47.773,122.17,1890,5018,26,0,5.25,3540,6668
3.2509e+05,2014,334,4,1,1400,6739,1,0,0,3,7,1000,400,1954,1954,98108,47.54,122.3,1500,6380,60,0,5,2900,7780
3.16e+05,2014,134,4,2.5,2010,7226,2,0,0,3,8,2010,0,1995,1995,98092,47.259,122.21,2160,7696,19,0,6.5,4170,9706
6.3293e+05,2014,304,3,2.5,2990,32239,2,0,0,4,8,2990,0,1978,1978,98077,47.772,122.09,2990,36497,36,0,5.5,5980,39487
2.05e+05,2014,136,5,1.75,1730,5200,1,0,0,4,7,1050,680,1978,1978,98042,47.363,122.09,1350,5200,36,0,6.75,3080,6930
3.805e+05,2015,438,3,2,1270,1348,3,0,0,3,8,1270,0,2003,2003,98103,47.693,122.34,1180,1360,12,0,5,2450,2630
6.35e+05,2015,457,5,2.25,2180,6000,1,0,0,4,8,1430,750,1966,1966,98007,47.623,122.14,2160,8800,49,0,7.25,4340,10980
3.85e+05,2014,334,5,2,2020,4000,2,0,0,3,7,2020,0,1950,1950,98144,47.58,122.31,1960,4000,64,0,7,3980,6020
5.25e+05,2014,194,5,2.5,2360,10081,1,0,0,4,7,1180,1180,1961,1961,98006,47.555,122.18,2200,10461,53,0,7.5,4560,12821
3.44e+05,2014,203,2,1,1060,3325,1,0,0,4,6,770,290,1932,1932,98115,47.69,122.31,1820,4275,82,0,3,2880,5335
3.5e+05,2014,320,3,1.5,1550,40752,1,0,0,5,7,1550,0,1954,1954,98031,47.394,122.2,1550,8000,60,0,4.5,3100,9550
5.02e+05,2014,181,3,2.25,1600,45613,2,0,0,4,8,1600,0,1983,1983,98072,47.752,122.12,2320,43005,31,0,5.25,3920,44605
2.66e+05,2014,187,4,2.25,1995,7102,2,0,0,4,8,1995,0,1981,1981,98023,47.299,122.37,1880,7950,33,0,6.25,3875,9945
4.65e+05,2014,129,4,2.5,1930,9653,1,0,0,4,9,1930,0,1968,1968,98023,47.337,122.33,2100,10454,46,0,6.5,4030,12384
6.75e+05,2015,362,5,2.75,2570,12906,2,0,0,3,8,2570,0,1987,1987,98075,47.581,122.05,2580,12927,28,0,7.75,5150,15497
4.47e+05,2014,224,3,2.5,1650,3076,2,0,0,3,7,1650,0,2003,2003,98053,47.682,122.03,1560,3064,11,0,5.5,3210,4714
1e+05,2014,127,2,1,910,22000,1,0,0,3,6,910,0,1956,1956,98001,47.278,122.25,1326,9891,58,0,3,2236,10801
2.8e+05,2014,250,3,2.25,2140,7200,2,0,0,4,7,2140,0,1979,1979,98031,47.391,122.19,1890,7455,35,0,5.25,4030,9595
6.95e+05,2014,153,4,2.5,2961,12146,2,0,0,3,9,2961,0,1998,1998,98075,47.584,122.05,2620,17749,16,0,6.5,5581,20710
8.325e+05,2014,228,3,2,1870,9527,1,0,0,4,7,1870,0,1951,1997,98040,47.578,122.22,1970,11904,63,1,5,3840,13774
2.9e+05,2014,251,2,1,960,4000,1,0,0,3,6,960,0,1918,1918,98118,47.555,122.27,1210,4000,96,0,3,2170,4960
2.2e+05,2014,166,3,2,1410,7998,1,0,0,4,7,1410,0,1940,1940,98178,47.497,122.28,1780,8278,74,0,5,3190,9688
6.4e+05,2014,202,3,2.5,2390,8315,2,0,0,4,9,2390,0,1990,1990,98074,47.627,122.03,2370,7816,24,0,5.5,4760,10206
2.762e+05,2015,485,2,1.75,1370,4495,1,0,0,4,8,1370,0,1975,1975,98198,47.379,122.32,1370,4686,40,0,3.75,2740,6056
8.05e+05,2014,278,4,2.5,2910,9000,2,0,0,3,9,2910,0,1989,1989,98006,47.545,122.14,2530,9000,25,0,6.5,5440,11910
6.04e+05,2014,129,4,2.5,2260,7753,2,0,0,3,9,2260,0,1989,1989,98029,47.575,122,2690,8924,25,0,6.5,4950,11184
8e+05,2014,160,3,2.25,1620,4500,2,0,0,4,8,1620,0,1926,1926,98119,47.643,122.36,1210,4320,88,0,5.25,2830,5940
3.7499e+05,2015,451,3,2.5,1300,10484,2,0,0,3,8,1300,0,1983,1983,98028,47.777,122.27,1380,7868,32,0,5.5,2680,9168
1.28e+05,2014,279,3,1,910,11117,1,0,0,3,7,910,0,1955,1955,98003,47.343,122.31,1490,8416,59,0,4,2400,9326
6.45e+05,2014,149,3,3.25,1730,1229,2,0,2,3,9,1320,410,2008,2008,98119,47.637,122.37,1710,1686,6,0,6.25,3440,3416
5.8e+05,2014,214,3,2.25,1480,1026,3,0,0,3,8,1480,0,2014,2014,98103,47.654,122.35,1570,1283,0,0,5.25,3050,2763
4.1725e+05,2014,127,3,2.25,1606,1452,3,0,0,3,8,1606,0,2009,2009,98125,47.718,122.28,1516,1939,5,0,5.25,3122,3545
5.35e+05,2015,480,4,2.5,2240,6920,1,0,0,5,8,1380,860,1974,1974,98146,47.501,122.38,1540,7000,41,0,6.5,3780,9240
4.75e+05,2014,231,3,1.5,1930,11092,1,0,0,3,7,1500,430,1983,1983,98074,47.634,122.03,1230,10964,31,0,4.5,3160,12894
2.88e+05,2015,493,3,2.5,1370,9253,1,0,0,3,7,1090,280,1994,1994,98042,47.372,122.07,1470,9253,21,0,5.5,2840,10623
4.5e+05,2014,196,2,2,1900,7740,1,0,0,4,7,1150,750,1923,1923,98126,47.523,122.37,1140,7740,91,0,4,3040,9640
4.3e+05,2014,236,4,2.5,2750,7200,2,0,0,3,8,2750,0,2011,2011,98019,47.733,121.97,2750,7200,3,0,6.5,5500,9950
2.47e+05,2015,362,3,2.5,1510,10875,1,0,0,3,7,1150,360,1990,1990,98003,47.348,122.3,1810,9916,25,0,5.5,3320,11426
8.19e+05,2015,478,3,1,1300,3600,2,0,0,3,7,1300,0,1900,1900,98119,47.635,122.37,2510,4800,115,0,4,3810,6100
1.2e+06,2015,477,4,2.5,4280,12796,2,0,0,3,11,3400,880,1999,1999,98006,47.559,122.12,3520,9593,16,0,6.5,7800,13873
1.8e+05,2014,314,3,1,1010,8581,1,0,0,4,6,1010,0,1920,1920,98002,47.304,122.22,1060,10354,94,0,4,2070,11364
4.4e+05,2014,235,4,2.5,2300,10880,1,0,0,4,7,1190,1110,1961,1961,98028,47.734,122.24,1960,10400,53,0,6.5,4260,12700
9.5e+05,2015,472,3,3,3610,17483,2,0,2,4,8,3610,0,1954,1954,98146,47.485,122.36,2230,12600,61,0,6,5840,16210
7.09e+05,2015,487,4,1.75,2170,4600,1,0,0,3,7,1270,900,1950,1950,98117,47.689,122.38,1750,4000,65,0,5.75,3920,6170
3.395e+05,2014,272,4,2.5,1930,7862,2,0,0,3,7,1930,0,1994,1994,98038,47.364,122.04,1640,9145,20,0,6.5,3570,11075
5.042e+05,2014,177,2,1.5,1200,1687,3,0,0,3,8,1200,0,2008,2008,98103,47.649,122.33,1240,1296,6,0,3.5,2440,2496
2e+05,2014,359,3,1,2120,31564,1,0,0,3,7,1220,900,1942,1942,98168,47.494,122.3,1790,11571,72,0,4,3910,13691
2.435e+05,2014,142,4,2.5,1980,7403,2,0,0,3,7,1980,0,1988,1988,98023,47.29,122.37,1980,7510,26,0,6.5,3960,9490
4.6455e+05,2015,381,3,1.5,1690,10500,1,0,0,4,7,1690,0,1967,1967,98033,47.702,122.17,1570,10500,48,0,4.5,3260,12190
4.95e+05,2014,218,5,2.75,2630,10165,1,0,0,4,8,1690,940,1976,1976,98027,47.52,122.05,2440,10165,38,0,7.75,5070,12795
4.2875e+05,2015,422,3,1,1100,4080,1,0,0,4,7,900,200,1929,1929,98103,47.687,122.35,1170,4080,86,0,4,2270,5180
1.35e+06,2014,249,4,3.25,3030,5164,1,0,0,5,9,2700,330,1925,1925,98112,47.639,122.3,1890,4415,89,0,7.25,4920,7445
7.9415e+05,2014,127,4,2,2210,8556,1,0,1,4,8,1210,1000,1954,1954,98199,47.65,122.4,2190,7975,60,0,6,4400,10185
4.07e+05,2015,444,2,2.5,1340,999,2,0,0,3,8,940,400,2008,2008,98116,47.566,122.39,1470,1436,7,0,4.5,2810,2776
3.4695e+05,2014,208,3,1.75,1830,10954,1,0,0,3,7,1830,0,1963,1963,98155,47.755,122.31,1850,8624,51,0,4.75,3680,10454
6e+05,2014,195,2,1,1180,2160,1,0,1,3,7,940,240,1909,1909,98119,47.631,122.37,2700,5400,105,0,3,3880,6580
9.8e+05,2014,256,4,1.75,2120,4000,1,0,0,4,8,1920,200,1929,1929,98105,47.66,122.28,2300,4000,85,0,5.75,4420,6120
1.7e+06,2014,297,5,2,2500,15250,2,1,4,5,8,2500,0,1942,1942,98008,47.588,122.11,1880,18782,72,0,7,4380,21282
2.78e+05,2015,437,5,1.5,1820,8712,1,0,0,5,7,1090,730,1960,1960,98032,47.371,122.29,1820,8712,55,0,6.5,3640,10532
9.5e+05,2015,463,7,3.5,3470,16264,2,0,0,4,9,3470,0,1980,1980,98007,47.62,122.15,3040,13500,35,0,10.5,6510,16970
5e+05,2014,340,3,1,1800,7200,1,0,0,3,7,1020,780,1964,1964,98118,47.562,122.28,1740,5475,50,0,4,3540,7275
3.94e+05,2014,290,3,2.5,1680,4075,2,0,0,3,7,1680,0,2008,2008,98053,47.696,122.02,1710,4075,6,0,5.5,3390,5755
2.5e+05,2014,333,4,2.75,1830,6643,2,0,0,3,8,1830,0,2001,2001,98001,47.26,122.29,2400,6472,13,0,6.75,4230,8302
1.7128e+06,2015,429,5,2.5,2660,6572,1,0,0,5,9,1960,700,1959,1959,98039,47.618,122.22,3960,14595,56,0,7.5,6620,17255
4.5e+05,2014,198,3,1.75,1540,9154,1,0,0,3,8,1540,0,1983,1983,98074,47.621,122.04,1990,10273,31,0,4.75,3530,11813
2.4e+05,2014,236,3,1.75,1520,9600,1,0,0,3,8,1520,0,1966,1966,98023,47.326,122.36,2060,9600,48,0,4.75,3580,11120
8.5e+05,2014,284,4,3,2550,3784,1,0,0,4,8,1750,800,1900,1900,98103,47.656,122.34,2100,4560,114,0,7,4650,7110
4.05e+05,2014,237,3,1,1220,7771,1,0,0,3,7,1220,0,1963,1963,98008,47.633,122.12,1420,7674,51,0,4,2640,8894
4e+05,2014,175,3,2.5,2180,7508,1,0,0,4,7,1420,760,1962,1962,98133,47.761,122.34,1900,7818,52,0,5.5,4080,9998
5.35e+05,2015,382,4,1,1660,10656,1,0,0,4,7,1180,480,1920,1920,98136,47.539,122.39,1120,8816,95,0,5,2780,10476
5.42e+05,2015,413,3,2.25,2220,12056,2,0,0,3,8,2220,0,1985,1985,98052,47.715,122.1,2320,12025,30,0,5.25,4540,14245
2.35e+05,2014,153,3,2,1530,8700,1,0,0,4,7,1530,0,1970,1970,98055,47.453,122.21,1960,7600,44,0,5,3490,9130
4.15e+05,2014,177,3,1.75,2410,8944,1,0,0,4,8,1860,550,1967,1967,98058,47.449,122.14,2750,9600,47,0,4.75,5160,12010
4.8825e+05,2014,277,4,2,1830,9610,1,0,0,3,7,1830,0,1963,1963,98033,47.695,122.18,1970,10754,51,0,6,3800,12584
1.03e+06,2014,310,3,2.5,3545,9816,1,0,0,3,10,2610,935,2005,2005,98027,47.553,122.08,3630,7704,9,0,5.5,7175,11249
5.15e+05,2014,311,2,1.5,1400,5000,1,0,0,4,7,1150,250,1904,1904,98107,47.668,122.36,1530,4200,110,0,3.5,2930,5600
3.248e+05,2015,457,2,1,1170,5043,1,0,0,3,6,880,290,1949,1949,98108,47.549,122.3,1430,5692,66,0,3,2600,6862
4.17e+05,2014,265,2,1,1190,5100,1,0,0,2,7,1190,0,1928,1928,98117,47.677,122.38,1920,5100,86,0,3,3110,6290
1.2025e+06,2014,194,3,2.5,3430,28718,1,0,0,3,10,3430,0,1984,1984,98033,47.648,122.18,3440,35021,30,0,5.5,6870,38451
2.705e+05,2015,414,3,1.5,1952,8613,1,0,0,4,7,1652,300,1960,1960,98032,47.371,122.29,1400,8712,55,0,4.5,3352,10664
6.295e+05,2015,484,3,2,2020,10584,1,0,0,3,10,2020,0,1994,1994,98075,47.585,122.03,3030,9870,21,0,5,5050,11890
2.45e+05,2014,288,3,2,1450,9333,2,0,0,4,7,1450,0,1972,1972,98003,47.346,122.31,1910,7701,42,0,5,3360,9151
5.97e+05,2015,443,4,2.5,2370,41338,2,0,0,3,8,2370,0,1995,1995,98077,47.738,122.05,2340,46661,20,0,6.5,4710,49031
3.35e+05,2014,154,4,2.75,2540,7210,1,0,0,4,7,1600,940,1979,1979,98058,47.46,122.17,1820,7766,35,0,6.75,4360,10306
5.15e+05,2014,173,5,3.25,2910,5027,2,0,0,3,8,2040,870,2013,2013,98106,47.554,122.36,2910,5027,1,0,8.25,5820,7937
2.34e+05,2014,161,3,2,1640,5280,1,0,0,5,6,1640,0,1910,1910,98002,47.309,122.21,1160,7875,104,0,5,2800,9515
5.14e+05,2014,238,3,2,1770,7200,1,0,0,4,7,1770,0,1967,1967,98033,47.664,122.17,2250,11250,47,0,5,4020,13020
2.52e+05,2015,394,3,2,1370,7500,1,0,0,3,7,1370,0,1997,1997,98038,47.363,122.05,1420,7500,18,0,5,2790,8870
5e+05,2015,362,3,2.5,2760,35171,2,0,0,3,9,2760,0,1990,1990,98058,47.465,122.12,2720,35171,25,0,5.5,5480,37931
5.625e+05,2014,201,4,2.5,2440,7322,2,0,0,3,9,2440,0,1991,1991,98056,47.536,122.18,2590,9927,23,0,6.5,5030,12367
5.81e+05,2014,127,4,2,2510,13695,1,0,0,4,7,1280,1230,1961,2001,98033,47.7,122.17,1220,12500,53,1,6,3730,15010
7.3495e+05,2014,189,4,3.25,4280,47179,2,0,0,3,10,3050,1230,2002,2002,98092,47.302,122.13,2820,43401,12,0,7.25,7100,47681
3.5e+05,2014,235,4,2,2060,13400,1,0,2,4,8,2060,0,1957,1957,98166,47.44,122.34,1950,10370,57,0,6,4010,12430
4.2e+05,2014,217,4,1.75,1940,11500,1,0,0,4,7,1090,850,1955,1955,98006,47.577,122.15,1700,8360,59,0,5.75,3640,10300
7.75e+05,2014,176,3,2.75,2850,14800,1,0,0,4,9,1920,930,1976,1976,98006,47.559,122.15,3300,10809,38,0,5.75,6150,13659
3.9e+05,2014,325,3,2,1910,11576,1,0,0,3,7,1410,500,1978,1978,98011,47.736,122.2,2040,8750,36,0,5,3950,10660
6.45e+05,2015,493,3,2,1640,4218,1,0,0,4,7,910,730,1941,1941,98103,47.655,122.34,1670,4000,74,0,5,3310,5640
1.388e+06,2014,318,3,1.25,2400,6653,3,0,2,3,11,2400,0,1992,1992,98122,47.602,122.29,1910,6653,22,0,4.25,4310,9053
2.65e+05,2014,334,3,1,1080,4930,1,0,0,3,6,1080,0,1950,1950,98126,47.521,122.37,1100,5950,64,0,4,2180,7030
2.4995e+05,2014,303,3,2,1670,4438,1,0,0,3,7,1670,0,2014,2014,98022,47.195,121.97,1670,4558,0,0,5,3340,6228
5.07e+05,2014,279,2,1.75,1670,6460,1,0,0,3,8,1670,0,2004,2004,98053,47.712,122.03,2170,6254,10,0,3.75,3840,7924
6.04e+05,2015,400,4,1.75,1490,4485,1,0,0,3,8,1350,140,1960,1960,98199,47.639,122.4,1380,4846,55,0,5.75,2870,6336
5.8775e+05,2015,431,2,1,890,4730,1,0,0,3,7,890,0,1941,1941,98103,47.688,122.34,1330,5904,74,0,3,2220,6794
4.59e+05,2015,383,4,3,1900,9077,2,0,0,3,7,1900,0,1954,2015,98155,47.768,122.3,1900,12868,61,1,7,3800,14768
7.108e+05,2014,251,3,2.5,2880,36820,2,0,0,3,10,2880,0,1992,1992,98077,47.766,122.04,3190,36820,22,0,5.5,6070,39700
1.75e+05,2015,478,1,1,620,8685,1,0,0,4,5,620,0,1976,1976,98198,47.41,122.29,1300,12150,39,0,2,1920,12770
8.52e+05,2015,477,3,3,2400,4000,2,0,0,3,7,1860,540,1905,1905,98102,47.629,122.32,1750,3940,110,0,6,4150,6340
2.7525e+05,2014,182,3,2.25,1520,7199,2,0,0,4,7,1520,0,1992,1992,98038,47.349,122.03,1410,6751,22,0,5.25,2930,8271
4.2025e+05,2015,471,3,2,1510,3657,1,0,0,3,8,1510,0,2007,2007,98053,47.722,122.03,1510,3657,8,0,5,3020,5167
1.97e+05,2015,414,4,1,1360,11175,1,0,0,3,7,1360,0,1961,1961,98188,47.455,122.27,1340,9702,54,0,5,2700,11062
6.99e+05,2014,140,4,2.5,2650,7945,2,0,0,3,9,2650,0,2006,2006,98125,47.711,122.3,1200,7920,8,0,6.5,3850,10570
6.7e+05,2014,190,3,2.5,1420,1438,2,0,0,3,9,1280,140,2003,2003,98102,47.627,122.32,1490,1439,11,0,5.5,2910,2859
7.5e+05,2014,159,4,3.25,2050,5000,2,0,0,4,8,1370,680,1987,1987,98112,47.623,122.3,1720,5000,27,0,7.25,3770,7050
6.25e+05,2015,487,3,2.25,2570,47480,1,0,0,3,9,2570,0,1979,1979,98053,47.685,122.08,2570,1.0672e+05,36,0,5.25,5140,1.0929e+05
3.95e+05,2014,183,4,2.75,2640,35070,1,0,0,3,8,2640,0,1963,1963,98058,47.424,122.18,2520,34986,51,0,6.75,5160,37626
2.75e+05,2014,263,3,1.5,1240,9125,1,0,0,4,7,1240,0,1967,1967,98058,47.447,122.16,1670,9125,47,0,4.5,2910,10365
4.57e+05,2014,311,3,1.75,1690,6375,1,0,0,3,8,1690,0,1903,2002,98024,47.525,121.93,1270,7774,111,1,4.75,2960,9464
1.875e+05,2014,208,3,1,840,8400,1,0,0,3,6,840,0,1959,1959,98023,47.328,122.34,1030,8640,55,0,4,1870,9480
4.6495e+05,2015,492,4,2.25,2350,36116,1,0,0,4,9,2350,0,1983,1983,98042,47.353,122.08,2580,36116,32,0,6.25,4930,38466
1.8725e+05,2014,333,2,1,710,14700,1,0,0,5,6,710,0,1926,1926,98168,47.494,122.32,1320,14700,88,0,3,2030,15410
2.165e+05,2015,464,3,1,1170,9000,1,0,0,4,6,1170,0,1918,1918,98022,47.211,121.99,1280,8160,97,0,4,2450,9330
4.075e+05,2015,462,4,2.5,1900,9075,2,0,0,3,7,1900,0,1988,1988,98133,47.778,122.35,1800,8460,27,0,6.5,3700,10360
5.25e+05,2014,258,2,1,880,4000,1,0,0,3,7,880,0,1940,1940,98117,47.685,122.39,1310,4000,74,0,3,2190,4880
8.9e+05,2014,221,4,2.75,3220,15467,2,0,0,3,11,3220,0,1994,1994,98077,47.713,122.08,3670,16641,20,0,6.75,6890,19861
3.195e+05,2014,284,4,2.75,2500,5100,1,0,0,4,7,1420,1080,1907,1907,98108,47.523,122.33,1430,5100,107,0,6.75,3930,7600
5.054e+05,2015,421,3,1.75,1640,3400,1,0,0,4,7,930,710,1926,1926,98105,47.669,122.3,1380,3750,89,0,4.75,3020,5390
7.35e+05,2015,460,4,3.5,2340,2810,2,0,2,3,8,1730,610,2011,2011,98027,47.54,122.03,2600,2843,4,0,7.5,4940,5183
4.3647e+05,2014,221,4,2.5,2692,8392,2,0,0,3,9,2692,0,2014,2014,98030,47.352,122.2,2574,14446,0,0,6.5,5266,17138
2.1e+05,2015,445,3,1,1660,7440,1,0,0,3,7,1270,390,1957,1957,98106,47.524,122.36,1540,7440,58,0,4,3200,9100
3.58e+05,2014,176,3,1.5,2450,12497,1,0,0,4,7,2450,0,1967,1967,98065,47.532,121.83,1560,11700,47,0,4.5,4010,14150
3.7e+05,2015,436,4,2.5,2570,7753,2,0,0,3,8,2570,0,1987,1987,98058,47.424,122.16,2140,7615,28,0,6.5,4710,10185
6.15e+05,2014,173,5,2,2130,4180,1,0,0,5,7,1270,860,1926,1926,98116,47.575,122.39,1710,4180,88,0,7,3840,6310
5.5012e+05,2014,285,5,2.5,2620,8050,1,0,0,3,8,1520,1100,1975,1975,98052,47.692,122.11,2030,7676,39,0,7.5,4650,10296
2.6e+05,2014,129,3,2,1920,8075,1,0,0,4,7,1510,410,1969,1969,98023,47.309,122.38,1920,7826,45,0,5,3840,9746
4.46e+05,2014,204,4,1.75,1730,5922,2,0,0,5,7,1730,0,1949,1949,98125,47.719,122.32,1700,6127,65,0,5.75,3430,7857
3.6e+05,2014,235,2,2,1180,3200,1,0,1,4,6,590,590,1945,1945,98136,47.528,122.38,1350,4000,69,0,4,2530,5180
4.508e+05,2014,147,4,3.25,2510,5311,2,0,0,3,9,2510,0,2009,2009,98056,47.503,122.17,1590,9583,5,0,7.25,4100,12093
9.39e+05,2014,152,4,2.75,3270,12880,2,0,0,3,9,3270,0,2014,2014,98033,47.668,122.17,2420,7505,0,0,6.75,5690,10775
7.75e+05,2014,211,4,3.5,3080,5250,2,0,0,3,9,3080,0,2003,2003,98075,47.599,121.97,2980,5509,11,0,7.5,6060,8589
5.61e+05,2014,284,3,1.75,1710,5000,1,0,0,4,7,1360,350,1918,1918,98136,47.549,122.39,1490,6250,96,0,4.75,3200,7960
2.645e+05,2014,310,3,1.5,1580,14040,1,0,0,3,7,1050,530,1980,1980,98001,47.293,122.27,2240,12000,34,0,4.5,3820,13580
5.54e+05,2014,215,2,2,1870,5580,1,0,0,3,8,1870,0,2004,2004,98053,47.71,122.03,1670,4500,10,0,4,3540,6370
7e+05,2015,408,4,2.75,2870,8625,1,0,1,4,8,1860,1010,1959,1959,98155,47.742,122.29,2430,8479,56,0,6.75,5300,11349
2.414e+05,2015,456,3,2,1420,9828,1,0,0,4,7,1420,0,1990,1990,98010,47.329,122.01,1550,7227,25,0,5,2970,8647
4.365e+05,2014,180,4,2.5,2290,11173,2,0,0,4,8,2290,0,1988,1988,98058,47.431,122.16,2290,10404,26,0,6.5,4580,12694
3.05e+05,2015,382,4,2,1610,6250,1,0,0,4,7,1610,0,1952,1952,98118,47.529,122.27,1310,6000,63,0,6,2920,7610
3.91e+05,2015,470,3,2,1490,9000,1,0,0,4,8,1490,0,1977,1977,98006,47.545,122.18,2190,9000,38,0,5,3680,10490
2.475e+05,2015,438,3,0.75,1300,72309,1,0,0,3,6,680,620,1950,1987,98006,47.567,122.12,3080,8395,65,1,3.75,4380,9695
5.432e+05,2014,128,6,2.25,2820,15600,1,0,2,5,7,1970,850,1940,1940,98166,47.464,122.36,2520,7797,74,0,8.25,5340,10617
1.86e+05,2015,401,3,1,1200,10080,1,0,0,4,7,1200,0,1969,1969,98042,47.326,122.14,1230,9800,46,0,4,2430,11000
3.25e+05,2015,366,4,2.5,2260,5702,2,0,0,3,8,2260,0,2002,2002,98042,47.349,122.15,2450,6381,13,0,6.5,4710,8641
8.75e+05,2015,472,3,2.5,2520,3750,2,0,1,4,9,2520,0,1995,1995,98116,47.567,122.4,2250,6200,20,0,5.5,4770,8720
5.12e+05,2014,201,2,2.25,1170,1313,3,0,0,3,8,1170,0,2007,2007,98107,47.671,122.38,1310,1304,7,0,4.25,2480,2474
3.3595e+05,2014,187,2,1.5,800,5192,1,0,0,5,7,800,0,1951,1951,98146,47.512,122.39,1190,5320,63,0,3.5,1990,6120
3.6e+05,2014,292,4,2.5,2050,9143,2,0,0,3,8,2050,0,1992,1992,98166,47.46,122.36,1510,9484,22,0,6.5,3560,11534
3.35e+05,2014,192,3,2.25,1530,4580,2,0,0,3,7,1530,0,2011,2011,98019,47.734,121.97,2110,4094,3,0,5.25,3640,5624
6.7e+05,2014,198,3,1.75,1280,2147,1,0,0,4,7,1280,0,1910,1910,98102,47.636,122.32,2010,2640,104,0,4.75,3290,3920
1.7e+05,2014,167,4,1,1920,13787,1,0,0,4,7,1220,700,1966,1966,98188,47.45,122.28,1490,11200,48,0,5,3410,13120
6.91e+05,2014,141,4,2.75,2550,8632,1,0,0,3,8,1700,850,1972,1972,98033,47.648,122.2,2550,9534,42,0,6.75,5100,12084
5.91e+05,2014,262,3,2,1460,3600,2,0,0,3,7,1460,0,1902,1902,98122,47.612,122.31,1590,1210,112,0,5,3050,2670
2.8e+05,2015,487,3,3,1390,1080,2,0,0,3,7,1140,250,2006,2006,98118,47.532,122.28,1450,1461,9,0,6,2840,2851
7.44e+05,2014,141,4,2.75,2830,13059,2,0,0,3,10,2830,0,1998,1998,98075,47.595,121.99,3840,11596,16,0,6.75,6670,14426
3.35e+05,2015,477,3,1,2320,6750,1,0,0,3,7,1160,1160,1960,1960,98118,47.533,122.28,1230,6075,55,0,4,3550,8395
2.25e+05,2014,230,2,1,1170,7142,1,0,0,3,7,1170,0,1951,1951,98155,47.75,122.31,1170,7615,63,0,3,2340,8785
2.45e+05,2014,245,4,2.25,2190,9113,2,0,0,3,7,2190,0,1986,1986,98001,47.324,122.28,1570,8306,28,0,6.25,3760,10496
4.065e+05,2014,361,3,2.75,1840,68479,1,0,2,3,8,1340,500,1989,1989,98014,47.68,121.91,2060,61903,25,0,5.75,3900,63743
4.425e+05,2014,210,3,1.5,1800,8303,1,0,0,3,7,1200,600,1957,1957,98133,47.769,122.36,1800,8171,57,0,4.5,3600,9971
1.899e+05,2014,278,2,1,800,5600,1,0,0,5,6,800,0,1955,1955,98056,47.496,122.17,1100,6000,59,0,3,1900,6800
5.3995e+05,2015,447,3,2.5,1330,2180,3,0,0,3,8,1330,0,2014,2014,98117,47.699,122.36,1330,5000,1,0,5.5,2660,6330
2.7e+05,2014,218,3,2.25,1470,16728,1,0,0,4,7,1350,120,1959,1959,98168,47.497,122.3,1540,9000,55,0,5.25,3010,10470
2e+05,2014,140,3,1,1050,5000,1,0,0,4,6,1050,0,1967,1967,98056,47.492,122.17,1050,5200,47,0,4,2100,6250
2.55e+05,2014,262,4,2.5,1580,7800,1,0,0,4,7,1580,0,1959,1959,98059,47.481,122.16,1320,7800,55,0,6.5,2900,9380
4.86e+05,2014,189,4,2.5,3560,12047,2,0,0,3,10,3560,0,1988,1988,98023,47.302,122.34,3420,11250,26,0,6.5,6980,14810
6.511e+05,2015,450,4,2.5,2310,5526,2,0,0,3,9,2310,0,2003,2003,98074,47.63,122.02,2500,5769,12,0,6.5,4810,8079
2.84e+05,2015,487,3,2.25,1580,7034,1,0,0,4,7,1180,400,1989,1989,98038,47.356,122.04,1470,7358,26,0,5.25,3050,8938
8.2575e+05,2015,399,4,3.5,2950,3737,2,0,0,3,10,2270,680,2012,2012,98027,47.531,122.07,2580,3581,3,0,7.5,5530,6531
5.02e+05,2014,133,4,2.5,2040,5616,2,0,0,3,8,2040,0,2012,2012,98028,47.774,122.24,2380,4737,2,0,6.5,4420,6777
5.985e+05,2014,300,3,3,1560,2091,3,0,0,3,8,1560,0,2006,2006,98103,47.66,122.35,1530,2091,8,0,6,3090,3651
2.33e+05,2015,472,3,1,1980,8505,1,0,0,3,7,1030,950,1965,1965,98106,47.538,122.35,1830,8505,50,0,4,3810,10485
8.959e+05,2015,415,4,3.5,3640,4983,2,0,3,3,9,2790,850,2014,2014,98075,47.562,122.03,3270,14700,1,0,7.5,6910,18340
1.75e+05,2015,474,2,1,840,12750,1,0,0,3,6,840,0,1925,1925,98055,47.484,122.21,1480,6969,90,0,3,2320,7809
5.2e+05,2014,249,2,1.75,1340,1368,2,0,0,3,7,1060,280,2006,2006,98122,47.618,122.31,2480,1707,8,0,3.75,3820,3047
2.9995e+05,2015,365,4,2.25,1810,7601,1,0,0,3,7,1080,730,1986,1986,98023,47.286,122.36,1570,7601,29,0,6.25,3380,9411
3.28e+05,2014,125,4,2.5,2370,6500,2,0,0,3,9,2370,0,1998,1998,98092,47.333,122.17,2590,6137,16,0,6.5,4960,8507
6.75e+05,2015,464,3,1.75,1660,9549,1,0,0,3,7,1660,0,1956,1956,98033,47.65,122.2,2090,9549,59,0,4.75,3750,11209
7.99e+05,2014,313,3,1,1510,4178,2,0,0,3,8,1510,0,1902,1979,98103,47.685,122.33,2140,4916,112,1,4,3650,6426
2.45e+05,2014,322,2,1,670,1675,1,0,0,5,6,670,0,1960,1960,98144,47.592,122.3,1220,1740,54,0,3,1890,2410
8.49e+05,2014,209,3,3,2960,42159,2,0,0,3,10,2960,0,1995,1995,98052,47.718,122.1,2640,25209,19,0,6,5600,28169
8.35e+05,2014,128,4,2,1910,6960,1,0,0,5,8,1910,0,1941,1941,98103,47.689,122.35,1360,3300,73,0,6,3270,5210
5.66e+05,2015,416,3,2.5,1560,5259,2,0,0,3,8,1560,0,1999,1999,98075,47.599,122.02,2170,5461,16,0,5.5,3730,7021
3.55e+05,2015,450,4,2.5,1780,15000,2,0,0,2,7,1780,0,1993,1993,98058,47.424,122.15,2005,9680,22,0,6.5,3785,11460
7.4e+05,2014,134,4,2.5,3430,10157,2,0,0,3,10,3430,0,2000,2000,98034,47.723,122.16,3480,10157,14,0,6.5,6910,13587
3.795e+05,2014,324,2,1,960,5096,1,0,0,5,7,960,0,1949,1949,98126,47.531,122.38,1760,4488,65,0,3,2720,5448
4.6237e+05,2014,352,2,2.25,1860,2670,2,0,0,4,8,1860,0,1986,1986,98006,47.544,122.19,1860,2531,28,0,4.25,3720,4391
3.975e+05,2014,180,4,2.5,2570,7859,2,0,0,3,8,2570,0,1992,1992,98038,47.374,122.05,2150,7284,22,0,6.5,4720,9854
1.218e+06,2015,436,4,3,3470,4750,2,0,2,3,9,2370,1100,2014,2014,98116,47.592,122.39,2420,4761,1,0,7,5890,8231
5.03e+05,2014,142,2,1.75,2860,59612,1,1,4,3,8,1510,1350,1948,2003,98023,47.328,122.39,2720,59612,66,1,3.75,5580,62472
5.17e+05,2014,351,2,1,1140,3750,1,0,0,4,7,1140,0,1925,1925,98103,47.662,122.34,1660,4000,89,0,3,2800,5140
5e+05,2014,245,3,2.25,2010,7447,2,0,0,3,8,2010,0,1985,1985,98028,47.747,122.25,2230,7846,29,0,5.25,4240,9856
3.59e+05,2015,486,4,2.5,2640,7883,2,0,0,3,8,2640,0,1990,1990,98092,47.312,122.19,2150,7683,25,0,6.5,4790,10323
5.9775e+05,2014,205,4,2.5,2310,9624,2,0,0,3,8,2310,0,1984,1984,98027,47.539,122.05,1940,9636,30,0,6.5,4250,11946
3.965e+05,2014,312,3,1,1710,5110,1,0,0,3,7,1100,610,1954,1954,98126,47.526,122.38,1310,5110,60,0,4,3020,6820
4.68e+05,2014,188,3,1.5,1830,9848,1,0,0,5,7,1830,0,1962,1962,98056,47.539,122.18,1830,8168,52,0,4.5,3660,9998
3.0978e+05,2014,182,3,2.5,2242,4500,2,0,0,3,8,2242,0,2014,2014,98092,47.258,122.2,2009,4500,0,0,5.5,4251,6742
2.82e+05,2015,388,3,1,1670,5200,1,0,0,5,7,1030,640,1977,1977,98042,47.366,122.09,1620,6696,38,0,4,3290,8366
4.4e+05,2014,238,3,1.75,1570,8400,1,0,0,4,7,1570,0,1959,1959,98133,47.76,122.34,1860,8639,55,0,4.75,3430,10209
1.218e+05,2014,214,2,1,940,8384,1,0,0,3,5,940,0,1947,1947,98146,47.507,122.36,1290,8384,67,0,3,2230,9324
5.21e+05,2014,276,3,3.25,1460,1254,3,0,0,3,8,1460,0,2000,2000,98103,47.654,122.35,1400,1255,14,0,6.25,2860,2715
3.365e+05,2015,445,4,1.75,1760,7268,1,0,0,4,7,1080,680,1979,1979,98058,47.427,122.15,1830,8786,36,0,5.75,3590,10546
3.38e+05,2015,403,2,1,1470,5566,1,0,0,4,7,770,700,1919,1919,98118,47.535,122.27,1410,5808,96,0,3,2880,7278
7.759e+05,2015,472,3,2.5,2700,5764,2,0,0,3,9,2700,0,2014,2014,98075,47.562,122.03,3270,14700,1,0,5.5,5970,17400
3.58e+05,2014,314,5,2.5,2460,5604,2,0,0,3,8,2460,0,2011,2011,98038,47.366,122.04,2210,6395,3,0,7.5,4670,8855
6.38e+05,2015,409,3,3.25,1720,1587,2,0,2,3,9,1410,310,2004,2004,98122,47.619,122.3,1490,1620,11,0,6.25,3210,3340
7.6e+05,2015,409,4,3.5,3090,4060,2,0,0,3,8,2420,670,1992,1992,98144,47.573,122.29,1720,4080,23,0,7.5,4810,7170
1.14e+06,2014,183,3,2.5,2780,33503,1,0,1,4,8,2110,670,1969,1969,98075,47.584,122.08,3150,15542,45,0,5.5,5930,18322
7.75e+05,2014,169,4,2.75,3010,15992,2,0,0,3,11,3010,0,1996,1996,98075,47.59,121.99,3330,12333,18,0,6.75,6340,15343
8.8e+05,2014,320,5,3.5,4600,8764,2,0,0,3,10,3180,1420,2007,2007,98006,47.549,122.19,3210,9431,7,0,8.5,7810,14031
3.05e+05,2015,456,4,2.5,1900,7000,1,0,0,2,7,1420,480,1968,1968,98023,47.309,122.38,1600,7600,47,0,6.5,3500,9500
4.4995e+05,2014,312,3,2,1880,3048,2,0,0,4,7,1880,0,1902,1902,98122,47.603,122.3,1680,3600,112,0,5,3560,5480
5.3e+05,2014,290,3,2.25,1880,1.0062e+05,1,0,0,3,8,1880,0,1987,2007,98024,47.534,121.88,2520,21689,27,1,5.25,4400,23569
4.49e+05,2014,313,2,1.75,1510,6852,1,0,0,3,8,1510,0,2005,2005,98053,47.707,122.01,1510,5912,9,0,3.75,3020,7422
4.6e+05,2015,439,3,1.75,1970,9135,1,0,0,4,7,1370,600,1961,1961,98011,47.76,122.22,1880,9650,54,0,4.75,3850,11620
4.35e+05,2015,477,4,2,1650,4745,1,0,0,3,7,1130,520,1972,1972,98034,47.736,122.18,1650,5184,43,0,6,3300,6834
4.82e+05,2014,333,2,1,950,3960,1,0,0,3,7,950,0,1941,1941,98103,47.688,122.34,1320,4050,73,0,3,2270,5000
3.85e+05,2015,409,3,1.75,1560,5950,1,0,0,4,6,780,780,1944,1944,98125,47.719,122.31,1320,7830,71,0,4.75,2880,9390
1.85e+05,2014,314,3,1.5,1090,9605,1,0,0,4,6,1090,0,1969,1969,98038,47.361,122.03,1160,10487,45,0,4.5,2250,11577
3.1395e+05,2014,126,3,1,1510,6083,1,0,0,4,6,860,650,1940,1940,98115,47.697,122.32,1510,5712,74,0,4,3020,7222
8.99e+05,2015,491,4,3.5,2490,5500,2,0,0,3,9,1780,710,2015,2015,98136,47.55,122.39,1710,5500,0,0,7.5,4200,7990
2.5025e+05,2014,159,3,2.25,2210,8000,2,0,0,4,8,2210,0,1969,1969,98023,47.309,122.38,1990,8000,45,0,5.25,4200,10210
4.85e+05,2014,224,2,1,1130,3800,1,0,0,4,7,1130,0,1916,1916,98117,47.686,122.38,1470,3800,98,0,3,2600,4930
9.39e+05,2015,471,4,2.25,2240,9684,2,0,0,4,9,2240,0,1970,1970,98040,47.549,122.22,2440,9618,45,0,6.25,4680,11858
4.15e+05,2014,305,3,1.75,2380,5650,1,0,2,4,8,1190,1190,1956,1956,98118,47.512,122.25,2350,6554,58,0,4.75,4730,8934
6.5e+05,2014,173,4,2.5,2400,7351,2,0,0,3,9,2400,0,1990,1990,98029,47.571,122.02,2330,7756,24,0,6.5,4730,10156
1.15e+06,2014,255,4,2.25,3740,18000,1,0,0,4,9,1870,1870,1951,1951,98177,47.703,122.38,2610,10902,63,0,6.25,6350,14642
3.05e+05,2014,229,3,2.25,1646,9519,2,0,0,3,7,1646,0,1994,1994,98038,47.365,122.04,1975,8889,20,0,5.25,3621,10535
6.375e+05,2014,352,4,3,2320,4468,2,0,0,3,8,2160,160,1999,1999,98029,47.546,122.01,2330,3541,15,0,7,4650,5861
4.0745e+05,2014,208,3,2,1810,10860,1,0,0,3,7,1810,0,1967,1967,98053,47.639,121.97,1420,11982,47,0,5,3230,13792
7.7e+05,2014,265,4,3.5,3680,2242,2,0,0,3,9,2670,1010,1930,2007,98112,47.619,122.31,1350,1288,84,1,7.5,5030,4968
2.92e+05,2014,345,3,1.75,2270,7156,1,0,0,3,7,1370,900,1948,1948,98168,47.486,122.32,1210,7156,66,0,4.75,3480,9426
3.79e+05,2014,211,4,2.5,2260,5824,2,0,0,3,8,2260,0,2011,2011,98038,47.35,122.04,2240,5561,3,0,6.5,4500,7821
6.54e+05,2014,238,5,2.5,2960,8968,1,0,0,4,8,1640,1320,1965,1965,98008,47.623,122.1,1890,9077,49,0,7.5,4850,12037
5.5e+05,2015,403,3,1,1010,6120,1,0,0,3,7,860,150,1940,1940,98115,47.686,122.3,1930,6120,75,0,4,2940,7130
3.525e+05,2014,228,3,1,1470,8400,1,0,0,4,7,1470,0,1953,1953,98133,47.763,122.35,1470,8400,61,0,4,2940,9870
5.0498e+05,2014,209,2,2.5,1900,4871,2,0,0,3,8,1900,0,2005,2005,98053,47.713,122.03,1640,4780,9,0,4.5,3540,6680
6.2e+05,2015,430,5,2.5,3070,34991,2,0,0,3,9,3070,0,1995,1995,98059,47.472,122.15,2150,19515,20,0,7.5,5220,22585
1.15e+06,2014,183,5,2.5,3580,8921,2,0,0,3,9,3580,0,2000,2000,98033,47.693,122.2,2710,9308,14,0,7.5,6290,12888
4.1995e+05,2015,365,4,1.75,1870,16549,1,0,0,3,8,1870,0,1969,1969,98072,47.748,122.08,1870,10804,46,0,5.75,3740,12674
9.5e+05,2014,170,4,2.5,3360,11548,2,0,0,3,9,3360,0,1988,1988,98033,47.653,122.18,3400,14091,26,0,6.5,6760,17451
4.415e+05,2014,243,3,2.5,2360,4670,2,0,0,3,7,2360,0,1998,1998,98065,47.537,121.87,2420,5620,16,0,5.5,4780,7980
5.835e+05,2015,414,3,2.25,3530,13000,2,0,0,4,10,3530,0,1985,1985,98042,47.382,122.16,2960,13000,30,0,5.25,6490,16530
3.03e+05,2014,346,2,1.5,1400,1650,3,0,0,3,7,1400,0,1999,1999,98125,47.722,122.29,1430,1650,15,0,3.5,2830,3050
2.79e+05,2015,416,3,1.75,1750,9623,1,0,0,3,7,1150,600,1962,1962,98198,47.4,122.31,1820,9623,53,0,4.75,3570,11373
2.8835e+05,2015,458,3,1,1250,18616,1,0,0,4,6,1250,0,1972,1972,98010,47.341,122.05,1920,15654,43,0,4,3170,16904
1.185e+06,2014,141,3,2.25,2760,40946,2,0,0,5,10,2760,0,1978,1978,98005,47.65,122.16,3030,42253,36,0,5.25,5790,45013
2.35e+05,2014,237,2,1,880,5600,1,0,0,5,7,880,0,1955,1955,98178,47.507,122.27,1240,7015,59,0,3,2120,7895
3.5e+05,2014,324,3,1.5,1870,9000,1,0,0,3,7,1120,750,1923,1923,98108,47.522,122.32,1850,6000,91,0,4.5,3720,7870
2.07e+05,2014,128,3,1,1490,8995,1,0,0,4,7,1490,0,1954,1954,98168,47.49,122.3,1490,9000,60,0,4,2980,10490
3.2995e+05,2014,311,3,2.5,1300,812,2,0,0,3,8,880,420,2008,2008,98144,47.589,122.32,1300,824,6,0,5.5,2600,2124
5.94e+05,2014,175,3,2.25,1270,1406,2,0,0,3,8,1060,210,2014,2014,98105,47.665,122.28,1160,1327,0,0,5.25,2430,2597
5.22e+05,2014,266,4,2.5,2835,6598,2,0,0,3,8,2835,0,2002,2002,98038,47.388,122.03,2770,6969,12,0,6.5,5605,9804
7.18e+05,2014,153,3,1,1030,4958,1,0,0,5,7,1030,0,1952,1952,98105,47.665,122.28,2230,6987,62,0,4,3260,8017
1.925e+06,2014,180,5,4.25,4830,8050,2,0,2,4,11,3710,1120,1914,1914,98144,47.579,122.29,4470,9194,100,0,9.25,9300,14024
6.25e+05,2014,352,4,2.25,2660,22194,1,0,0,4,8,2180,480,1977,1977,98008,47.614,122.11,2660,18135,37,0,6.25,5320,20795
7.1e+05,2015,409,6,3.5,3830,68825,2,0,0,3,9,3830,0,1995,1995,98027,47.457,122,2410,68825,20,0,9.5,6240,72655
2.51e+05,2014,250,2,1,840,7870,1,0,0,3,6,840,0,1949,1949,98155,47.739,122.33,1442,8131,65,0,3,2282,8971
5.07e+05,2014,238,3,2.25,2210,11585,1,0,0,4,7,1510,700,1958,1958,98155,47.757,122.28,1870,14092,56,0,5.25,4080,16302
4.8995e+05,2014,280,3,1.75,2480,10804,1,0,0,3,8,1800,680,1976,1976,98177,47.772,122.37,2480,10400,38,0,4.75,4960,12880
3.235e+05,2014,257,3,3,2240,11536,2,0,0,3,7,2240,0,1943,2005,98178,47.489,122.25,1650,8760,71,1,6,3890,11000
3.15e+05,2014,348,3,2.5,1950,3000,2,0,0,3,7,1950,0,2001,2001,98146,47.494,122.34,1620,6000,13,0,5.5,3570,7950
8.2895e+05,2014,135,4,3.5,3930,5680,2,0,1,3,9,2820,1110,2013,2013,98027,47.553,122.08,3700,5816,1,0,7.5,7630,9746
3.015e+05,2014,132,2,1.5,830,1333,2,0,0,3,7,830,0,2005,2005,98136,47.551,122.38,1120,4822,9,0,3.5,1950,5652
1.95e+06,2014,170,7,3.5,4640,15235,2,0,1,3,11,2860,1780,1965,2003,98040,47.567,122.23,3230,20697,49,1,10.5,7870,25337
5e+05,2014,169,3,2.5,2840,48716,1,0,3,3,9,1870,970,1994,1994,98014,47.683,121.92,2710,43676,20,0,5.5,5550,46516
5.99e+05,2014,194,5,2.5,2950,72309,2,0,0,3,8,2950,0,2006,2006,98058,47.419,122.08,1480,56192,8,0,7.5,4430,59142
1.5e+05,2014,175,2,1,890,8100,1,0,0,3,6,890,0,1942,1942,98146,47.484,122.34,1260,8100,72,0,3,2150,8990
1.07e+06,2014,153,4,3.75,4130,12320,2,0,0,3,11,4130,0,2001,2001,98059,47.519,122.15,3690,11227,13,0,7.75,7820,15357
3.4e+05,2014,257,3,1.75,1270,8422,1,0,0,3,7,1270,0,1967,1967,98011,47.76,122.2,1470,8500,47,0,4.75,2740,9770
6.9995e+05,2014,221,4,2,2070,7830,1,0,1,5,7,1180,890,1941,1941,98125,47.706,122.28,2390,7830,73,0,6,4460,9900
3.15e+05,2015,481,2,1,770,6731,1,0,0,4,6,770,0,1943,1943,98155,47.751,122.31,1120,9212,72,0,3,1890,9982
1.049e+06,2015,479,3,2.25,2610,3357,2,0,0,4,7,1980,630,1926,1926,98112,47.638,122.31,1940,3357,89,0,5.25,4550,5967
3.18e+05,2014,280,3,1,1250,20040,1,0,0,3,7,1250,0,1970,1970,98072,47.751,122.11,1640,19840,44,0,4,2890,21090
4.9e+05,2014,238,4,2.5,2430,42646,1,0,0,3,7,1450,980,1989,1989,98014,47.616,121.95,2000,38159,25,0,6.5,4430,40589
4.15e+05,2015,463,3,1.75,1480,2200,2,0,0,3,7,1480,0,1995,1995,98103,47.697,122.35,1360,2190,20,0,4.75,2840,3670
2.685e+05,2014,349,2,1.5,1290,1749,1,0,0,3,8,660,630,1969,1969,98008,47.612,122.12,1860,1749,45,0,3.5,3150,3039
5.94e+05,2014,175,4,2.75,2720,4613,2,0,0,3,9,2720,0,2005,2005,98028,47.735,122.22,2830,4836,9,0,6.75,5550,7556
8.3999e+05,2014,232,4,2.75,3660,5637,2,0,0,3,9,3660,0,2014,2014,98053,47.684,122.02,3625,5639,0,0,6.75,7285,9299
7.3e+05,2014,198,4,2.5,2740,11975,2,0,0,4,8,2740,0,1991,1991,98074,47.632,122.03,2310,9068,23,0,6.5,5050,11808
4.69e+05,2014,190,5,2.5,2690,11745,1,0,0,3,8,1790,900,1960,1960,98177,47.771,122.36,2670,7905,54,0,7.5,5360,10595
2.57e+05,2014,238,3,2.25,1730,9516,1,0,0,3,8,1180,550,1978,1978,98030,47.382,122.17,1870,8165,36,0,5.25,3600,9895
3.2e+05,2014,305,2,1,1120,5329,1,0,1,3,6,750,370,1929,1929,98126,47.542,122.38,1530,5330,85,0,3,2650,6450
3.28e+05,2015,492,3,2.5,2242,4800,2,0,0,3,8,2242,0,2013,2013,98092,47.258,122.2,2009,4800,2,0,5.5,4251,7042
5.3e+05,2015,475,2,1,760,3000,1,0,0,3,6,760,0,1922,1922,98107,47.663,122.36,1630,3600,93,0,3,2390,4360
4.61e+05,2014,230,3,1.75,1420,5170,1,0,0,4,7,1420,0,1963,1963,98007,47.615,122.14,2250,7700,51,0,4.75,3670,9120
3.89e+05,2015,444,3,1.75,2180,9220,1,0,0,4,7,1090,1090,1938,1938,98001,47.355,122.28,2050,22400,77,0,4.75,4230,24580
3.999e+05,2015,431,3,1.75,1260,12750,1,0,0,3,7,1260,0,1979,1979,98034,47.729,122.23,1460,7865,36,0,4.75,2720,9125
4.2e+05,2014,236,3,2.25,2020,21010,2,0,0,3,7,2020,0,1995,1995,98014,47.699,121.92,1850,18151,19,0,5.25,3870,20171
6.75e+05,2015,463,3,1.5,1710,4000,2,0,0,3,8,1710,0,1926,1926,98116,47.571,122.39,1910,4000,89,0,4.5,3620,5710
7.49e+05,2014,189,4,2.75,2700,6000,2,0,0,4,8,2100,600,1910,1910,98116,47.586,122.38,2050,5400,104,0,6.75,4750,8100
1.037e+06,2015,460,5,3.75,4570,10194,2,0,0,3,11,4570,0,2006,2006,98034,47.718,122.16,2040,7560,9,0,8.75,6610,12130
8e+05,2014,256,5,2.5,3320,9024,2,0,0,3,9,3320,0,1999,1999,98075,47.587,122.06,3320,7665,15,0,7.5,6640,10985
2.1825e+05,2014,324,3,1.5,1080,9774,1,0,0,3,7,1080,0,1968,1968,98023,47.316,122.4,1190,9611,46,0,4.5,2270,10691
8.33e+05,2014,228,4,3.5,3560,7178,2,0,3,3,10,2590,970,2006,2006,98052,47.705,122.11,3290,6978,8,0,7.5,6850,10538
3.2995e+05,2015,415,4,2.5,2300,9690,2,0,0,3,8,2300,0,2006,2006,98023,47.279,122.35,1200,9085,9,0,6.5,3500,11385
9.5e+05,2014,223,3,2.5,2700,6947,2,0,3,3,9,2700,0,2013,2013,98056,47.517,122.21,2500,6947,1,0,5.5,5200,9647
6.6e+05,2014,175,3,2.75,2210,4000,2,0,0,3,8,2210,0,2008,2008,98053,47.695,122.02,2230,4674,6,0,5.75,4440,6884
3.45e+05,2014,126,3,1,1110,6250,1,0,0,3,7,1110,0,1956,1956,98115,47.698,122.29,2010,6944,58,0,4,3120,8054
4.6995e+05,2014,188,4,2.75,2530,14178,2,0,0,3,8,2530,0,1997,1997,98019,47.737,121.95,2530,14055,17,0,6.75,5060,16585
2.05e+05,2014,199,3,1,860,7467,1,0,0,3,6,860,0,1944,1944,98178,47.495,122.24,1280,7467,70,0,4,2140,8327
6.58e+05,2015,375,3,1.5,1660,3190,1,0,0,3,7,1660,0,1919,1919,98109,47.637,122.35,2200,3240,96,0,4.5,3860,4900
2.15e+05,2015,478,3,1,960,7200,1,0,0,4,6,960,0,1958,1958,98166,47.458,122.35,1060,7620,57,0,4,2020,8580
1.95e+05,2015,476,3,1,1280,6967,1,0,0,3,7,1280,0,1949,1949,98155,47.751,122.33,1280,7245,66,0,4,2560,8525
3.52e+05,2015,458,3,1.75,1260,7200,1,0,0,3,7,1260,0,1971,1971,98034,47.719,122.18,1460,7200,44,0,4.75,2720,8460
1.25e+06,2014,202,4,3.75,4520,9240,1,0,2,3,10,3270,1250,1992,1992,98040,47.59,122.23,3380,9240,22,0,7.75,7900,13760
4.55e+05,2014,238,4,2.75,3030,1.1738e+05,1,0,0,4,8,1680,1350,1959,1959,98042,47.401,122.14,2060,1.1096e+05,55,0,6.75,5090,1.1399e+05
4.5e+05,2014,187,3,2.5,1990,12793,2,0,0,3,8,1990,0,1993,1993,98028,47.735,122.23,2290,9035,21,0,5.5,4280,11025
3.97e+05,2014,194,2,1.75,1610,4104,1,0,0,3,7,950,660,1996,1996,98118,47.556,122.28,1510,5284,18,0,3.75,3120,6894
2.88e+05,2015,437,3,1.5,1300,7313,1,0,0,4,7,1300,0,1968,1968,98055,47.457,122.21,1770,8075,47,0,4.5,3070,9375
5.8e+05,2014,228,5,2.5,3110,15783,1,0,0,3,8,1720,1390,1974,1974,98052,47.63,122.1,2550,12220,40,0,7.5,5660,15330
4.68e+05,2014,312,3,2,1570,6300,1,0,0,3,7,820,750,1953,2005,98118,47.556,122.28,1510,4281,61,1,5,3080,5851
5.4e+05,2015,484,3,2.5,1670,5146,2,0,0,3,8,1670,0,1991,1991,98029,47.571,122,1940,5146,24,0,5.5,3610,6816
3.15e+05,2014,152,3,1,960,6634,1,0,0,3,6,960,0,1952,1952,98125,47.726,122.31,1570,7203,62,0,4,2530,8163
1.02e+06,2014,181,4,3.5,3770,8501,2,0,0,3,10,3770,0,2008,2008,98033,47.674,122.2,1520,9660,6,0,7.5,5290,13430
4e+05,2015,473,2,1,1010,3916,1,0,2,4,6,810,200,1918,1918,98144,47.573,122.31,1580,3888,97,0,3,2590,4898
4.7175e+05,2014,283,5,3.5,3790,8200,1,0,1,3,8,2120,1670,2001,2001,98056,47.489,122.19,1740,8676,13,0,8.5,5530,12466
7.2e+05,2014,211,2,1.5,1840,9000,1,0,2,3,8,1340,500,1957,1957,98136,47.528,122.39,1880,7560,57,0,3.5,3720,9400
3.5e+05,2015,445,3,1,1190,3600,1,0,0,3,6,1190,0,1904,1904,98144,47.599,122.3,1680,3600,111,0,4,2870,4790
3.97e+05,2015,437,4,2.5,2201,9542,2,0,0,3,8,2201,0,2006,2006,98198,47.4,122.32,1990,9542,9,0,6.5,4191,11743
3.065e+05,2014,297,2,1,1390,19988,1,0,2,4,7,1390,0,1949,1949,98198,47.398,122.32,2580,10490,65,0,3,3970,11880
4.2995e+05,2014,307,4,2.5,2320,4524,2,0,0,3,8,2320,0,2004,2004,98059,47.48,122.14,2330,4524,10,0,6.5,4650,6844
9.988e+05,2014,229,3,2,2250,8000,1,0,2,4,9,2250,0,1955,1955,98177,47.708,122.38,2880,10960,59,0,5,5130,13210
7.33e+05,2014,232,4,1.75,1930,3876,1,0,0,5,7,1450,480,1924,1924,98105,47.66,122.32,1280,3825,90,0,5.75,3210,5755
2.63e+06,2014,338,6,4.75,5540,7200,2,0,2,4,11,3950,1590,1909,1909,98119,47.636,122.37,2930,7200,105,0,10.75,8470,12740
1.5825e+06,2015,478,4,2.5,3980,16304,1,0,1,3,10,2480,1500,1968,1968,98004,47.639,122.21,3980,16304,47,0,6.5,7960,20284
1.45e+05,2014,284,3,1,1010,11880,1,0,0,3,7,1010,0,1960,1960,98030,47.376,122.22,1150,9435,54,0,4,2160,10445
2.485e+06,2014,311,4,2.5,3440,23954,1,1,3,5,10,2260,1180,1931,1931,98040,47.564,122.23,4230,18723,83,0,6.5,7670,22163
3.45e+05,2015,395,3,1.5,1360,13496,1,0,0,4,8,1360,0,1960,1960,98198,47.403,122.31,1900,10538,55,0,4.5,3260,11898
2.92e+05,2014,154,3,1.75,1730,11325,1,0,0,5,7,1730,0,1972,1972,98031,47.392,122.18,2030,17859,42,0,4.75,3760,19589
5.72e+05,2015,480,2,2,1870,5143,1,0,0,3,8,1870,0,2005,2005,98053,47.714,122.03,1810,5143,10,0,4,3680,7013
1.575e+06,2014,245,5,3.75,4220,9240,2,0,2,5,11,3420,800,1991,1991,98040,47.59,122.23,3380,9240,23,0,8.75,7600,13460
2.4e+05,2014,324,3,2,1190,10299,1,0,0,3,7,1190,0,1994,1994,98010,47.314,122,1700,9849,20,0,5,2890,11039
5.5e+05,2014,159,3,1.75,1380,3402,1,0,0,3,7,1380,0,1900,2000,98122,47.611,122.3,1500,5496,114,1,4.75,2880,6876
6.25e+05,2014,283,4,2,1760,5307,1,0,0,4,7,1170,590,1948,1948,98105,47.671,122.28,1850,6600,66,0,6,3610,8360
5.5e+05,2015,410,3,1,1110,6000,1,0,0,3,7,1110,0,1904,1904,98109,47.646,122.36,1460,6000,111,0,4,2570,7110
3.75e+05,2014,210,3,1,1960,7955,1,0,0,4,7,1260,700,1963,1963,98177,47.764,122.36,1850,8219,51,0,4,3810,10179
3.7769e+05,2014,143,5,1.75,2120,8399,1,0,0,4,7,1320,800,1942,1942,98133,47.762,122.33,2120,8398,72,0,6.75,4240,10518
1.315e+06,2015,403,5,4,4420,36342,2,0,0,5,10,2740,1680,1982,1982,98007,47.647,122.15,3720,37034,33,0,9,8140,41454
5.95e+05,2014,211,3,2.5,2660,10637,2,0,0,3,9,2660,0,1991,1991,98011,47.738,122.22,2590,8637,23,0,5.5,5250,11297
1.15e+05,2014,335,2,1,1000,16524,1,0,0,3,5,1000,0,1913,1913,98001,47.284,122.25,1350,10208,101,0,3,2350,11208
2.531e+05,2014,204,3,2,1239,6036,1,0,0,3,7,1239,0,2009,2009,98030,47.369,122.17,2060,5746,5,0,5,3299,6985
1.96e+05,2015,426,3,1.5,1000,18568,1,0,0,3,6,1000,0,1989,1989,98001,47.298,122.27,1610,17420,26,0,4.5,2610,18420
2.2995e+05,2014,320,2,1.5,1160,1848,2,0,0,3,7,1160,0,1972,1972,98034,47.737,122.18,1160,1566,42,0,3.5,2320,2726
4.695e+05,2015,478,3,2.25,1850,12000,1,0,0,4,7,1300,550,1977,1977,98072,47.741,122.1,1580,12616,38,0,5.25,3430,14466
6.875e+05,2014,177,4,2.75,3190,10970,2,0,0,3,10,3190,0,1994,1994,98075,47.586,122.03,2850,8416,20,0,6.75,6040,11606
4.2e+05,2014,360,4,2.5,2110,9825,2,0,0,3,8,2110,0,2000,2000,98059,47.498,122.15,1650,9900,14,0,6.5,3760,12010
1.2e+06,2014,217,5,3.25,4610,10576,2,0,3,3,11,3310,1300,2006,2006,98027,47.537,122.07,4042,8321,8,0,8.25,8652,12931
6.925e+05,2015,444,6,1.75,2230,10080,1,0,0,3,7,1390,840,1969,1969,98034,47.709,122.2,2110,8475,46,0,7.75,4340,10705
5.99e+05,2014,237,4,2.5,2120,3640,2,0,0,3,8,2120,0,2005,2005,98029,47.552,122,2190,3640,9,0,6.5,4310,5760
3.037e+05,2015,416,4,2,2520,7334,1,0,0,3,7,1600,920,1955,1955,98125,47.726,122.29,2040,7937,60,0,6,4560,10457
4.55e+05,2014,284,4,1,1340,5800,1,0,2,3,7,1340,0,1914,1914,98116,47.566,122.39,1900,5800,100,0,5,3240,7140
2.84e+05,2014,126,4,2.5,2000,5390,2,0,0,3,7,2000,0,2003,2003,98042,47.373,122.13,2330,5390,11,0,6.5,4330,7390
5.529e+05,2015,440,4,3.5,3828,18900,2,0,0,3,9,3828,0,2014,2014,98001,47.285,122.28,2120,18900,1,0,7.5,5948,22728
3.9e+05,2015,463,3,1,1190,85226,1,0,0,5,5,1190,0,1935,1935,98070,47.365,122.46,1360,46960,80,0,4,2550,48150
1.045e+06,2014,297,4,2.25,2630,4000,2,0,0,5,9,1810,820,1909,1909,98102,47.639,122.32,2370,4700,105,0,6.25,5000,7330
3.22e+05,2015,387,3,1,960,10181,1,0,0,3,7,960,0,1961,1961,98034,47.723,122.23,1740,10194,54,0,4,2700,11154
4.41e+05,2015,479,3,1.5,1540,7200,1,0,0,3,7,1540,0,1968,1968,98011,47.736,122.19,1560,7500,47,0,4.5,3100,9040
6.02e+05,2014,229,3,2.25,1580,11580,1,0,0,4,8,1580,0,1979,1979,98006,47.55,122.16,2630,10009,35,0,5.25,4210,11589
3.3e+05,2015,480,2,1,1220,10000,1,0,0,5,7,1220,0,1950,1950,98028,47.74,122.24,2000,9600,65,0,3,3220,10820
3.749e+05,2015,439,5,2.75,2980,8500,1,0,0,3,8,1540,1440,1982,1982,98032,47.364,122.28,2310,8500,33,0,7.75,5290,11480
8.7e+05,2014,229,4,2.5,3190,14565,2,0,0,3,11,3190,0,1990,1990,98077,47.713,122.07,3420,20475,24,0,6.5,6610,23665
3.35e+05,2014,128,3,1.5,2240,87625,1,0,0,2,7,1480,760,1980,1980,98092,47.304,122.09,1920,1.1021e+05,34,0,4.5,4160,1.1245e+05
4.125e+05,2015,425,3,1.75,1660,10716,1,0,0,3,7,1100,560,1988,1988,98034,47.733,122.23,1630,7626,27,0,4.75,3290,9286
6.5e+05,2014,299,3,1.75,1660,10819,1,0,0,4,7,1240,420,1942,1942,98177,47.705,122.38,3110,11853,72,0,4.75,4770,13513
6.15e+05,2015,464,4,1,1340,2006,1,0,0,3,7,1340,0,1931,1931,98119,47.636,122.37,2040,3625,84,0,5,3380,4965
3.67e+05,2015,426,4,2.5,2960,6219,2,0,0,3,9,2960,0,2006,2006,98038,47.36,122.04,2960,5361,9,0,6.5,5920,8321
3.37e+05,2014,170,4,3,2240,8504,2,0,0,3,7,2240,0,1992,1992,98155,47.735,122.3,1570,8460,22,0,7,3810,10700
7.1e+05,2014,283,5,2.5,2570,9600,1,0,2,3,8,1620,950,1956,1956,98125,47.722,122.28,2680,9900,58,0,7.5,5250,12470
2.72e+05,2015,465,4,2,1780,19843,1,0,0,3,7,1780,0,1963,1963,98058,47.441,122.15,2210,13500,52,0,6,3990,15280
1.55e+05,2014,256,2,1,810,4755,1,0,0,3,7,810,0,1980,1980,98118,47.531,122.28,1180,4755,34,0,3,1990,5565
2.85e+05,2015,436,3,1.75,1930,6533,1,0,0,3,7,1230,700,1960,1960,98055,47.488,122.22,2030,5954,55,0,4.75,3960,7884
1.085e+06,2014,161,5,2.5,2340,6000,2,0,0,4,10,2340,0,1922,1922,98144,47.576,122.29,2350,6000,92,0,7.5,4690,8340
3.45e+05,2014,286,2,1,1160,8504,1,0,0,4,7,1160,0,1949,1949,98155,47.736,122.3,1320,8504,65,0,3,2480,9664
3.7e+05,2014,301,4,2.75,2420,39704,1,0,0,3,9,2420,0,1985,1985,98038,47.405,122.03,2760,36303,29,0,6.75,5180,38723
4.4e+05,2014,176,4,2.5,2250,7526,2,0,0,3,8,2250,0,1989,1989,98059,47.512,122.15,1980,7526,25,0,6.5,4230,9776
5.1e+05,2015,484,3,1.75,1490,3800,1,0,0,3,6,700,790,1913,1913,98118,47.555,122.27,2180,4000,102,0,4.75,3670,5490
3.605e+05,2014,228,3,2.5,3300,11525,1,0,0,5,8,1650,1650,1961,1961,98198,47.411,122.31,1950,9680,53,0,5.5,5250,12980
4.65e+05,2014,297,2,1,730,2600,1,0,0,4,6,730,0,1918,1918,98107,47.675,122.38,1480,3900,96,0,3,2210,4630
3.3e+05,2015,491,3,1.5,1440,7875,1,0,0,4,8,1440,0,1968,1968,98058,47.456,122.15,1800,8964,47,0,4.5,3240,10404
6.39e+05,2014,202,4,2.5,2210,9875,2,0,0,3,9,2210,0,1990,1990,98074,47.629,122.03,2440,8799,24,0,6.5,4650,11009
4.1e+05,2014,168,4,2,1970,10500,1,0,0,3,8,1820,150,1961,1961,98166,47.479,122.36,2090,12300,53,0,6,4060,14270
3.6675e+05,2014,125,3,3,1571,2017,3,0,0,3,8,1571,0,2008,2008,98125,47.734,122.31,1520,1497,6,0,6,3091,3068
8.25e+05,2014,285,4,2.25,2430,10050,2,0,0,4,8,2430,0,1979,1979,98006,47.556,122.16,2390,10250,35,0,6.25,4820,12680
2.315e+05,2014,312,2,1,1200,9488,1,0,0,5,7,1200,0,1941,1941,98168,47.483,122.3,1200,9488,73,0,3,2400,10688
5.7e+05,2014,252,4,2.5,2650,6875,2,0,0,3,8,2650,0,2014,2014,98059,47.479,122.12,2650,5831,0,0,6.5,5300,8481
4.85e+05,2014,154,3,2.5,2340,59058,1,0,0,3,8,2340,0,1985,1985,98038,47.405,122.03,2700,37263,29,0,5.5,5040,39603
2.1e+05,2014,188,3,1,1070,8179,1,0,0,3,6,1070,0,1949,1949,98146,47.502,122.35,1050,8177,65,0,4,2120,9247
7.9e+05,2014,122,3,2.5,2600,4750,1,0,0,4,9,1700,900,1951,1951,98117,47.683,122.4,2380,4750,63,0,5.5,4980,7350
5.1e+05,2015,488,4,2.5,4073,17334,2,0,0,3,8,4073,0,2008,2008,98001,47.295,122.27,1780,9625,7,0,6.5,5853,13698
5.335e+05,2014,340,3,3.5,2490,3517,2,0,0,3,8,1720,770,2005,2005,98027,47.534,122.07,1600,2378,9,0,6.5,4090,4868
5.45e+05,2014,223,3,2.5,1900,3366,2,0,0,3,9,1900,0,1996,1996,98033,47.668,122.18,2500,3954,18,0,5.5,4400,5854
6.95e+05,2014,181,3,2.5,2620,51354,2,0,0,3,9,2620,0,1998,1998,98077,47.721,122.03,2620,37042,16,0,5.5,5240,39662
3.82e+05,2014,231,4,3.5,2530,3000,2,0,0,3,8,1850,680,2014,2014,98146,47.492,122.34,1470,6000,0,0,7.5,4000,8530
2.3e+05,2015,424,2,0.75,900,3527,1,0,0,3,6,900,0,1939,1939,98146,47.508,122.34,1220,4080,76,0,2.75,2120,4980
6.5e+05,2015,460,3,2.5,2190,3600,2,0,0,3,9,2190,0,2003,2003,98029,47.551,121.99,2300,3600,12,0,5.5,4490,5790
3.4e+05,2015,474,4,2.5,2810,6481,2,0,0,3,9,2810,0,1998,1998,98092,47.333,122.17,2660,6958,17,0,6.5,5470,9768
2.05e+05,2014,279,4,1.75,1850,65340,1,0,0,4,7,1850,0,1972,1972,98042,47.347,122.11,1750,40946,42,0,5.75,3600,42796
3.42e+05,2014,136,3,1,1260,6826,1,0,0,3,6,720,540,1944,1944,98125,47.731,122.3,1300,6826,70,0,4,2560,8086
7.13e+05,2015,423,3,2.75,2310,1850,2,0,0,3,10,2020,290,2011,2011,98027,47.53,122.07,2340,2155,4,0,5.75,4650,4465
6.25e+05,2014,284,4,2,2020,6867,1,0,0,5,8,1010,1010,1942,1942,98115,47.7,122.29,1250,6842,72,0,6,3270,8862
2.75e+05,2014,210,2,1.75,930,7080,1,0,0,3,6,930,0,1923,2006,98106,47.522,122.36,1100,7680,91,1,3.75,2030,8610
7.505e+05,2014,303,4,2.5,2860,9159,1,0,0,4,8,1530,1330,1989,1989,98033,47.692,122.2,2070,8680,25,0,6.5,4930,11540
1.1e+06,2014,331,4,2.5,3830,13800,1,0,4,4,9,2030,1800,1969,1969,98006,47.567,122.16,3460,9875,45,0,6.5,7290,13705
2.57e+05,2014,248,2,1,770,9497,1,0,0,3,6,770,0,1950,1950,98133,47.741,122.35,1550,7532,64,0,3,2320,8302
7.85e+05,2014,128,3,2.75,3010,1842,2,0,0,3,9,3010,0,2011,2011,98075,47.584,121.99,2950,4200,3,0,5.75,5960,7210
2.9e+05,2014,324,2,2,1590,9375,1,0,0,3,7,910,680,1983,1983,98055,47.459,122.2,1560,8524,31,0,4,3150,10114
2.75e+05,2015,471,3,2.5,1710,7230,2,0,0,3,7,1710,0,1996,1996,98003,47.278,122.3,1720,6537,19,0,5.5,3430,8247
2.5e+05,2014,152,4,2,1850,7560,1,0,0,4,7,1540,310,1978,1978,98032,47.367,122.28,1620,7658,36,0,6,3470,9508
1.75e+05,2014,168,2,1,660,5000,1,0,0,3,6,660,0,1915,1915,98106,47.566,122.36,1000,5000,99,0,3,1660,5660
4.8e+05,2014,223,2,1.75,1170,4635,1,0,0,4,6,690,480,1924,1924,98117,47.684,122.36,1240,4120,90,0,3.75,2410,5290
5.275e+05,2014,277,5,2.25,2530,8250,2,0,0,4,7,2530,0,1961,1961,98007,47.612,122.13,2020,8250,53,0,7.25,4550,10780
8.3e+05,2014,214,5,3.25,3360,6120,2,0,0,3,9,3360,0,2014,2014,98074,47.607,122.05,3230,5398,0,0,8.25,6590,8758
7.1e+05,2014,242,3,2,1880,3000,1,0,0,4,8,1040,840,1931,1931,98109,47.642,122.35,1790,3000,83,0,5,3670,4880
4.05e+05,2014,174,3,1,1410,8053,1,0,0,4,7,1410,0,1951,1951,98177,47.704,122.37,1170,8042,63,0,4,2580,9452
4e+05,2014,313,3,1.5,1510,8360,1,0,0,3,7,1120,390,1960,1960,98007,47.612,122.13,1700,8360,54,0,4.5,3210,9870
1.4625e+06,2014,170,5,3.25,3840,4800,3,0,3,3,10,2750,1090,2008,2008,98144,47.593,122.29,2060,4800,6,0,8.25,5900,8640
4.15e+05,2014,214,2,1,1460,4200,1,0,0,4,6,880,580,1914,1914,98117,47.677,122.36,1540,4200,100,0,3,3000,5660
2.54e+05,2014,262,3,2.5,1560,10608,2,0,0,3,7,1560,0,1994,1994,98042,47.357,122.16,1360,10608,20,0,5.5,2920,12168
4.5e+05,2015,431,7,3.5,2830,8625,1,0,0,4,8,1830,1000,1957,1957,98133,47.749,122.36,1570,8400,58,0,10.5,4400,11230
3.02e+05,2015,410,5,1.75,2360,8642,1,0,0,5,7,2060,300,1926,1926,98133,47.762,122.33,1950,8491,89,0,6.75,4310,10851
7.5e+05,2014,242,3,1.75,1590,8285,1,0,0,4,8,1590,0,1956,1956,98004,47.586,122.19,1970,8970,58,0,4.75,3560,10560
4.25e+05,2014,170,3,2.25,1790,10209,1,0,0,3,7,1290,500,1967,1967,98072,47.749,122.09,1840,9900,47,0,5.25,3630,11690
3.35e+05,2014,232,4,2,1910,10200,1,0,0,4,7,1910,0,1963,1963,98059,47.48,122.13,1820,15600,51,0,6,3730,17510
5.65e+05,2014,208,2,1,960,4080,1,0,0,5,7,960,0,1911,1911,98103,47.689,122.35,1300,4080,103,0,3,2260,5040
3.385e+05,2015,392,2,1,720,6050,1,0,0,2,5,720,0,1951,1951,98125,47.726,122.29,1480,7280,64,0,3,2200,8000
2.38e+05,2014,136,3,2,1020,1204,2,0,0,3,7,720,300,2004,2004,98126,47.544,122.38,1360,1506,10,0,5,2380,2526
6.28e+05,2014,321,5,2.75,2830,11795,1,0,0,4,7,1710,1120,1960,1960,98008,47.583,122.12,2460,10880,54,0,7.75,5290,13710
2e+05,2014,232,2,1,930,8665,1,0,0,4,6,930,0,1938,1938,98168,47.482,122.32,1630,12375,76,0,3,2560,13305
9.42e+05,2014,214,4,2.75,3160,37200,2,0,3,3,8,2310,850,1939,1939,98125,47.721,122.28,3130,20000,75,0,6.75,6290,23160
1.005e+06,2015,458,3,2.5,2570,5000,1,0,0,4,8,1480,1090,1940,1940,98105,47.658,122.28,2420,5484,75,0,5.5,4990,8054
2.9e+05,2014,319,3,1,1470,8200,1,0,0,3,7,1040,430,1953,1953,98155,47.735,122.3,1420,8200,61,0,4,2890,9670
3.6e+05,2014,174,3,1.75,1500,7200,1,0,0,3,7,1500,0,1957,1957,98133,47.775,122.34,1650,7392,57,0,4.75,3150,8892
4.37e+05,2015,479,3,3,1460,1180,3,0,0,3,8,1460,0,2006,2006,98117,47.7,122.37,1460,1224,9,0,6,2920,2684
4.3076e+05,2014,216,5,2.75,2710,4685,2,0,0,3,8,2710,0,2014,2014,98038,47.355,122.06,2710,4449,0,0,7.75,5420,7159
2.8966e+05,2014,176,4,2.25,2260,7200,2,0,0,4,7,2260,0,1984,1984,98031,47.412,122.18,1720,7200,30,0,6.25,3980,9460
2.52e+05,2015,410,3,1.5,1150,13200,1,0,0,3,7,1150,0,1956,1956,98166,47.475,122.34,1220,13066,59,0,4.5,2370,14216
2.615e+05,2014,352,4,2.5,2460,7800,1,0,0,3,8,1500,960,1977,1977,98023,47.308,122.38,2210,7800,37,0,6.5,4670,10260
1.98e+05,2014,197,3,1.75,1300,6318,1,0,0,3,7,1300,0,1980,1980,98001,47.275,122.25,1150,8002,34,0,4.75,2450,9302
1.027e+06,2014,169,3,2.5,2430,10500,2,0,1,3,9,2430,0,1989,1989,98004,47.582,122.2,3440,12842,25,0,5.5,5870,15272
7.625e+05,2014,236,4,2.5,3150,5979,2,0,0,3,9,3150,0,2005,2005,98052,47.708,122.1,3150,6595,9,0,6.5,6300,9745
1.6e+06,2014,178,3,4.25,2820,7200,2,0,0,4,10,2460,360,1930,1930,98112,47.63,122.29,3300,7522,84,0,7.25,6120,10342
2.85e+05,2014,248,3,1.75,1160,7006,1,0,0,4,7,1160,0,1992,1992,98022,47.194,121.98,1670,7750,22,0,4.75,2830,8910
8.115e+05,2014,320,5,4.25,3970,4500,2,0,0,3,9,2860,1110,2004,2004,98027,47.54,122.07,3480,4500,10,0,9.25,7450,8470
2.875e+05,2015,471,4,2,1220,9147,1,0,0,5,7,1220,0,1953,1953,98146,47.501,122.34,1220,8576,62,0,6,2440,9796
4.375e+05,2014,187,3,2,1490,4800,2,0,0,5,6,1490,0,1948,1948,98117,47.693,122.36,1500,4800,66,0,5,2990,6290
3.57e+05,2015,388,4,2.5,1980,9757,2,0,0,5,7,1980,0,1995,1995,98038,47.367,122.02,1610,6147,20,0,6.5,3590,8127
3.7977e+05,2014,307,3,2.5,1470,1779,2,0,0,3,8,1160,310,2005,2005,98029,47.547,122,1470,1576,9,0,5.5,2940,3046
7.78e+05,2014,203,3,2,1840,6000,2,0,0,5,7,1720,120,1946,1946,98033,47.683,122.21,1390,6000,68,0,5,3230,7840
3.55e+05,2014,182,3,1.75,1730,7416,1,0,0,3,7,1730,0,1954,1954,98133,47.76,122.35,1390,6490,60,0,4.75,3120,8220
4.19e+05,2014,250,3,2.5,3310,21096,2,0,2,3,9,3310,0,2004,2004,98023,47.305,122.39,3310,13835,10,0,5.5,6620,17145
7.79e+05,2014,286,4,1.5,2740,4912,1,0,0,4,8,1370,1370,1937,1937,98199,47.652,122.41,2160,5006,77,0,5.5,4900,7746
2.455e+05,2015,451,2,1.5,1430,9782,1,0,0,3,7,1430,0,1955,1955,98188,47.441,122.28,1430,9828,60,0,3.5,2860,11258
4.2e+05,2014,135,3,2,1640,9972,1,0,0,4,7,1640,0,1977,1977,98075,47.581,122,1680,10165,37,0,5,3320,11805
3.315e+05,2014,306,4,1.75,1820,14319,1,0,0,4,7,1820,0,1969,1969,98059,47.476,122.15,1440,10018,45,0,5.75,3260,11838
5.28e+05,2014,332,3,2.75,2160,4086,1,0,0,3,7,1380,780,1987,1987,98126,47.535,122.38,1300,4080,27,0,5.75,3460,6240
3.66e+05,2015,399,3,2.5,2370,4375,2,0,0,3,8,2370,0,2006,2006,98038,47.354,122,2380,4606,9,0,5.5,4750,6976
5.345e+05,2014,166,3,2.5,1700,3150,2,0,0,3,8,1700,0,2005,2005,98029,47.55,122,1700,3600,9,0,5.5,3400,5300
5.18e+05,2015,409,4,3,2430,11670,1,0,0,4,7,1330,1100,1978,1978,98034,47.731,122.23,1580,10464,37,0,7,4010,12894
3.77e+05,2015,459,3,2.5,1870,5333,2,0,0,3,8,1870,0,2012,2012,98019,47.745,121.98,2100,3730,3,0,5.5,3970,5600
3.9989e+05,2014,169,4,2.25,1820,8255,1,0,0,4,7,1320,500,1930,1930,98133,47.723,122.34,1550,7628,84,0,6.25,3370,9448
4.7e+05,2014,202,4,2.5,1850,11250,1,0,0,3,7,1210,640,1981,1981,98074,47.626,122.06,1650,7623,33,0,6.5,3500,9473
6.07e+05,2015,467,5,1.75,1910,5428,1,0,0,3,8,1390,520,1954,1954,98136,47.533,122.39,1820,5900,61,0,6.75,3730,7810
4.736e+05,2014,306,4,1.5,1780,8400,1,0,0,3,7,1080,700,1969,1969,98136,47.517,122.39,1660,8400,45,0,5.5,3440,10180
6.45e+05,2014,197,4,2.5,2860,14000,2,0,0,3,8,2860,0,1995,1995,98019,47.731,121.97,2650,14564,19,0,6.5,5510,17424
5.53e+05,2014,273,2,2,1400,1512,2,0,0,3,8,940,460,2006,2006,98107,47.672,122.39,1400,3500,8,0,4,2800,4900
3.5e+05,2015,463,3,2.25,1410,1340,2,0,0,3,8,1370,40,1967,1967,98008,47.611,122.11,1730,2748,48,0,5.25,3140,4158
5.25e+05,2014,272,4,2.75,2530,11549,1,0,0,3,7,1700,830,1942,1942,98033,47.656,122.2,2530,10000,72,0,6.75,5060,12530
3.05e+05,2014,271,3,2,1680,8487,1,0,0,3,7,1680,0,1993,1993,98022,47.196,122.01,2080,8560,21,0,5,3760,10240
5.93e+05,2014,310,5,2.5,2640,4400,1,0,0,5,7,1840,800,1925,1925,98122,47.605,122.3,1720,4400,89,0,7.5,4360,7040
3.07e+05,2015,480,4,2,2390,23972,2,0,0,3,7,1720,670,1949,1949,98023,47.32,122.34,1950,22750,66,0,6,4340,25140
3e+05,2014,283,3,2.5,1960,1477,2,0,0,3,7,1670,290,2012,2012,98059,47.487,122.17,1980,1467,2,0,5.5,3940,3427
9.5e+05,2015,453,4,2.25,2770,5320,2,0,1,3,9,2440,330,2013,2013,98136,47.528,122.39,2100,6011,2,0,6.25,4870,8781
2.1e+05,2014,188,3,2,960,9380,1,0,0,3,6,960,0,1949,1949,98146,47.485,122.34,1460,9240,65,0,5,2420,10200
3.9e+05,2014,195,1,1.75,1440,4920,1,0,0,3,7,720,720,1923,1923,98126,47.534,122.38,1440,4920,91,0,2.75,2880,6360
6.715e+05,2015,400,3,2.5,1770,1714,3,0,0,3,8,1770,0,2012,2012,98103,47.653,122.35,1720,3360,3,0,5.5,3490,5130
1.16e+06,2014,210,4,2.5,3860,10361,2,0,2,4,10,2940,920,1985,1985,98006,47.552,122.15,3720,13155,29,0,6.5,7580,17015
7.5175e+05,2014,147,2,2,1880,5400,1,0,0,3,8,1880,0,1902,1902,98112,47.624,122.31,1590,5400,112,0,4,3470,7280
6.685e+05,2014,266,4,2.25,2290,9546,1,0,0,4,8,1780,510,1976,1976,98006,47.562,122.13,2360,8864,38,0,6.25,4650,11154
1.015e+06,2014,208,3,2.5,2920,5629,1,0,2,5,8,1460,1460,1955,1955,98199,47.642,122.41,2380,5000,59,0,5.5,5300,7920
4.05e+05,2014,211,3,2.5,1500,2314,2,0,0,3,7,1500,0,2005,2005,98029,47.554,122,1440,2170,9,0,5.5,2940,3670
1.94e+05,2014,305,3,1.5,1010,5000,1,0,0,3,6,1010,0,1943,1943,98178,47.492,122.28,980,5000,71,0,4.5,1990,6010
1.2e+05,2015,381,3,1,1150,8924,1,0,0,3,6,1150,0,1943,1943,98030,47.386,122.22,1492,8924,72,0,4,2642,10074
4.43e+05,2015,488,3,1,1280,5460,1,0,0,4,7,1280,0,1931,1931,98133,47.732,122.33,1390,5500,84,0,4,2670,6780
3.14e+05,2014,136,4,2.5,2340,8990,2,0,0,3,8,2340,0,2003,2003,98038,47.378,122.03,2980,6718,11,0,6.5,5320,9058
3.1e+05,2015,424,3,2.75,2150,6576,1,0,0,4,7,1900,250,1926,1926,98155,47.754,122.31,2150,9071,89,0,5.75,4300,11221
6.82e+05,2015,457,4,2.5,2390,53941,2,0,0,3,8,2390,0,1989,1989,98053,47.707,122.08,2610,1.0411e+05,26,0,6.5,5000,1.065e+05
2.45e+05,2015,493,3,1.5,1340,7391,1,0,0,4,7,1340,0,1966,1966,98198,47.384,122.32,1300,7391,49,0,4.5,2640,8731
1.035e+06,2014,218,4,2.5,2910,9131,2,0,0,3,10,2910,0,2014,2014,98033,47.683,122.19,1880,11212,0,0,6.5,4790,14122
3.67e+05,2014,223,3,1.75,2000,12669,1,0,3,4,7,1200,800,1965,1965,98070,47.358,122.45,1580,12055,49,0,4.75,3580,14055
4.55e+05,2014,135,3,2.5,1870,7344,1,0,0,3,8,1470,400,1980,1980,98034,47.727,122.21,1930,7344,34,0,5.5,3800,9214
2.45e+05,2014,339,4,1.5,1850,7547,1,0,0,4,7,1850,0,1960,1960,98198,47.371,122.31,1730,7577,54,0,5.5,3580,9427
7.75e+05,2014,124,2,2.5,2680,7392,1,0,0,3,9,2680,0,2004,2004,98053,47.717,122.03,2315,7045,10,0,4.5,4995,9725
5.89e+05,2014,141,4,2.5,2910,5776,2,0,2,3,8,2910,0,1998,1998,98065,47.539,121.87,2550,6750,16,0,6.5,5460,9660
6.6e+05,2015,362,3,2.5,2400,6474,1,0,2,3,8,1560,840,1964,1964,98177,47.773,122.39,2340,10856,51,0,5.5,4740,13256
8.7591e+05,2015,463,4,2.5,3610,13292,2,0,0,3,10,3610,0,1996,1996,98075,47.587,121.97,3000,10776,19,0,6.5,6610,14386
1.33e+05,2014,350,5,2,1430,5600,1,0,0,3,6,1430,0,1947,1947,98118,47.519,122.27,1860,5980,67,0,7,3290,7410
4.1e+05,2015,437,4,2.5,2510,5258,2,0,0,3,7,2510,0,2001,2001,98056,47.482,122.19,2570,5119,14,0,6.5,5080,7629
6.5e+05,2014,294,4,2.5,2620,19864,2,0,0,4,8,2620,0,1984,1984,98052,47.701,122.12,2500,13285,30,0,6.5,5120,15905
5.18e+05,2014,313,4,2.5,2070,10244,1,0,0,3,8,1370,700,1969,1969,98006,47.559,122.18,2070,9683,45,0,6.5,4140,11753
5.61e+05,2014,162,3,2.25,1710,4140,2,0,0,3,8,1710,0,2004,2004,98029,47.55,122,1730,3680,10,0,5.25,3440,5390
1.015e+06,2015,424,4,2.5,2960,4760,2,0,0,3,8,2160,800,1900,1900,98102,47.637,122.32,1600,4760,115,0,6.5,4560,7720
1.48e+05,2014,188,2,1,630,4200,1,0,0,3,6,630,0,1930,1930,98106,47.533,122.35,970,4200,84,0,3,1600,4830
6.05e+05,2014,136,2,1,910,3600,1,0,0,4,7,910,0,1909,1909,98119,47.634,122.36,1720,3600,105,0,3,2630,4510
1.575e+05,2015,382,2,1,670,4500,1,0,0,3,5,670,0,1905,1905,98108,47.527,122.33,1210,4500,110,0,3,1880,5170
5.6e+05,2014,205,4,3,2170,5764,2,0,0,3,8,2170,0,1992,1992,98029,47.567,122,2010,5681,22,0,7,4180,7851
3.1e+05,2014,338,3,1,1210,7649,1,0,0,4,7,1210,0,1956,1956,98155,47.769,122.32,1210,6760,58,0,4,2420,7970
8.35e+05,2014,214,4,3.25,3270,6027,2,0,0,3,10,3270,0,2001,2001,98074,47.635,122.06,3270,6546,13,0,7.25,6540,9816
7.225e+05,2015,443,4,2.5,2460,9296,2,0,0,3,9,2460,0,1978,1978,98007,47.612,122.15,2730,9900,37,0,6.5,5190,12360
1.565e+06,2014,181,4,2.75,2970,12750,1,0,1,4,7,2130,840,1918,1986,98004,47.614,122.21,1980,15300,96,1,6.75,4950,18270
2.94e+05,2014,204,2,2.5,1380,889,2,0,0,3,7,1140,240,2012,2012,98126,47.544,122.37,1580,1397,2,0,4.5,2960,2777
5.064e+05,2014,319,3,2.5,2100,9040,1,0,0,3,8,1700,400,1989,1989,98056,47.533,122.17,2430,8809,25,0,5.5,4530,10909
6.33e+05,2014,352,4,3.5,4220,5817,2,0,0,3,9,2910,1310,2006,2006,98065,47.539,121.86,4290,6637,8,0,7.5,8510,10857
7.8e+05,2014,332,3,1,1660,4400,1,0,0,3,8,1460,200,1911,1911,98112,47.636,122.3,1660,4400,103,0,4,3320,6060
3.15e+05,2014,159,3,2.5,1480,1590,2,0,0,3,8,1150,330,2010,2010,98106,47.53,122.36,1480,5761,4,0,5.5,2960,7241
8.6e+05,2014,154,3,3.25,4720,32467,2,0,2,3,10,3190,1530,1998,1998,98059,47.508,122.11,3260,26386,16,0,6.25,7980,31106
3.1495e+05,2015,429,3,2.5,1690,4533,2,0,0,3,7,1690,0,2003,2003,98038,47.358,122.02,1830,5175,12,0,5.5,3520,6865
5.2e+05,2014,215,3,2,1410,2700,2,0,0,4,7,1410,0,1902,1902,98122,47.603,122.3,1750,4000,112,0,5,3160,5410
1.955e+05,2014,294,4,1,1230,8636,1,0,0,4,6,1230,0,1954,1954,98002,47.323,122.22,1168,8316,60,0,5,2398,9546
3.355e+05,2014,189,3,1,1370,6780,2,0,0,3,6,1370,0,1930,1930,98125,47.716,122.29,1450,7214,84,0,4,2820,8584
7.15e+05,2015,485,5,3.25,2710,2356,2,0,0,3,8,2230,480,2013,2013,98027,47.539,122.03,2160,2108,2,0,8.25,4870,4818
4.35e+05,2014,175,2,1,1060,3036,1,0,0,4,6,1060,0,1943,1943,98105,47.658,122.32,1730,5535,71,0,3,2790,6595
7.985e+05,2015,446,3,3,1950,1833,3,0,0,3,9,1610,340,2009,2009,98004,47.608,122.2,2040,2131,6,0,6,3990,4081
3.049e+05,2014,183,4,1.75,2600,11325,1,0,0,4,7,1610,990,1969,1969,98031,47.395,122.21,1720,11088,45,0,5.75,4320,13688
4.69e+05,2014,126,2,1,1030,4400,1,0,0,3,7,1030,0,1924,1924,98117,47.681,122.36,1400,4200,90,0,3,2430,5230
8e+05,2014,321,3,1.75,1510,3600,1,0,0,5,8,1230,280,1910,1910,98119,47.639,122.36,1300,3600,104,0,4.75,2810,5110
3.04e+05,2014,216,2,1.5,950,676,2,0,0,3,7,850,100,2003,2003,98144,47.6,122.31,950,1280,11,0,3.5,1900,2230
5.57e+05,2015,402,3,2.5,2280,18241,1,0,0,3,9,960,1320,1995,1995,98011,47.745,122.21,3100,12465,20,0,5.5,5380,14745
2.3e+05,2015,430,3,1,1380,10112,1,0,0,4,7,940,440,1963,1963,98023,47.32,122.35,1240,10112,52,0,4,2620,11492
5.68e+05,2014,231,3,2.5,1740,1279,3,0,0,3,8,1740,0,2008,2008,98116,47.589,122.39,1740,1280,6,0,5.5,3480,3020
6.3e+05,2015,473,3,2.5,3490,12410,2,0,0,3,8,2590,900,2009,2009,98059,47.471,122.07,1740,14448,6,0,5.5,5230,17938
7.08e+05,2014,228,5,2,3180,10800,1,0,0,3,8,1910,1270,1968,1968,98052,47.635,122.1,2440,9750,46,0,7,5620,12930
5.49e+05,2014,325,3,2,1340,3000,2,0,0,5,7,1340,0,1905,1905,98103,47.686,122.35,1120,3000,109,0,5,2460,4340
2.775e+05,2015,459,4,2,1700,12048,2,0,0,3,7,1700,0,1990,1990,98030,47.375,122.19,1960,7650,25,0,6,3660,9350
9.728e+05,2015,451,5,3.25,3500,10457,2,0,0,3,11,3500,0,2001,2001,98059,47.52,122.16,3500,11734,14,0,8.25,7000,15234
5.6e+05,2014,266,3,2,2870,95396,1,0,0,4,9,1350,1520,1980,1980,98027,47.483,122,2870,1.0237e+05,34,0,5,5740,1.0524e+05
5.16e+05,2014,210,2,1.75,1640,3090,1,0,0,4,7,910,730,1925,1925,98115,47.679,122.32,1510,4120,89,0,3.75,3150,5760
2.85e+05,2015,455,3,1.5,1490,10367,1,0,0,3,7,1010,480,1957,1957,98146,47.497,122.35,1000,8254,58,0,4.5,2490,9744
4.67e+05,2014,293,2,1.5,1320,10800,1,0,0,4,8,1320,0,1947,1947,98177,47.715,122.37,2120,12040,67,0,3.5,3440,13360
6.15e+05,2014,152,4,2.5,2150,9070,2,0,0,4,8,2150,0,1985,1985,98052,47.728,122.11,2230,8995,29,0,6.5,4380,11145
8.9e+05,2015,433,4,2,1480,11171,1,0,0,4,6,1480,0,1947,1947,98075,47.585,122.05,2790,20680,68,0,6,4270,22160
3.0135e+05,2014,142,3,3,1860,7440,1,0,0,5,7,1040,820,1954,1954,98178,47.504,122.25,1490,8160,60,0,6,3350,10020
2.9e+05,2014,263,1,0.75,740,1284,1,0,0,4,6,740,0,1928,1928,98107,47.674,122.41,1430,3988,86,0,1.75,2170,4728
3.35e+05,2014,231,4,1.75,1950,13440,1,0,0,4,6,1950,0,1931,1931,98065,47.523,121.82,1300,7432,83,0,5.75,3250,9382
3.1e+05,2014,203,2,1,1560,4920,1,0,0,4,6,780,780,1947,1947,98125,47.725,122.33,1760,7510,67,0,3,3320,9070
5.5e+05,2015,485,3,1,1070,3713,1,0,0,4,6,1070,0,1917,1917,98118,47.568,122.28,1290,3960,98,0,4,2360,5030
7.5e+05,2015,487,3,2.5,2400,7745,2,0,0,3,9,2400,0,2001,2001,98033,47.673,122.17,2080,8615,14,0,5.5,4480,11015
4.3e+05,2014,236,4,1.75,1710,7724,1,0,0,3,8,1710,0,1983,1983,98155,47.772,122.29,1940,7724,31,0,5.75,3650,9434
3.2e+05,2014,276,4,2.5,2300,3825,2,0,0,3,7,2300,0,2012,2012,98042,47.359,122.08,2110,3825,2,0,6.5,4410,6125
2.1e+05,2014,348,3,2,1830,4992,1,0,0,3,7,1230,600,1953,1953,98118,47.514,122.27,2050,7740,61,0,5,3880,9570
1.87e+05,2014,310,2,1.75,1020,10346,1,0,0,4,6,1020,0,1983,1983,98022,47.196,122,1160,8610,31,0,3.75,2180,9630
4.32e+05,2014,153,3,2.5,1970,4036,2,0,0,4,7,1970,0,2003,2003,98065,47.533,121.87,1960,5020,11,0,5.5,3930,6990
5.35e+05,2015,380,3,2.5,2510,5544,2,0,0,3,7,2510,0,2001,2001,98053,47.69,122.04,2660,5614,14,0,5.5,5170,8124
5.546e+05,2014,228,3,1.75,1470,5000,1,0,0,5,7,1470,0,1900,1900,98107,47.675,122.37,1530,5000,114,0,4.75,3000,6470
2.8835e+05,2014,159,3,1.5,1860,7963,1,0,0,3,7,1200,660,1963,1963,98188,47.451,122.27,1800,10400,51,0,4.5,3660,12260
2.86e+05,2015,408,4,1.5,1600,5750,2,0,0,4,6,1600,0,1902,1902,98118,47.544,122.28,1690,5750,113,0,5.5,3290,7350
1.55e+06,2015,473,3,3.25,3530,4920,2,0,0,3,9,2660,870,2015,2015,98109,47.641,122.36,1900,4200,0,0,6.25,5430,7730
7.55e+05,2015,365,2,2.5,1360,2070,2,0,0,3,8,1360,0,1999,1999,98102,47.642,122.33,1920,2092,16,0,4.5,3280,3452
6.05e+05,2014,153,5,2.75,2740,5616,1,0,0,5,7,1670,1070,1925,1925,98115,47.687,122.32,1600,4592,89,0,7.75,4340,7332
1.2e+06,2014,360,3,2,2480,13310,1,0,0,2,7,2480,0,1955,1955,98052,47.676,122.11,2400,11340,59,0,5,4880,13820
1.06e+06,2015,451,5,4.5,4140,7924,2,0,0,3,10,4140,0,2005,2005,98074,47.61,121.99,3960,8410,10,0,9.5,8100,12550
4.4e+05,2014,277,3,1.75,2350,7641,1,0,0,3,7,1510,840,1978,1978,98034,47.731,122.22,2190,7500,36,0,4.75,4540,9850
1.44e+05,2015,471,3,1,1250,8314,1,0,0,3,6,1250,0,1958,1958,98058,47.452,122.18,1188,7700,57,0,4,2438,8950
5.89e+05,2014,276,3,2,2360,1.1848e+05,1,0,0,3,8,2360,0,1981,1981,98024,47.559,121.87,2660,91476,33,0,5,5020,93836
2.9e+05,2014,345,2,1,950,5650,1,0,0,5,6,950,0,1943,1943,98118,47.515,122.26,1250,5650,71,0,3,2200,6600
1.289e+06,2014,250,5,3.5,3210,4060,2,0,2,3,10,2290,920,1917,2003,98117,47.68,122.36,1940,5000,97,1,8.5,5150,8210
6e+05,2014,153,4,2.5,1960,14242,1,0,1,4,8,1290,670,1958,1958,98146,47.495,122.37,2490,10907,56,0,6.5,4450,12867
2.57e+05,2014,287,5,2.75,2930,10148,2,0,0,3,9,2930,0,2002,2002,98059,47.489,122.14,2930,8425,12,0,7.75,5860,11355
2.46e+05,2014,127,3,1,1400,7410,1,0,0,3,6,1400,0,1944,1944,98166,47.48,122.34,1070,7410,70,0,4,2470,8810
4.36e+05,2014,169,2,1,790,6600,1,0,0,3,6,790,0,1949,1949,98122,47.615,122.29,1520,4400,65,0,3,2310,5190
3.4e+05,2014,248,4,2.25,2060,8400,1,0,0,3,7,1300,760,1960,1960,98178,47.498,122.23,1990,7383,54,0,6.25,4050,9443
2.11e+05,2014,128,4,1,2100,9200,1,0,0,3,7,1050,1050,1959,1959,98168,47.476,122.29,1540,10033,55,0,5,3640,12133
2.574e+06,2014,263,4,3.75,4475,20424,2,1,4,3,12,2659,1816,1999,1999,98033,47.665,122.21,4340,5250,15,0,7.75,8815,9725
2.6e+05,2014,250,3,1.5,1320,9750,1,0,0,3,7,1320,0,1954,1954,98148,47.427,122.33,1530,9750,60,0,4.5,2850,11070
4.3995e+05,2015,410,2,2,1440,4666,1,0,0,3,8,1440,0,2010,2010,98053,47.709,122.02,1510,4595,5,0,4,2950,6035
2.3678e+05,2015,410,3,2.5,1830,8372,2,0,0,3,8,1830,0,1987,1987,98023,47.312,122.4,1770,8372,28,0,5.5,3600,10202
2.45e+05,2014,307,2,1,670,2356,1,0,0,5,6,670,0,1960,1960,98144,47.592,122.3,1220,1740,54,0,3,1890,2410
1.265e+06,2014,332,4,2.25,2870,6000,1,0,0,5,8,1730,1140,1951,1951,98112,47.636,122.28,2370,5500,63,0,6.25,5240,8370
2.44e+05,2014,347,3,1.75,1500,7475,1,0,0,4,8,1500,0,1976,1976,98023,47.316,122.36,1940,7475,38,0,4.75,3440,8975
4.73e+05,2014,285,3,3,1380,1081,3,0,0,3,8,1380,0,2005,2005,98107,47.669,122.39,1390,1140,9,0,6,2770,2520
5.79e+05,2015,373,2,1.75,1560,4500,1,0,0,3,8,1560,0,2004,2004,98053,47.713,122.03,1860,4500,11,0,3.75,3420,6060
3.63e+05,2015,437,3,1.75,1960,8136,1,0,0,3,7,980,980,1948,1948,98106,47.521,122.36,1070,7480,67,0,4.75,3030,9440
6.3163e+05,2014,125,4,2.5,2440,6651,2,0,0,3,9,2440,0,2014,2014,98117,47.697,122.37,1350,7653,0,0,6.5,3790,10093
1.638e+05,2014,212,2,2.5,1000,1092,2,0,0,3,7,990,10,2004,2004,98118,47.542,122.27,1330,1466,10,0,4.5,2330,2466
7.16e+05,2015,386,3,2,1420,3600,1,0,0,4,7,1420,0,1904,1904,98119,47.637,122.36,1250,3600,111,0,5,2670,5020
2.58e+05,2014,331,3,2,1790,7879,1,0,0,3,7,1790,0,1998,1998,98001,47.263,122.29,1790,7879,16,0,5,3580,9669
2.4e+05,2015,443,2,1,1320,24319,1,0,0,3,7,1320,0,1966,1966,98027,47.474,122.02,1430,98445,49,0,3,2750,99765
1.0495e+05,2014,338,2,1,1170,8254,1,0,0,2,6,1170,0,1949,1949,98146,47.497,122.35,1820,8922,65,0,3,2990,10092
4.5e+05,2015,443,3,1.75,1390,11700,1,0,0,4,7,1390,0,1966,1966,98033,47.7,122.19,1060,8686,49,0,4.75,2450,10076
2.48e+05,2014,161,5,1.5,1510,9078,1,0,0,4,7,1510,0,1959,1959,98168,47.485,122.31,1480,9078,55,0,6.5,2990,10588
6.8e+05,2014,359,6,2.5,3180,9375,1,0,0,4,8,1590,1590,1967,1967,98006,47.571,122.13,2670,9625,47,0,8.5,5850,12805
6.85e+05,2014,154,4,2.5,2770,45514,2,0,0,4,9,2770,0,1989,1989,98077,47.775,122.09,2940,49495,25,0,6.5,5710,52265
2.1e+05,2015,452,2,1,1520,4700,2,0,0,4,7,1520,0,1978,1978,98092,47.319,122.18,1140,3906,37,0,3,2660,5426
4.65e+05,2015,471,3,1.5,1280,4720,1,0,0,4,7,850,430,1941,1941,98126,47.551,122.38,1280,4720,74,0,4.5,2560,6000
4.68e+05,2015,439,4,2.5,3040,20682,2,0,0,3,7,3040,0,2000,2000,98019,47.724,121.96,2670,9742,15,0,6.5,5710,12782
4.55e+05,2014,174,4,2.5,2950,4502,2,0,0,3,7,2950,0,2005,2005,98059,47.5,122.15,2360,4502,9,0,6.5,5310,7452
3.83e+05,2015,381,4,2.5,2640,8055,2,0,0,3,9,2640,0,2004,2004,98092,47.315,122.19,1650,8055,11,0,6.5,4290,10695
4.5e+05,2014,224,3,1.75,1810,12600,1,0,0,3,7,1400,410,1977,1977,98034,47.714,122.23,1934,12600,37,0,4.75,3744,14410
2.9457e+05,2015,432,3,1,1140,8400,1,0,0,4,7,1140,0,1960,1960,98059,47.502,122.14,1400,9000,55,0,4,2540,10140
1.8e+05,2014,291,2,1,1150,5695,1,0,0,4,6,1150,0,1958,1958,98056,47.499,122.17,1150,5695,56,0,3,2300,6845
2.355e+05,2014,188,5,2.5,2340,13713,1,0,0,2,8,1670,670,1967,1967,98003,47.331,122.32,2080,11000,47,0,7.5,4420,13340
5.6e+05,2014,173,4,2.5,2300,7989,2,0,0,3,9,2300,0,1990,1990,98074,47.627,122.03,2280,8835,24,0,6.5,4580,11135
2.55e+05,2014,279,2,1,920,43560,1,0,0,4,5,920,0,1923,1923,98024,47.525,121.93,1530,11875,91,0,3,2450,12795
2.6895e+05,2014,300,3,1,1320,8100,1,0,0,3,6,880,440,1943,1943,98166,47.47,122.35,1000,8100,71,0,4,2320,9420
3.1175e+05,2015,396,4,2.25,2270,12000,1,0,0,4,7,1290,980,1976,1976,98023,47.329,122.35,2030,23980,39,0,6.25,4300,26250
3.21e+05,2014,283,4,1,1300,18836,1,0,0,4,7,1300,0,1941,1941,98056,47.503,122.19,1540,8498,73,0,5,2840,9798
2.42e+05,2014,195,4,1,2240,7620,1,0,0,3,7,1120,1120,1966,1966,98146,47.509,122.35,1080,7620,48,0,5,3320,9860
4.2e+05,2015,485,3,2.5,1470,1445,2,0,0,3,8,1160,310,2005,2005,98029,47.547,122,1470,1525,10,0,5.5,2940,2995
5.7e+05,2015,470,2,1,1060,4000,1,0,0,4,7,1060,0,1910,1910,98115,47.673,122.31,1770,4000,105,0,3,2830,5060
3.3e+05,2014,225,1,1,860,4800,1,0,0,3,6,860,0,1907,1907,98122,47.615,122.3,1380,4800,107,0,2,2240,5660
5.15e+05,2014,359,3,2,1690,5100,1,0,0,5,7,1690,0,1907,1907,98117,47.68,122.38,1690,5100,107,0,5,3380,6790
7.25e+05,2014,170,3,3.5,3690,8837,2,0,0,3,10,3690,0,2001,2001,98065,47.54,121.88,3690,9585,13,0,6.5,7380,13275
3.25e+05,2014,229,2,1,750,5534,1,0,0,3,7,750,0,1947,1947,98177,47.702,122.36,1050,5534,67,0,3,1800,6284
1.545e+05,2014,264,3,1,890,9465,1,0,0,3,6,890,0,1957,1957,98148,47.439,122.33,1590,9147,57,0,4,2480,10037
5.05e+05,2014,266,2,3,2770,10800,1,0,0,5,8,1910,860,1984,1984,98074,47.608,122.06,2140,10800,30,0,5,4910,13570
2.175e+06,2014,338,4,3,4750,21701,1,0,0,5,11,4750,0,1976,1976,98004,47.645,122.22,3120,18551,38,0,7,7870,23301
8.95e+05,2015,409,3,2,2160,1.0542e+05,1,0,0,3,10,2160,0,1991,1991,98059,47.481,122.15,2760,9620,24,0,5,4920,11780
8.8e+05,2015,431,4,2,2530,10800,1,0,0,5,8,1350,1180,1954,1954,98040,47.571,122.22,2960,12150,61,0,6,5490,14680
5.825e+05,2015,394,2,1,1140,23779,1,0,0,3,6,1140,0,1966,1966,98033,47.695,122.17,2940,8417,49,0,3,4080,9557
2.875e+05,2014,245,4,2.5,2240,6944,1,0,2,3,7,1310,930,1979,1979,98001,47.338,122.26,1780,7477,35,0,6.5,4020,9717
3.595e+05,2014,180,4,2.75,2140,10316,2,0,0,3,8,2140,0,1993,1993,98001,47.354,122.27,1920,11337,21,0,6.75,4060,13477
3.5e+05,2015,414,3,1,1540,9800,1,0,0,4,7,1540,0,1950,1950,98155,47.76,122.33,1560,9450,65,0,4,3100,10990
3.83e+05,2015,365,3,1.5,1340,7725,1,0,0,4,8,1340,0,1967,1967,98056,47.539,122.17,1990,7725,48,0,4.5,3330,9065
3.7e+05,2015,382,3,2.5,1070,1219,2,0,0,3,7,720,350,2004,2004,98116,47.562,122.38,1070,1254,11,0,5.5,2140,2324
5.1e+05,2014,313,2,1,1390,5544,1,0,0,3,7,930,460,1947,1947,98105,47.67,122.27,1710,6200,67,0,3,3100,7590
4.748e+05,2014,148,2,3.25,1400,1243,3,0,0,3,8,1400,0,2000,2000,98103,47.653,122.35,1400,1335,14,0,5.25,2800,2735
4.33e+05,2015,436,3,2.75,2000,7200,1,0,0,3,7,1000,1000,1954,2014,98166,47.453,122.35,1440,7200,61,1,5.75,3440,9200
5.82e+05,2014,361,3,1.75,1820,3140,2,0,0,5,8,1820,0,1949,1990,98136,47.527,122.38,2030,5499,65,1,4.75,3850,7319
1e+06,2015,416,3,2.5,2100,4097,2,0,0,3,9,2100,0,2008,2008,98004,47.598,122.2,1780,4764,7,0,5.5,3880,6864
6.475e+05,2015,458,5,2,1760,21562,1,0,1,3,8,1560,200,1959,1959,98028,47.76,122.26,2150,12676,56,0,7,3910,14436
3.4e+05,2014,182,4,2.5,1954,4805,2,0,0,3,8,1954,0,2005,2005,98055,47.43,122.19,1714,3259,9,0,6.5,3668,5213
2.25e+05,2015,408,3,2.5,2170,11745,1,0,0,4,7,1410,760,1967,1967,98058,47.434,122.17,1860,8643,48,0,5.5,4030,10813
4.8e+05,2015,369,6,5,3028,18055,2,0,0,3,7,3028,0,2005,2005,98030,47.365,122.2,1400,34575,10,0,11,4428,37603
1.05e+06,2014,132,4,3.75,3280,11000,2,0,0,3,10,2320,960,2008,2008,98033,47.685,122.2,2400,8351,6,0,7.75,5680,11631
4.85e+05,2014,301,3,2.5,1840,8250,1,0,1,3,8,1340,500,1958,1958,98177,47.777,122.38,1970,7920,56,0,5.5,3810,9760
2.5495e+05,2014,317,2,1,700,8100,1,0,0,3,6,700,0,1949,1949,98155,47.749,122.31,1230,8100,65,0,3,1930,8800
4.7e+05,2015,424,3,2.5,1980,9725,2,0,0,3,8,1980,0,1994,1994,98045,47.486,121.8,2070,9834,21,0,5.5,4050,11814
1.072e+06,2014,238,2,2.25,3900,14864,1,0,3,3,8,1950,1950,1947,1947,98144,47.588,122.29,2580,5184,67,0,4.25,6480,9084
1.325e+06,2015,413,3,3,3180,2758,2,0,2,3,11,2240,940,2008,2008,98109,47.638,122.34,2420,2758,7,0,6,5600,5938
3.75e+05,2014,155,3,1.75,960,8106,1,0,0,3,7,960,0,1962,1962,98052,47.674,122.16,1650,8035,52,0,4.75,2610,8995
4.5e+05,2015,437,3,2,1540,67756,1,0,0,3,7,1540,0,1900,1973,98077,47.721,122.08,2060,67756,115,1,5,3600,69296
2.2e+05,2014,224,3,1,1460,10200,1,0,0,4,7,1460,0,1957,1957,98055,47.424,122.2,1460,8500,57,0,4,2920,9960
5.6e+05,2014,334,4,1.5,1810,3400,2,0,0,3,8,1810,0,1926,1926,98112,47.626,122.3,1770,3600,88,0,5.5,3580,5410
3.8e+05,2014,167,4,2.5,2150,37647,2,0,0,3,8,2150,0,1991,1991,98042,47.312,122.08,2410,42193,23,0,6.5,4560,44343
5e+05,2014,287,3,1.75,1530,8829,1,0,0,5,8,1530,0,1972,1972,98006,47.545,122.17,2060,9226,42,0,4.75,3590,10756
7.35e+05,2014,306,4,2.5,2470,2550,3,0,0,3,8,2470,0,2004,2004,98117,47.676,122.39,1270,3060,10,0,6.5,3740,5530
4.12e+05,2014,170,2,1,1260,3960,1,0,0,3,6,690,570,1925,1925,98117,47.69,122.39,1250,3960,89,0,3,2510,5220
3.1e+05,2014,285,4,2.5,2310,7384,2,0,0,3,8,2310,0,2010,2010,98042,47.374,122.17,2310,7800,4,0,6.5,4620,10110
4.87e+05,2014,202,3,1.75,1770,10125,2,0,0,3,7,1770,0,1944,1978,98133,47.729,122.35,1680,9825,70,1,4.75,3450,11595
4.5e+05,2014,211,3,2.5,1530,762,2,0,0,3,8,1050,480,2007,2007,98119,47.642,122.37,1610,1482,7,0,5.5,3140,3012
1.3712e+05,2014,189,3,1,960,27442,1,0,0,4,6,960,0,1970,1970,98058,47.468,122.13,1100,29019,44,0,4,2060,29979
6.595e+05,2014,160,3,1.75,1820,5500,1,0,0,4,8,1620,200,1957,1957,98115,47.674,122.28,2330,6050,57,0,4.75,4150,7870
4.33e+05,2015,438,3,1.75,2160,8565,1,0,0,3,8,1730,430,1971,1971,98028,47.766,122.26,2910,9570,44,0,4.75,5070,11730
2.92e+05,2015,424,3,1.75,1090,4500,1,0,0,5,8,1090,0,1929,1929,98118,47.516,122.26,1640,5225,86,0,4.75,2730,6315
4.65e+05,2014,339,3,2.5,2870,25663,2,0,0,3,10,2870,0,1988,1988,98003,47.277,122.33,2950,24347,26,0,5.5,5820,27217
2.5e+05,2014,127,1,1,1100,4373,1,0,0,2,6,820,280,1947,1947,98166,47.465,122.34,1100,7500,67,0,2,2200,8600
3.5e+05,2014,136,4,2.5,2440,4000,2,0,0,3,7,2440,0,2009,2009,98038,47.384,122.04,2410,4502,5,0,6.5,4850,6942
6.05e+05,2015,404,3,1.75,1930,5400,2,0,2,3,9,1930,0,1978,1978,98177,47.77,122.39,2100,6840,37,0,4.75,4030,8770
4e+05,2014,136,3,2.5,2740,83199,2,0,4,3,9,2740,0,1973,1973,98032,47.358,122.27,2500,29269,41,0,5.5,5240,32009
3.9e+05,2015,479,3,1.75,1435,8960,1,0,0,4,8,1435,0,1969,1969,98058,47.453,122.15,2030,9450,46,0,4.75,3465,10885
5.3e+05,2014,286,3,2.25,2160,8114,1,0,0,3,8,1460,700,1960,1960,98133,47.718,122.35,2160,8000,54,0,5.25,4320,10160
2.79e+05,2015,392,3,2.5,1500,7350,1,0,0,2,7,1060,440,1979,1979,98023,47.303,122.38,1390,7770,36,0,5.5,2890,9270
2.9995e+05,2014,140,3,1,910,8000,1,0,0,4,6,740,170,1950,1950,98177,47.775,122.38,2090,9007,64,0,4,3000,9917
2.892e+05,2014,321,3,2.25,1760,7023,2,0,0,3,7,1760,0,1995,1995,98019,47.747,121.98,1760,7082,19,0,5.25,3520,8842
7.6025e+05,2014,280,5,2.75,2540,8250,1,0,0,4,7,1440,1100,1953,1953,98040,47.587,122.24,2540,11000,61,0,7.75,5080,13540
4.65e+05,2015,438,4,2.25,2210,8862,1,0,0,4,8,1270,940,1977,1977,98011,47.773,122.2,2030,8862,38,0,6.25,4240,11072
3.75e+05,2014,147,3,1.75,1440,8775,1,0,0,3,7,1440,0,1973,1973,98034,47.723,122.17,1790,7865,41,0,4.75,3230,9305
1.9e+05,2015,410,3,1,1510,8760,1,0,0,4,6,1510,0,1946,1946,98002,47.301,122.22,1040,7828,69,0,4,2550,9338
6.75e+05,2014,345,3,2.5,1300,1590,2,0,0,3,8,1100,200,2014,2014,98109,47.638,122.34,1070,1223,0,0,5.5,2370,2523
6.1675e+05,2015,392,3,1.5,2140,47743,1,0,0,3,9,2140,0,1978,1978,98106,47.54,122.36,1060,6016,37,0,4.5,3200,8156
3.9999e+05,2014,340,5,2.75,1690,4000,1,0,0,5,7,970,720,1943,1943,98106,47.531,122.35,1240,4000,71,0,7.75,2930,5690
1.765e+06,2014,263,4,3.25,3980,10249,2,0,0,3,10,3980,0,2011,2011,98004,47.587,122.2,2450,10912,3,0,7.25,6430,14892
5.925e+05,2014,205,2,2,1870,4751,1,0,0,3,8,1870,0,2006,2006,98053,47.708,122.02,2170,5580,8,0,4,4040,7450
6.5e+05,2014,194,1,1,920,91476,1,0,0,3,6,920,0,1996,2002,98070,47.448,122.47,1746,91476,18,1,2,2666,92396
4.5e+05,2014,298,2,1,1340,7250,1,0,0,4,7,1340,0,1951,1951,98125,47.702,122.32,1450,7026,63,0,3,2790,8366
2.343e+05,2015,459,3,1,1140,9779,1,0,0,3,7,1140,0,1963,1963,98055,47.424,122.2,1520,9814,52,0,4,2660,10954
3.69e+05,2014,192,3,2.5,1320,1683,2,0,0,3,8,1270,50,2004,2004,98106,47.536,122.36,1320,2206,10,0,5.5,2640,3526
2.6e+05,2014,312,4,2.5,1790,4358,2,0,0,3,7,1790,0,1993,1993,98031,47.399,122.2,1790,4305,21,0,6.5,3580,6095
2.9e+06,2015,484,4,3.25,5050,20100,1,0,2,3,11,4750,300,1982,2008,98004,47.631,122.22,3890,20060,33,1,7.25,8940,25110
2.67e+05,2014,279,3,1.75,1440,10920,1,0,0,4,8,1440,0,1977,1977,98030,47.381,122.17,1720,8260,37,0,4.75,3160,9700
9.7435e+05,2014,204,4,2.5,3090,10730,2,0,0,5,8,2420,670,1985,1985,98006,47.546,122.14,2220,7875,29,0,6.5,5310,10965
5.2675e+05,2015,394,5,2.5,2270,10700,1,0,0,4,8,1570,700,1963,1963,98028,47.741,122.26,2020,10230,52,0,7.5,4290,12500
1.262e+06,2014,197,2,3,2210,3917,2,0,0,3,10,1500,710,2008,2008,98122,47.617,122.29,1720,3933,6,0,5,3930,6143
5.5e+05,2014,259,4,2.5,2810,7549,2,0,0,3,9,2810,0,1992,1992,98072,47.744,122.17,2750,7642,22,0,6.5,5560,10452
7.9995e+05,2014,262,4,3.5,3030,5494,3,0,0,3,9,3030,0,2014,2014,98052,47.71,122.11,2910,5314,0,0,7.5,5940,8344
4e+05,2014,214,3,2,1860,12944,1,0,0,3,9,1860,0,2002,2002,98058,47.43,122.1,2500,29279,12,0,5,4360,31139
7.43e+05,2014,335,4,2.75,3410,5838,2,0,0,3,9,3410,0,2012,2012,98053,47.693,122.02,3420,7048,2,0,6.75,6830,10458
2.15e+05,2014,203,3,1.75,1430,13399,1,0,0,4,7,900,530,1946,1946,98168,47.479,122.28,1720,6415,68,0,4.75,3150,7845
6.29e+05,2014,205,3,2,1510,4560,2,0,0,4,7,1510,0,1909,1995,98116,47.569,122.41,1990,5000,105,1,5,3500,6510
7.26e+05,2015,387,3,2.5,1890,3880,1,0,0,4,8,1460,430,1915,1915,98107,47.664,122.36,1010,3880,100,0,5.5,2900,5770
2.8565e+05,2014,214,3,1,1040,8199,1,0,0,3,7,1040,0,1953,1953,98155,47.735,122.3,1420,8200,61,0,4,2460,9240
3.3489e+05,2014,176,3,2.5,1769,7324,2,0,0,3,9,1769,0,2012,2012,98092,47.331,122.19,2502,6017,2,0,5.5,4271,7786
6.49e+05,2014,263,5,3.25,3990,13087,2,0,0,3,9,2400,1590,1991,1991,98042,47.363,122.06,2580,13633,23,0,8.25,6570,17623
3.4e+05,2014,304,4,1.75,2140,11651,2,0,0,3,8,2140,0,1930,2001,98022,47.196,122.01,2030,10978,84,1,5.75,4170,13118
4.75e+05,2014,156,2,1,890,4590,1,0,0,3,7,890,0,1923,1923,98117,47.69,122.36,1310,4590,91,0,3,2200,5480
2.05e+05,2015,391,2,1.5,830,1020,2,0,0,3,7,830,0,2006,2006,98106,47.56,122.36,830,1379,9,0,3.5,1660,2209
2.9e+05,2014,235,3,2.25,1500,7308,1,0,0,4,7,1210,290,1968,1968,98055,47.462,122.19,1480,7400,46,0,5.25,2980,8900
5.25e+05,2015,468,3,1.75,1600,9579,1,0,0,3,8,1180,420,1977,1977,98072,47.766,122.16,1750,9829,38,0,4.75,3350,11429
3.6e+05,2014,335,4,1.75,1750,18810,1,0,0,3,7,1220,530,1977,1977,98059,47.472,122.07,1840,17424,37,0,5.75,3590,19174
7.6e+05,2014,249,3,2.5,2190,10000,1,0,0,4,7,1540,650,1957,1957,98040,47.542,122.21,2880,11782,57,0,5.5,5070,13972
1.8995e+05,2015,431,4,2,1910,4225,1,0,0,4,6,910,1000,1919,1919,98001,47.308,122.23,1060,4800,96,0,6,2970,6710
4.385e+05,2014,359,3,2.25,3050,10689,2,0,0,4,9,3050,0,1988,1988,98092,47.333,122.2,2697,10925,26,0,5.25,5747,13975
4e+05,2014,301,3,2,1350,7216,1,0,0,3,7,1350,0,1964,1964,98177,47.762,122.36,1920,7600,50,0,5,3270,8950
2.61e+05,2014,361,3,1.75,1350,7686,1,0,0,3,7,1350,0,1987,1987,98038,47.362,122.05,1370,7686,27,0,4.75,2720,9036
5e+05,2014,335,2,1,680,5250,1,0,0,4,6,680,0,1922,1922,98177,47.701,122.36,1620,5461,92,0,3,2300,6141
3.81e+05,2014,277,3,2.5,1470,3999,2,0,0,3,7,1470,0,2003,2003,98065,47.533,121.87,1960,4444,11,0,5.5,3430,5914
3.8e+05,2015,478,4,1.75,1720,9600,1,0,0,4,8,1720,0,1969,1969,98059,47.476,122.16,1660,10720,46,0,5.75,3380,12440
8.97e+05,2014,290,4,2.5,2820,6120,2,0,0,3,9,2820,0,2014,2014,98115,47.691,122.29,1510,6120,0,0,6.5,4330,8940
3.8361e+05,2015,409,3,2,1230,8450,1,0,0,3,7,1230,0,1989,1989,98155,47.755,122.31,2110,8536,26,0,5,3340,9766
1.75e+05,2014,182,4,2.5,1780,6000,2,0,0,3,7,1780,0,1991,1991,98198,47.383,122.3,1630,6000,23,0,6.5,3410,7780
3.95e+05,2014,215,2,1,960,6700,1,0,0,3,7,960,0,1951,1951,98103,47.696,122.36,1350,6700,63,0,3,2310,7660
3.53e+05,2015,450,3,2.5,2550,6021,2,0,0,3,7,2550,0,2002,2002,98030,47.383,122.21,2080,6021,13,0,5.5,4630,8571
2.36e+05,2014,159,3,1.75,1330,6301,1,0,0,3,7,1330,0,1998,1998,98002,47.341,122.22,1330,6144,16,0,4.75,2660,7474
1.0131e+06,2014,210,4,2.5,2480,12688,1,0,0,4,9,1820,660,1967,1967,98004,47.634,122.2,2910,11979,47,0,6.5,5390,14459
4.0665e+05,2014,222,2,1,1070,6100,1,0,0,3,6,1070,0,1940,1940,98126,47.57,122.38,1770,5695,74,0,3,2840,6765
2.65e+05,2015,422,2,1.5,1440,22081,2,0,0,3,7,1440,0,1990,1990,98019,47.77,121.9,1440,19544,25,0,3.5,2880,20984
2.3e+05,2014,177,3,1.75,1010,9600,1,0,0,5,7,1010,0,1969,1969,98042,47.383,122.09,1320,9600,45,0,4.75,2330,10610
5.4e+05,2015,447,4,1,1690,3417,1,0,0,3,7,1690,0,1907,1907,98199,47.663,122.4,1970,4800,108,0,5,3660,6490
8.05e+05,2014,317,3,2.5,2690,17461,2,0,3,3,10,2690,0,1997,1997,98074,47.654,122.09,3610,16887,17,0,5.5,6300,19577
1.691e+06,2014,273,4,3.5,4020,13515,2,0,0,3,11,4020,0,2001,2001,98004,47.646,122.21,3930,13515,13,0,7.5,7950,17535
3.75e+05,2014,237,1,1,1090,5250,1,0,0,3,6,980,110,1927,1927,98117,47.7,122.39,2160,5250,87,0,2,3250,6340
2.25e+05,2015,467,3,1,1250,10200,1,0,0,3,6,1250,0,1965,1965,98178,47.49,122.26,1800,8283,50,0,4,3050,9533
5.715e+05,2014,153,3,1,1300,6710,1,0,0,4,6,1300,0,1952,1952,98040,47.585,122.24,1630,9946,62,0,4,2930,11246
9.99e+05,2014,166,4,2.75,2800,19168,2,0,0,3,10,2800,0,1992,1992,98075,47.591,122.04,2010,16020,22,0,6.75,4810,18820
3.37e+05,2014,303,4,2.5,3200,5772,2,0,0,3,8,3200,0,2003,2003,98042,47.349,122.15,3010,5772,11,0,6.5,6210,8972
6.05e+05,2015,464,5,3.5,3060,8862,2,0,0,3,8,3060,0,1989,1989,98056,47.532,122.19,2680,8398,26,0,8.5,5740,11458
5.77e+05,2014,163,3,1.75,1760,12874,1,0,0,4,7,1230,530,1967,1967,98005,47.591,122.17,1950,10240,47,0,4.75,3710,12000
3.65e+05,2015,487,3,2.25,1960,1985,2,0,0,3,7,1750,210,2003,2003,98118,47.542,122.29,1760,1985,12,0,5.25,3720,3945
2.55e+05,2014,236,2,1,1610,19965,1,0,0,3,7,1610,0,1952,1952,98168,47.51,122.31,2100,28400,62,0,3,3710,30010
1.085e+06,2014,135,4,3.25,3740,12080,1,0,0,3,10,2000,1740,1988,1988,98077,47.721,122.06,4210,15277,26,0,7.25,7950,19017
5.02e+05,2015,478,4,1.5,1700,8400,1,0,0,3,7,1700,0,1953,1953,98177,47.768,122.36,1750,8475,62,0,5.5,3450,10175
4.5e+05,2014,175,3,1.5,2330,11740,1,0,0,3,8,1330,1000,1954,1954,98155,47.748,122.29,2630,11740,60,0,4.5,4960,14070
7e+05,2015,392,6,3,2790,4550,2,0,0,4,8,2790,0,1907,1907,98119,47.627,122.36,2590,4550,108,0,9,5380,7340
2.51e+05,2014,271,4,2,1650,5974,1,0,0,5,7,860,790,1972,1972,98178,47.501,122.26,1940,6001,42,0,6,3590,7651
3.12e+05,2014,129,4,2.25,1930,7452,1,0,0,3,7,1430,500,1984,1984,98031,47.41,122.19,1714,7200,30,0,6.25,3644,9130
6.261e+05,2014,334,4,2.5,2280,7219,2,0,0,4,8,2280,0,1987,1987,98029,47.572,122.02,2240,7471,27,0,6.5,4520,9751
5.7e+05,2014,292,4,3,1490,6766,1,0,1,5,7,1490,0,1915,1915,98136,47.545,122.38,1990,6526,99,0,7,3480,8016
6.08e+05,2015,366,4,3,2400,7680,1,0,0,3,7,1200,1200,1956,1956,98199,47.647,122.39,2670,6342,59,0,7,5070,8742
7.245e+05,2015,493,3,3.25,3240,4185,2,0,0,3,8,2770,470,2011,2011,98075,47.579,122.03,2660,4692,4,0,6.25,5900,7932
4.23e+05,2014,271,3,1,1830,13900,1,0,0,3,7,1830,0,1951,1951,98133,47.765,122.35,1840,10667,63,0,4,3670,12497
3.2e+05,2015,367,4,1.75,1710,10480,1,0,0,4,6,1710,0,1969,1969,98059,47.474,122.14,1750,10480,46,0,5.75,3460,12190
3.975e+05,2014,218,3,1,1030,10480,1,0,0,4,7,1030,0,1954,1954,98006,47.574,122.14,1480,12200,60,0,4,2510,13230
1.73e+06,2014,326,4,3.5,4440,20668,2,0,2,5,10,3240,1200,1965,1965,98040,47.547,122.23,4240,18650,49,0,7.5,8680,23090
5.602e+05,2014,161,3,2.5,1990,3984,2,0,0,3,8,1990,0,2004,2004,98075,47.591,122.02,2320,3984,10,0,5.5,4310,5974
2.475e+05,2014,356,4,2,2460,5921,1,0,0,4,7,1230,1230,1948,1948,98002,47.308,122.21,1260,6648,66,0,6,3720,9108
3.9645e+05,2014,141,3,1.75,1540,12446,1,0,0,5,8,1540,0,1967,1967,98027,47.517,122.03,1330,11508,47,0,4.75,2870,13048
6.8e+05,2014,149,3,2.25,2330,4000,1,0,2,5,7,1520,810,1927,1927,98115,47.673,122.29,1870,4000,87,0,5.25,4200,6330
2.1e+05,2014,324,2,1,970,8874,1,0,0,3,7,970,0,1968,1968,98056,47.494,122.18,1340,8175,46,0,3,2310,9145
5e+05,2014,255,3,1.75,2420,65501,2,0,1,3,8,2420,0,1984,1984,98074,47.653,122.09,2970,19036,30,0,4.75,5390,21456
7.8e+05,2014,202,4,2.5,2270,13449,1,0,0,4,9,1310,960,1975,1975,98040,47.542,122.23,2810,13475,39,0,6.5,5080,15745
1.95e+05,2014,319,2,1,800,5280,1,0,0,5,6,800,0,1918,1918,98022,47.205,122,1240,7670,96,0,3,2040,8470
6.25e+05,2014,195,4,2.5,2570,5520,2,0,0,3,9,2570,0,2000,2000,98074,47.614,122.03,2470,5669,14,0,6.5,5040,8239
8.7e+05,2014,187,4,3,3040,36246,1,0,0,3,9,2680,360,1923,2014,98074,47.609,122.07,3520,13178,91,1,7,6560,16218
5.1e+05,2015,408,3,2,1680,8080,1,0,0,3,8,1680,0,1987,1987,98074,47.617,122.05,1800,7503,28,0,5,3480,9183
3.129e+05,2014,147,4,2.5,1630,4473,2,0,0,3,7,1630,0,2003,2003,98038,47.355,122.02,1830,5082,11,0,6.5,3460,6712
5e+05,2014,345,3,1.5,1680,17409,1,0,0,3,7,1680,0,1962,1962,98033,47.677,122.18,1680,9101,52,0,4.5,3360,10781
2.6495e+05,2015,425,3,1.5,1470,11599,1,0,0,3,7,1070,400,1967,1967,98030,47.363,122.19,1580,9760,48,0,4.5,3050,11230
3.2e+05,2015,382,3,1.5,1400,9087,1,0,0,3,7,1400,0,1954,1954,98133,47.771,122.34,1490,8380,61,0,4.5,2890,9780
5.47e+05,2014,167,4,1,1720,2800,1,0,0,4,7,1200,520,1926,1926,98115,47.674,122.3,1530,3500,88,0,5,3250,5220
8.5e+05,2014,269,4,2.5,3180,11652,2,0,1,3,9,3180,0,1977,1977,98040,47.567,122.21,3110,15183,37,0,6.5,6290,18363
4.88e+05,2014,147,3,2.5,1590,2550,3,0,0,3,7,1590,0,1985,1985,98117,47.677,122.39,1260,5100,29,0,5.5,2850,6690
4.45e+05,2014,162,5,1.75,2460,6846,1,0,0,5,7,1340,1120,1911,1911,98108,47.544,122.32,1410,4800,103,0,6.75,3870,7260
2.99e+05,2015,409,3,2.25,1350,3582,2,0,0,3,8,1350,0,2010,2010,98031,47.421,122.19,1940,3860,5,0,5.25,3290,5210
6.85e+05,2014,264,3,1.75,1650,8400,1,0,0,3,8,1470,180,1959,1959,98040,47.577,122.24,2020,7777,55,0,4.75,3670,9427
1.6e+05,2014,211,3,1.75,1610,7392,1,0,0,4,7,1610,0,1964,1964,98001,47.341,122.28,1450,7392,50,0,4.75,3060,9002
2.95e+05,2014,189,2,1,800,6500,1,0,0,4,6,800,0,1953,1953,98133,47.762,122.36,1220,7000,61,0,3,2020,7800
2.025e+05,2014,352,3,2,1540,8316,1,0,0,5,6,1540,0,1954,1954,98002,47.323,122.22,1250,8316,60,0,5,2790,9856
4.9e+05,2014,301,4,2.5,2650,9627,1,0,3,4,8,1610,1040,1976,1976,98028,47.768,122.25,2650,9221,38,0,6.5,5300,11871
4.55e+05,2014,188,4,3.5,3440,6000,2,0,0,4,8,3440,0,2002,2002,98198,47.408,122.33,1660,7800,12,0,7.5,5100,11240
9.5e+05,2014,224,4,2.5,2790,15653,2,0,0,4,10,2790,0,1964,1964,98040,47.548,122.22,3520,15653,50,0,6.5,6310,18443
1.9995e+05,2015,453,3,1,840,9480,1,0,0,3,6,840,0,1960,1960,98023,47.328,122.34,840,9420,55,0,4,1680,10260
1.899e+06,2014,251,2,2.75,3690,32044,2,1,4,3,12,3690,0,1989,1989,98166,47.449,122.37,2310,26988,25,0,4.75,6000,30678
6.2e+05,2014,312,4,1.75,2350,18800,1,0,2,3,8,2350,0,1959,1959,98005,47.59,122.18,3050,14640,55,0,5.75,5400,16990
4.59e+05,2014,286,4,1.75,2260,9703,1,0,0,2,8,1660,600,1978,1978,98052,47.662,122.14,2390,8455,36,0,5.75,4650,10715
2.1368e+05,2014,205,3,2.25,1560,6013,2,0,0,3,7,1560,0,1990,1990,98023,47.286,122.35,1640,6290,24,0,5.25,3200,7850
3.6e+05,2015,443,3,1.75,1900,11407,1,0,0,3,8,1900,0,1963,1963,98155,47.745,122.29,1710,11407,52,0,4.75,3610,13307
2.6e+05,2015,485,3,1,1200,6615,1,0,0,4,7,1200,0,1954,1954,98106,47.517,122.35,1230,6615,61,0,4,2430,7815
8.19e+05,2014,174,3,3.5,2130,6150,2,0,2,5,8,1530,600,1908,1908,98199,47.649,122.41,2040,5381,106,0,6.5,4170,7511
4.84e+05,2015,386,4,1.75,2440,16730,1,0,0,3,7,1390,1050,1976,1976,98072,47.741,122.11,1390,11600,39,0,5.75,3830,14040
4.15e+05,2014,156,3,1.75,1910,12596,1,0,0,3,7,1340,570,1977,1977,98072,47.74,122.1,1550,13310,37,0,4.75,3460,15220
2.295e+05,2014,187,3,1,1230,6000,1,0,0,4,7,1230,0,1967,1967,98002,47.326,122.21,1240,6000,47,0,4,2470,7230
7.92e+05,2015,475,3,2.5,2250,19270,2,0,0,3,8,2250,0,1999,1999,98074,47.657,122.09,2940,19541,16,0,5.5,5190,21791
4.45e+05,2014,307,4,3.25,3450,5000,2,0,0,3,8,3450,0,2008,2008,98178,47.492,122.27,1420,5000,6,0,7.25,4870,8450
2.7995e+05,2014,279,3,1.75,1930,7267,1,0,0,4,7,1330,600,1977,1977,98002,47.322,122.2,1600,7698,37,0,4.75,3530,9628
3.7495e+05,2015,382,4,1.75,1660,8160,1,0,0,3,8,1660,0,1974,1974,98058,47.448,122.13,1800,7684,41,0,5.75,3460,9344
2.095e+06,2014,139,5,3.75,5340,10655,2,0,3,4,10,3740,1600,1912,1912,98144,47.58,122.28,3910,9418,102,0,8.75,9250,14758
6.7894e+05,2014,339,5,2.25,2610,4080,2,0,0,5,7,1750,860,1909,1909,98115,47.676,122.31,2160,4080,105,0,7.25,4770,6690
5.08e+05,2014,284,4,2.25,3320,53392,2,0,0,4,8,2000,1320,1986,1986,98027,47.472,122.01,3230,43129,28,0,6.25,6550,46449
5.5e+05,2014,338,4,2.5,2850,6809,2,0,0,3,9,2850,0,2003,2003,98019,47.735,121.97,2820,7500,11,0,6.5,5670,10350
2.15e+05,2014,326,3,1.75,1280,10016,1,0,0,4,7,1280,0,1975,1975,98003,47.282,122.33,1670,9764,39,0,4.75,2950,11044
9.4e+05,2015,433,4,2.75,3770,24897,2,0,2,4,8,2550,1220,1964,1964,98075,47.582,122.08,2640,11502,51,0,6.75,6410,15272
2.84e+05,2014,237,3,1.75,1430,4850,1,0,0,3,7,930,500,1978,1978,98108,47.547,122.3,1430,4850,36,0,4.75,2860,6280
1.149e+06,2014,310,4,3.75,3180,9889,2,0,0,3,9,2500,680,2012,2012,98033,47.685,122.2,2910,8558,2,0,7.75,6090,11738
2.005e+06,2014,154,6,4.5,3810,28176,1,0,4,5,10,3810,0,1969,1969,98177,47.761,122.38,3810,26400,45,0,10.5,7620,30210
2.5e+05,2015,470,3,1.5,2390,23522,1,0,0,2,7,1890,500,1938,1968,98059,47.475,122.09,2430,23958,77,1,4.5,4820,26348
2.799e+05,2014,307,3,1,1400,10800,1,0,0,3,6,1400,0,1962,1962,98034,47.719,122.2,1430,10000,52,0,4,2830,11400
3.51e+05,2014,196,3,1,1160,10518,1,0,0,3,7,1160,0,1960,1960,98028,47.734,122.22,1670,9380,54,0,4,2830,10540
5.4e+05,2015,449,3,2.5,2600,23361,1,1,4,3,8,2150,450,1912,1912,98146,47.5,122.38,1700,14700,103,0,5.5,4300,17300
8.685e+05,2014,255,5,2.5,2490,9639,1,0,0,4,8,1610,880,1959,1959,98040,47.551,122.22,2290,9958,55,0,7.5,4780,12448
2.3e+05,2014,298,4,1.5,1050,9516,1,0,0,4,7,1050,0,1969,1969,98031,47.415,122.18,1390,9600,45,0,5.5,2440,10650
3.75e+05,2014,317,3,1,1040,9800,1,0,0,4,7,1040,0,1955,1955,98006,47.577,122.16,1280,8880,59,0,4,2320,9920
4.19e+05,2014,239,3,2.25,1700,7650,1,0,0,4,7,1340,360,1975,1975,98034,47.721,122.17,1980,7200,39,0,5.25,3680,8900
3.4077e+05,2014,349,3,1.5,1510,11200,1,0,0,4,8,1510,0,1960,1960,98003,47.335,122.33,2110,12070,54,0,4.5,3620,13580
4.2e+05,2014,334,3,1.75,1720,5000,1,0,0,3,8,1720,0,1932,2009,98019,47.738,121.98,1410,8300,82,1,4.75,3130,10020
2.685e+05,2014,222,4,1.75,1670,8000,1,0,0,4,8,1670,0,1974,1974,98023,47.319,122.38,1720,8000,40,0,5.75,3390,9670
2.5e+05,2014,313,4,1,1440,7404,1,0,0,3,6,1080,360,1918,1918,98126,47.533,122.38,1620,7436,96,0,5,3060,8876
4.5e+05,2015,473,2,1.5,1450,2550,1,0,0,3,7,820,630,1984,1984,98103,47.691,122.35,1450,5100,31,0,3.5,2900,6550
7.5e+05,2014,273,4,2.5,2850,12429,2,0,0,3,9,2850,0,2008,2008,98033,47.691,122.18,2540,12000,6,0,6.5,5390,14850
9.2e+05,2014,209,3,3.25,3660,66211,2,0,0,3,10,3660,0,2003,2003,98038,47.409,122.06,3660,1.0715e+05,11,0,6.25,7320,1.1081e+05
4.53e+05,2014,211,3,2.5,1510,1618,2,0,0,3,8,1330,180,2011,2011,98199,47.651,122.38,1350,1397,3,0,5.5,2860,2907
7.8e+05,2015,382,3,2.5,2610,7567,2,0,0,3,9,2610,0,1997,1997,98052,47.665,122.14,2610,8458,18,0,5.5,5220,11068
2.1e+05,2014,245,3,1.5,1250,9484,1,0,0,4,7,1250,0,1969,1969,98042,47.367,122.15,1320,9600,45,0,4.5,2570,10850
8e+05,2014,317,4,1.75,2150,9148,1,0,0,4,7,2150,0,1955,1955,98004,47.583,122.2,2370,9148,59,0,5.75,4520,11298
3.72e+05,2014,335,4,1.5,1780,7914,1,0,0,4,7,1780,0,1962,1962,98059,47.514,122.16,1350,8069,52,0,5.5,3130,9849
2.1e+05,2014,169,3,2,1440,7210,1,0,0,3,8,1440,0,1983,1983,98092,47.313,122.18,1700,7245,31,0,5,3140,8685
6.89e+05,2014,291,3,2.5,2080,9612,1,0,3,4,8,1700,380,1940,1940,98125,47.729,122.28,2560,10202,74,0,5.5,4640,12282
2.4e+06,2014,170,6,4.5,5480,10800,2,0,3,4,9,4430,1050,1999,1999,98119,47.631,122.37,2970,7200,15,0,10.5,8450,12680
5.5e+05,2014,143,3,2,1830,9152,1,0,0,5,8,1830,0,1959,1959,98006,47.553,122.18,1770,9220,55,0,5,3600,11050
6.16e+05,2014,167,4,2.5,2490,12929,2,0,0,3,9,2490,0,1983,1983,98074,47.616,122.02,2440,12929,31,0,6.5,4930,15419
3.15e+05,2014,333,3,1.75,1900,7076,1,0,0,3,7,1130,770,1977,1977,98155,47.757,122.33,1540,10113,37,0,4.75,3440,12013
5.775e+05,2015,452,2,2.5,2330,3000,2,0,3,3,8,2330,0,1915,1994,98144,47.595,122.29,1760,4000,100,1,4.5,4090,6330
2.1e+05,2014,125,5,2,2050,10200,1,0,0,3,6,1430,620,1956,1956,98198,47.414,122.33,1940,8625,58,0,7,3990,10675
5.895e+05,2015,489,4,1.5,1440,3200,1,0,1,4,7,960,480,1960,1960,98136,47.527,122.38,1650,6400,55,0,5.5,3090,7840
3.91e+05,2014,203,2,1,890,5423,1,0,0,3,6,890,0,1946,1946,98117,47.697,122.37,1690,5993,68,0,3,2580,6883
2.9e+05,2015,424,3,2.5,2020,4861,2,0,0,3,7,2020,0,2005,2005,98058,47.466,122.14,2170,4600,10,0,5.5,4190,6620
2.75e+05,2015,402,3,1,1250,10744,1,0,0,3,6,1250,0,1942,1942,98198,47.423,122.33,1500,10710,73,0,4,2750,11960
1.822e+05,2014,291,4,1,1130,13927,1,0,0,3,6,1130,0,1929,1929,98168,47.494,122.3,1800,8274,85,0,5,2930,9404
4e+05,2014,245,6,3,3320,15600,1,0,0,4,8,1660,1660,1977,1977,98092,47.298,122.17,2330,15360,37,0,9,5650,18680
4.45e+05,2015,367,2,1.75,1440,4660,1,0,2,3,8,1440,0,2008,2008,98053,47.709,122.02,1680,4989,7,0,3.75,3120,6429
1.7995e+05,2014,312,3,1,920,4875,1,0,0,5,6,920,0,1969,1969,98042,47.365,122.08,960,5200,45,0,4,1880,6120
2.405e+05,2015,431,2,1,1240,12092,1,0,0,3,6,960,280,1922,1984,98146,47.496,122.35,1820,7460,93,1,3,3060,8700
4.99e+05,2014,345,2,1,1450,3090,2,0,0,3,7,1450,0,1919,1987,98103,47.685,122.36,1450,4635,95,1,3,2900,6085
2.765e+05,2015,436,4,1.75,1400,6650,1,0,0,4,6,1400,0,1942,1942,98168,47.489,122.33,1120,8645,73,0,5.75,2520,10045
4.02e+05,2014,179,4,2.75,2950,15540,1,0,0,4,8,2120,830,1974,1974,98042,47.385,122.15,2840,17136,40,0,6.75,5790,20086
9.3e+05,2014,286,3,2.25,2890,5000,3,0,0,3,9,2890,0,2014,2014,98117,47.698,122.39,2020,5000,0,0,5.25,4910,7890
3e+05,2014,125,3,2,1050,10072,1,0,0,3,7,1050,0,1986,1986,98019,47.734,121.98,1130,10087,28,0,5,2180,11137
2.4e+05,2014,203,3,1.75,1260,7362,1,0,0,3,7,1260,0,1984,1984,98038,47.36,122.05,1530,7232,30,0,4.75,2790,8492
3.49e+05,2014,298,4,2.5,1800,7620,2,0,0,3,8,1800,0,1995,1995,98055,47.435,122.2,1800,6879,19,0,6.5,3600,8679
2.1e+05,2014,201,3,1.5,1920,61014,1,0,0,3,6,1920,0,1953,1953,98038,47.445,122.07,1616,61014,61,0,4.5,3536,62934
2.12e+05,2014,237,3,1.5,1060,9225,1,0,0,4,7,1060,0,1955,1955,98003,47.322,122.32,1270,9375,59,0,4.5,2330,10435
4.345e+05,2014,255,3,1.75,1930,7210,1,0,0,3,7,1110,820,1975,1975,98072,47.735,122.17,1870,7877,39,0,4.75,3800,9807
9.875e+05,2015,368,4,2.25,3270,15760,1,0,0,4,10,2000,1270,1974,1974,98040,47.529,122.23,4100,15760,41,0,6.25,7370,19030
2.4e+05,2014,285,3,1,1350,7560,1,0,0,4,7,950,400,1959,1959,98032,47.378,122.3,1470,7560,55,0,4,2820,8910
2.6425e+05,2014,250,3,1,1420,7420,1,0,0,3,6,1420,0,1944,1944,98178,47.495,122.24,1290,6600,70,0,4,2710,8020
4.505e+05,2015,460,2,1,1330,3698,1,0,0,3,7,1330,0,1952,1952,98117,47.687,122.37,1900,5000,63,0,3,3230,6330
9.4e+05,2015,400,3,1,1220,8119,1,0,0,4,7,1220,0,1955,1955,98039,47.633,122.24,1910,8119,60,0,4,3130,9339
1.3625e+06,2014,279,3,2,2310,21318,1,0,0,3,10,2310,0,1979,1996,98004,47.638,122.22,2950,21814,35,1,5,5260,24124
5.43e+05,2014,169,3,2.25,1240,949,3,0,0,3,8,1240,0,2008,2008,98103,47.649,122.33,1310,1140,6,0,5.25,2550,2380
1.815e+06,2014,169,5,3,3880,13000,2,0,0,3,10,3880,0,1972,2003,98040,47.547,122.23,3470,13701,42,1,8,7350,17581
4.23e+05,2014,209,4,2.5,2320,4254,2,0,0,3,8,2320,0,2004,2004,98059,47.48,122.14,2330,4602,10,0,6.5,4650,6922
6.28e+05,2015,459,4,1.75,1940,3060,1,0,0,4,7,1000,940,1911,1911,98115,47.679,122.32,1320,3060,104,0,5.75,3260,5000
4e+05,2014,299,2,1,1140,1.0153e+05,1,0,0,3,6,1140,0,1932,1932,98092,47.259,122.23,1580,1.0153e+05,82,0,3,2720,1.0267e+05
7e+05,2014,242,4,3.5,3150,6175,2,0,0,3,9,3150,0,2001,2001,98075,47.597,122.02,3150,6986,13,0,7.5,6300,10136
1.22e+06,2014,266,4,2,3090,8125,2,0,0,5,8,3090,0,1918,1918,98117,47.685,122.39,1560,6250,96,0,6,4650,9340
4e+05,2014,334,4,2,2070,10800,2,0,0,3,7,2070,0,1982,1982,98011,47.726,122.24,1880,10800,32,0,6,3950,12870
4.8e+05,2014,182,5,2.5,2160,7737,2,0,0,3,7,2160,0,1998,1998,98065,47.538,121.87,2460,7737,16,0,7.5,4620,9897
1.9e+05,2014,211,3,1.75,1350,7370,1,0,0,4,6,1350,0,1912,1912,98118,47.534,122.28,1440,6000,102,0,4.75,2790,7350
2.71e+05,2014,347,4,1.75,1710,7200,1,0,0,5,7,910,800,1975,1975,98031,47.397,122.17,1730,7200,39,0,5.75,3440,8910
7.99e+05,2014,163,3,2.5,2860,4442,2,0,0,3,8,2860,0,2000,2000,98199,47.661,122.4,1440,4400,14,0,5.5,4300,7260
6.4e+05,2014,167,3,2,1380,4800,1,0,0,3,7,1380,0,1948,1948,98199,47.651,122.37,1740,5640,66,0,5,3120,7020
2.75e+05,2014,258,4,1,1340,22500,1,0,0,3,7,1340,0,1926,1926,98168,47.489,122.32,1620,10800,88,0,5,2960,12140
2.6995e+05,2014,345,4,3,2390,7309,2,0,0,4,7,2390,0,1944,1981,98002,47.294,122.22,930,7308,70,1,7,3320,9698
3.9e+05,2014,264,3,2,1710,8910,1,0,0,5,7,1710,0,1953,1953,98133,47.772,122.34,1430,8493,61,0,5,3140,10203
6.73e+05,2015,446,4,2.5,2990,10400,2,0,0,3,9,2990,0,2002,2002,98166,47.451,122.36,2140,17449,13,0,6.5,5130,20439
5.3825e+05,2014,187,3,2.25,2590,15229,2,0,3,3,8,2590,0,1984,1984,98198,47.395,122.33,2590,15229,30,0,5.25,5180,17819
2.3495e+05,2014,129,3,1,1360,9948,1,0,0,3,6,1360,0,1977,1977,98010,47.342,122.05,1670,8475,37,0,4,3030,9835
6.315e+05,2014,174,2,1,1130,2640,1,0,0,4,8,1130,0,1927,1927,98109,47.644,122.36,1680,3200,87,0,3,2810,4330
8.4e+05,2014,221,3,2.5,3050,33920,1,0,0,3,8,3050,0,2004,2004,98052,47.703,122.07,1970,60984,10,0,5.5,5020,64034
5.72e+05,2014,208,3,2.5,2360,9938,1,0,0,3,8,1690,670,1987,1987,98027,47.537,122.05,2280,9626,27,0,5.5,4640,11986
9.76e+05,2014,235,4,1.5,3120,7680,1,0,3,3,8,1660,1460,1956,1956,98199,47.646,122.39,2900,7680,58,0,5.5,6020,10800
3.96e+05,2015,488,3,2.25,1680,9766,2,0,0,3,7,1680,0,1989,1989,98019,47.734,121.98,1590,9757,26,0,5.25,3270,11437
7.75e+05,2015,452,3,1,2030,4080,1,0,0,4,7,1840,190,1908,1908,98115,47.676,122.31,2030,4080,107,0,4,4060,6110
2.5e+05,2015,402,3,1.75,1200,5478,1,0,0,5,6,1200,0,1955,1955,98056,47.496,122.17,1270,6855,60,0,4.75,2470,8055
4e+05,2014,264,3,1.5,2390,32109,1,0,0,3,7,2390,0,1975,2007,98092,47.303,122.1,1370,32109,39,1,4.5,3760,34499
5.365e+05,2015,478,2,2,1360,1860,1,0,0,4,7,680,680,1925,1925,98107,47.673,122.4,1440,5000,90,0,4,2800,6360
2.78e+05,2015,376,2,2.25,1610,1968,2,0,0,4,7,1610,0,1979,1979,98056,47.518,122.2,1950,1968,36,0,4.25,3560,3578
8.15e+05,2015,450,4,2.5,3030,7187,2,0,0,3,9,3030,0,2005,2005,98033,47.693,122.17,3030,7187,10,0,6.5,6060,10217
2.79e+05,2014,194,3,1.75,1430,39160,1,0,0,3,7,900,530,1925,1987,98065,47.551,121.8,1430,40860,89,1,4.75,2860,42290
3.02e+05,2015,402,2,1,1010,6000,1,0,0,4,6,1010,0,1944,1944,98133,47.771,122.35,1610,7313,71,0,3,2620,8323
9.5e+05,2014,196,5,3.25,2700,3650,2,0,2,3,9,2070,630,1926,2014,98144,47.596,122.29,1940,4000,88,1,8.25,4640,6700
4.95e+05,2014,173,3,2,2950,12196,2,0,0,4,7,2310,640,1918,1918,98166,47.47,122.36,2320,19844,96,0,5,5270,22794
7.99e+05,2014,331,4,3.5,3290,20107,2,0,4,3,10,2220,1070,1990,1990,98198,47.355,122.32,2990,16988,24,0,7.5,6280,20278
1.1e+06,2015,484,4,2.5,2190,6300,1,0,3,3,7,1240,950,1960,1960,98033,47.692,122.22,2730,14659,55,0,6.5,4920,16849
7.5e+05,2014,225,3,1.75,2280,7800,1,0,3,4,8,1360,920,1941,1941,98117,47.699,122.39,2280,5200,73,0,4.75,4560,7480
3e+05,2015,413,3,2.25,1350,1234,2,0,0,3,7,1160,190,2007,2007,98106,47.556,122.36,1420,1234,8,0,5.25,2770,2584
2.55e+05,2015,488,3,1,1010,7690,1,0,0,4,6,1010,0,1958,1958,98058,47.45,122.18,1010,7619,57,0,4,2020,8629
5e+05,2015,473,3,3.5,2150,4368,2,0,0,3,8,1610,540,1998,1998,98074,47.621,122.06,2390,16630,17,0,6.5,4540,18780
5.8e+05,2014,258,3,1.5,1860,7190,2,0,1,5,7,1860,0,1952,1952,98177,47.772,122.39,1670,5525,62,0,4.5,3530,7385
3.24e+05,2014,335,3,1,1160,7202,1,0,0,4,7,1160,0,1957,1957,98133,47.767,122.33,1620,8598,57,0,4,2780,9758
2.61e+05,2014,333,4,1.5,2040,10488,1,0,0,3,7,1190,850,1961,1961,98188,47.456,122.27,1960,10488,53,0,5.5,4000,12528
4.15e+05,2014,270,4,2.5,2891,6499,2,0,0,3,9,2891,0,2014,2014,98001,47.336,122.26,2550,8383,0,0,6.5,5441,11274
2.08e+05,2015,447,2,1,1160,5750,1,0,0,4,6,1160,0,1924,1924,98065,47.532,121.83,1160,8250,91,0,3,2320,9410
5.34e+05,2014,320,5,2,2280,3600,2,0,0,3,7,2280,0,1992,1992,98122,47.606,122.31,1740,1800,22,0,7,4020,4080
2.91e+05,2014,195,3,1,1280,10500,1,0,0,4,5,1280,0,1941,1941,98024,47.566,121.89,1410,10500,73,0,4,2690,11780
3.4981e+05,2014,180,3,1,960,8855,1,0,0,4,7,960,0,1958,1958,98155,47.769,122.33,1250,8855,56,0,4,2210,9815
7.91e+05,2015,440,5,1.75,2344,4800,1,0,0,4,7,1544,800,1921,1921,98103,47.654,122.33,1770,4200,94,0,6.75,4114,6544
2.46e+05,2015,410,3,1.5,1630,10200,1,0,0,4,8,1300,330,1976,1976,98023,47.316,122.36,1960,6700,39,0,4.5,3590,8330
6.91e+05,2014,262,2,2,1780,3810,1,0,0,3,7,980,800,1922,1922,98119,47.647,122.36,1690,3810,92,0,4,3470,5590
4.5e+05,2015,447,2,2.75,2810,11205,1,0,0,3,7,1510,1300,1968,1968,98178,47.487,122.24,2520,13000,47,0,4.75,5330,15810
7.57e+05,2014,133,3,3.25,3190,5283,2,0,0,3,9,3190,0,2007,2007,98029,47.553,122,2950,5198,7,0,6.25,6140,8388
4.41e+05,2015,447,2,1,1290,1289,2,0,0,3,7,1030,260,2005,2005,98144,47.601,122.31,1290,1332,10,0,3,2580,2622
2.138e+05,2015,478,2,1,740,5200,1,0,0,4,5,740,0,1952,1952,98056,47.493,122.17,750,5200,63,0,3,1490,5940
4.25e+05,2014,310,5,2.5,2180,7875,1,0,0,4,7,1200,980,1955,1955,98133,47.754,122.34,1840,5105,59,0,7.5,4020,7285
2.92e+05,2014,338,3,1.75,1320,6600,1,0,0,3,7,1320,0,1988,1988,98168,47.484,122.33,1070,6594,26,0,4.75,2390,7914
4.62e+05,2014,143,3,1.75,1300,2580,1,0,0,5,7,820,480,1919,1919,98115,47.674,122.32,1180,2820,95,0,4.75,2480,4120
2.25e+05,2014,135,3,2,1400,7384,1,0,0,3,7,1150,250,1979,1979,98058,47.465,122.17,1820,7992,35,0,5,3220,9392
4.05e+05,2014,191,3,1.5,1600,7500,1,0,0,3,7,1600,0,1966,1966,98034,47.721,122.18,1700,7500,48,0,4.5,3300,9100
5.28e+05,2014,201,3,2.5,2020,5613,2,0,0,3,7,2020,0,2003,2003,98053,47.684,122.03,2020,4609,11,0,5.5,4040,6629
4.85e+05,2014,293,3,2.5,1650,4218,2,0,0,3,8,1650,0,2000,2000,98075,47.6,122.02,1650,4559,14,0,5.5,3300,6209
3.95e+05,2014,174,3,2.5,1600,1936,2,0,0,3,7,1600,0,2007,2007,98108,47.563,122.3,1600,1936,7,0,5.5,3200,3536
5.0255e+05,2014,263,3,1.75,1770,7875,1,0,0,4,7,1170,600,1958,1958,98008,47.606,122.13,1670,8000,56,0,4.75,3440,9770
2.55e+05,2015,472,3,1,1580,7560,1,0,0,4,7,1000,580,1976,1976,98001,47.332,122.28,1580,7560,39,0,4,3160,9140
3.43e+05,2014,155,4,2.5,2070,4500,2,0,0,3,7,2070,0,2004,2004,98038,47.35,122.03,2760,5173,10,0,6.5,4830,7243
1.95e+05,2014,345,3,1,1070,22489,1,0,0,3,7,1070,0,1967,1967,98001,47.328,122.26,1880,20250,47,0,4,2950,21320
1.16e+06,2015,452,4,3.75,3560,13959,2,0,0,4,9,3560,0,1972,1972,98040,47.557,122.21,3320,11834,43,0,7.75,6880,15394
3.915e+05,2014,319,3,2,1450,9132,1,0,0,3,7,1450,0,1987,1987,98034,47.729,122.23,1580,9104,27,0,5,3030,10554
4.25e+05,2014,272,2,1,1170,5000,1,0,0,4,7,1030,140,1920,1920,98136,47.545,122.39,1170,5850,94,0,3,2340,7020
2.79e+05,2015,483,3,1,1010,7903,1,0,0,3,6,1010,0,1948,1948,98155,47.766,122.32,1010,7903,67,0,4,2020,8913
6.4e+05,2014,321,4,2.5,2260,5172,2,0,0,3,9,2260,0,2004,2004,98052,47.705,122.13,2680,5172,10,0,6.5,4940,7432
3.99e+05,2014,238,3,3,1520,1884,3,0,0,3,8,1520,0,2009,2009,98125,47.718,122.28,1360,1939,5,0,6,2880,3459
6.5995e+05,2014,321,3,2.5,2990,9413,2,0,0,3,10,2990,0,2006,2006,98028,47.734,122.23,1940,9600,8,0,5.5,4930,12590
2.8631e+05,2014,207,2,1.5,1220,1036,3,0,0,3,7,1220,0,2006,2006,98133,47.735,122.35,1210,659,8,0,3.5,2430,1879
2.749e+05,2014,181,4,2.5,1970,6600,2,0,0,3,7,1970,0,1987,1987,98030,47.349,122.17,1970,7682,27,0,6.5,3940,9652
5.95e+05,2015,444,3,2.75,2150,31238,2,0,0,3,9,2150,0,1996,1996,98014,47.66,121.96,2650,38307,19,0,5.75,4800,40457
2.8e+05,2014,269,3,1.75,1670,6034,1,0,0,3,7,990,680,1957,1957,98118,47.521,122.29,1230,6034,57,0,4.75,2900,7704
4.535e+05,2014,154,5,2.5,2300,23345,1,0,0,5,7,1170,1130,1967,1967,98059,47.474,122.11,2280,23345,47,0,7.5,4580,25645
6.08e+05,2014,235,2,1,1390,3600,1,0,0,4,7,1010,380,1913,1913,98119,47.642,122.36,1590,3600,101,0,3,2980,4990
5e+05,2014,205,3,2.25,1420,983,3,0,0,3,8,1420,0,2006,2006,98103,47.653,122.35,1530,1280,8,0,5.25,2950,2700
8.98e+05,2014,238,3,2.5,3530,9753,2,0,0,3,10,3530,0,1997,1997,98006,47.554,122.1,3220,9234,17,0,5.5,6750,12764
5.4995e+05,2014,341,4,3.5,3090,10510,1,0,0,3,8,2190,900,1991,1991,98034,47.718,122.21,2200,7408,23,0,7.5,5290,10498
6.45e+05,2014,152,4,2.5,2430,14400,1,0,0,5,8,1670,760,1963,1963,98007,47.62,122.14,2140,9048,51,0,6.5,4570,11478
3.335e+05,2015,374,3,2.5,2196,7475,2,0,0,3,8,2196,0,2006,2006,98030,47.38,122.2,1860,6755,9,0,5.5,4056,8951
5.32e+05,2015,466,3,3.75,2260,2050,2,0,0,3,9,1170,1090,2010,2010,98118,47.566,122.29,2130,3082,5,0,6.75,4390,5342
3.7e+05,2015,431,2,1,850,6213,1,0,0,3,6,750,100,1916,1916,98136,47.528,122.38,1880,5500,99,0,3,2730,6350
4.3e+05,2014,167,3,2,1730,9000,1,0,0,3,8,1370,360,1978,1978,98027,47.52,122.05,2390,10000,36,0,5,4120,11730
2.15e+05,2014,335,2,1,1480,5325,1,0,0,4,7,1120,360,1925,1925,98022,47.208,121.99,1670,5800,89,0,3,3150,7280
6.57e+05,2014,175,4,2.5,2180,3375,1,0,0,4,7,1420,760,1926,1926,98117,47.685,122.36,1560,3375,88,0,6.5,3740,5555
2.55e+05,2014,180,2,1,1320,9967,1,0,0,3,6,940,380,1919,1919,98108,47.569,122.3,1970,7587,95,0,3,3290,8907
2.25e+05,2014,132,3,1,990,8012,1,0,0,4,7,990,0,1966,1966,98058,47.456,122.18,1260,9060,48,0,4,2250,10050
8.39e+05,2014,135,3,1,1230,12305,1,0,0,3,7,1230,0,1955,1990,98004,47.609,122.19,2100,7960,59,1,4,3330,9190
6.35e+05,2014,239,4,2.5,2470,77550,1,0,0,4,7,2470,0,1987,1987,98075,47.589,122.01,2490,40894,27,0,6.5,4960,43364
3.175e+05,2014,221,4,2.5,2150,9000,1,0,0,4,7,1360,790,1979,1979,98059,47.478,122.16,1620,8400,35,0,6.5,3770,10550
2.26e+05,2014,329,3,1,1520,7200,1,0,0,3,7,1030,490,1954,1954,98166,47.453,122.35,1530,7201,60,0,4,3050,8721
3.9495e+05,2015,417,2,2.25,1300,2104,2,0,0,3,8,1010,290,2011,2011,98136,47.548,122.39,1430,1850,4,0,4.25,2730,3150
4e+05,2014,281,1,1,1390,60984,1,0,0,3,6,1390,0,1960,1960,98019,47.765,121.9,1620,24225,54,0,2,3010,25615
2.65e+05,2014,273,3,1.5,1530,7500,1,0,0,3,7,1530,0,1986,1986,98038,47.364,122.06,2080,11250,28,0,4.5,3610,12780
6.399e+05,2015,452,4,2.5,3380,75794,2,0,0,3,10,3380,0,1997,1997,98001,47.351,122.27,3710,17913,18,0,6.5,7090,21293
6.7e+05,2015,487,4,2.25,2040,7031,2,0,0,3,8,2040,0,2012,2012,98033,47.702,122.17,1670,7031,3,0,6.25,3710,9071
6.41e+05,2014,195,2,1,1420,5332,1,0,0,3,8,1070,350,1953,1953,98105,47.669,122.28,2400,5406,61,0,3,3820,6826
4.5e+05,2014,201,3,2.25,2080,1.1151e+05,1,0,0,3,8,1680,400,1977,1977,98072,47.74,122.11,2440,1.0716e+05,37,0,5.25,4520,1.0924e+05
5.925e+05,2014,142,4,3,2170,8240,1,0,0,4,8,1370,800,1968,1968,98052,47.629,122.09,2020,7944,46,0,7,4190,10114
3.58e+05,2014,242,3,3.25,1410,1442,3,0,0,3,8,1360,50,2006,2006,98125,47.718,122.32,1500,1200,8,0,6.25,2910,2610
5.6e+05,2015,369,4,2.75,1950,6192,2,0,0,3,8,1950,0,1992,1992,98029,47.57,122,2040,5441,23,0,6.75,3990,7391
7.11e+05,2014,251,4,2.5,2095,4400,1,0,0,5,8,1295,800,1910,1910,98116,47.584,122.39,1980,4400,104,0,6.5,4075,6495
3.4e+05,2014,342,3,1,1450,9586,2,0,0,3,7,1450,0,1950,1950,98155,47.744,122.33,1500,8592,64,0,4,2950,10042
1.542e+05,2015,366,4,1,1310,8640,1,0,0,3,6,910,400,1948,1948,98146,47.51,122.34,1310,8640,67,0,5,2620,9950
5.15e+05,2015,464,3,2.75,1710,9448,1,0,0,3,7,1010,700,1947,1947,98105,47.669,122.27,1960,8951,68,0,5.75,3670,10661
3.05e+05,2014,152,3,1,950,13475,1,0,0,3,7,950,0,1950,1950,98155,47.754,122.31,1240,8910,64,0,4,2190,9860
3.9e+05,2014,297,4,1.75,2330,8364,1,0,0,4,8,2330,0,1968,1968,98058,47.457,122.15,2180,9630,46,0,5.75,4510,11960
4.5e+05,2014,211,4,1.75,1980,7350,1,0,0,3,7,1430,550,1973,1973,98034,47.709,122.2,1870,7920,41,0,5.75,3850,9900
2.48e+05,2014,129,4,3,2163,5883,2,0,0,3,7,2163,0,2006,2006,98001,47.273,122.25,1700,10143,8,0,7,3863,12306
1.14e+06,2014,249,4,1.75,3080,6500,1,0,0,4,9,1700,1380,1941,1941,98199,47.635,122.4,2960,5711,73,0,5.75,6040,8791
1.78e+05,2015,414,5,1.5,1990,18200,1,0,0,3,7,1990,0,1960,1960,98178,47.494,122.26,1860,8658,55,0,6.5,3850,10648
2.935e+05,2015,447,3,2.5,1610,5024,2,0,0,3,7,1610,0,2004,2004,98038,47.383,122.04,1790,3717,11,0,5.5,3400,5327
4.7495e+05,2015,431,4,1.75,2030,15400,1,0,1,3,9,1130,900,1975,1975,98166,47.46,122.36,2040,12425,40,0,5.75,4070,14455
7.4995e+05,2014,155,4,2.75,3110,35235,2,0,0,4,9,3110,0,1983,1983,98072,47.736,122.09,2790,35445,31,0,6.75,5900,38555
7.4e+05,2015,472,4,2,2800,8540,1,0,0,4,8,1730,1070,1977,1977,98052,47.687,122.13,2470,9400,38,0,6,5270,12200
4e+05,2014,174,3,2.5,2970,23100,1,0,0,3,7,1510,1460,1967,1967,98072,47.773,122.13,2390,20300,47,0,5.5,5360,23270
9.985e+05,2015,367,3,1.75,2140,4800,2,0,0,3,8,1690,450,1905,1905,98112,47.631,122.31,2440,4800,110,0,4.75,4580,6940
4.35e+05,2014,317,5,1,2170,65340,1,0,0,4,7,1670,500,1930,1930,98011,47.755,122.2,3170,12884,84,0,6,5340,15054
3.85e+05,2014,180,3,1.75,1300,7030,1,0,0,3,7,1300,0,1968,1968,98034,47.721,122.18,1450,7650,46,0,4.75,2750,8950
6.25e+05,2014,324,3,2.25,1970,4564,1,0,0,3,8,1470,500,1959,1959,98199,47.67,122.41,1980,5000,55,0,5.25,3950,6970
2.68e+05,2014,176,3,2.5,1650,6684,2,0,0,3,7,1650,0,1991,1991,98031,47.405,122.18,1850,7048,23,0,5.5,3500,8698
7.6e+05,2014,163,4,2.5,2420,10285,1,0,4,3,8,1700,720,1958,1958,98146,47.487,122.36,2540,9900,56,0,6.5,4960,12320
6.728e+05,2014,204,4,2.5,2740,10533,2,0,0,3,9,2740,0,1997,1997,98074,47.609,122.01,2760,8603,17,0,6.5,5500,11343
4.02e+05,2014,239,3,2.5,1520,3425,2,0,0,3,7,1520,0,1986,1986,98052,47.68,122.16,1640,3425,28,0,5.5,3160,4945
6.325e+05,2014,166,5,2.5,2640,7096,2,0,0,3,7,2640,0,2003,2003,98053,47.683,122.04,2640,4850,11,0,7.5,5280,7490
5.5e+05,2015,365,3,2.25,1950,26500,1,0,0,4,8,1570,380,1965,1965,98006,47.578,122.18,2160,12751,50,0,5.25,4110,14701
4.15e+05,2015,408,3,1.75,1790,15142,1,0,0,3,7,1360,430,1976,1976,98072,47.736,122.17,1910,7500,39,0,4.75,3700,9290
5.29e+05,2014,194,3,2.5,3070,22098,2,0,0,3,9,3070,0,1995,1995,98059,47.472,122.15,3070,21803,19,0,5.5,6140,24873
3.655e+05,2014,175,3,2,1410,9600,1,0,0,4,7,1410,0,1983,1983,98072,47.759,122.15,1410,9600,31,0,5,2820,11010
2.55e+05,2015,480,3,2,1290,13282,1,0,0,3,7,1290,0,1978,1978,98030,47.379,122.17,1290,12357,37,0,5,2580,13647
5.15e+05,2014,324,4,2.75,2700,5150,2,0,0,3,9,2700,0,2009,2009,98065,47.521,121.87,2700,5747,5,0,6.75,5400,8447
2.7e+05,2015,369,4,2,1830,5220,1,0,0,3,7,1830,0,1951,1951,98118,47.533,122.28,1760,5757,64,0,6,3590,7587
3.66e+05,2014,152,3,1.75,1510,8301,1,0,0,3,7,1510,0,1967,1967,98034,47.724,122.22,1460,7910,47,0,4.75,2970,9420
2.03e+05,2014,204,3,2.25,1630,9145,1,0,0,3,7,1630,0,1960,1960,98146,47.5,122.35,1630,9206,54,0,5.25,3260,10836
4.73e+05,2014,325,3,2.25,1620,12309,2,0,0,3,7,1620,0,1987,1987,98074,47.619,122.03,2030,13963,27,0,5.25,3650,15583
5e+05,2014,132,2,2.25,1290,1334,3,0,0,3,8,1290,0,2007,2007,98107,47.672,122.38,1350,1334,7,0,4.25,2640,2624
2.0995e+05,2015,451,2,1,1050,6250,1,0,0,4,6,840,210,1943,1943,98168,47.502,122.33,1310,12500,72,0,3,2360,13550
2.8345e+05,2014,331,5,2.75,2770,6116,1,0,0,3,7,1490,1280,1979,1979,98168,47.485,122.29,1920,6486,35,0,7.75,4690,9256
2.2e+05,2014,262,4,2.5,2130,9100,1,0,0,3,8,1290,840,1978,1978,98030,47.382,122.17,1770,7700,36,0,6.5,3900,9830
2.8095e+05,2014,129,3,1.75,1390,8700,1,0,3,4,7,840,550,1912,1912,98055,47.472,122.2,1390,10875,102,0,4.75,2780,12265
6.3e+05,2014,236,3,1,1360,13000,1,0,0,5,6,1360,0,1945,1945,98010,47.336,122.03,1890,19650,69,0,4,3250,21010
2.39e+05,2014,153,3,1,1040,6860,2,0,0,3,6,1040,0,1942,1942,98146,47.512,122.38,1030,6512,72,0,4,2070,7552
4.6e+05,2014,256,3,2,1860,7232,1,0,0,3,7,1320,540,1985,1985,98125,47.717,122.32,1830,7220,29,0,5,3690,9080
3.6e+05,2015,463,2,1,1120,12625,1,0,3,3,7,1120,0,1940,1940,98136,47.54,122.39,1880,6828,75,0,3,3000,7948
7.85e+05,2015,473,3,2.75,2310,5200,1,0,0,4,7,1520,790,1940,1940,98199,47.636,122.4,2310,5200,75,0,5.75,4620,7510
6.82e+05,2014,345,4,2.75,2820,8009,2,0,0,3,9,2820,0,2001,2001,98075,47.6,121.98,2820,7398,13,0,6.75,5640,10218
6.8e+05,2014,221,3,2.25,1820,8316,1,0,0,5,7,1320,500,1960,1960,98005,47.585,122.17,1780,8400,54,0,5.25,3600,10220
4.7995e+05,2014,342,2,2.25,1360,1336,3,0,0,3,8,1360,0,2008,2008,98107,47.671,122.39,1280,1295,6,0,4.25,2640,2655
3.5e+05,2014,191,4,2.5,2650,10459,2,0,0,4,8,2650,0,1989,1989,98003,47.274,122.29,2340,8777,25,0,6.5,4990,11427
5.85e+05,2014,271,3,2.5,1700,1156,2,0,2,3,9,1320,380,2002,2002,98119,47.637,122.37,1710,1686,12,0,5.5,3410,3386
2.9e+05,2014,279,3,1,1480,32700,1,0,0,4,6,1380,100,1942,1942,98168,47.495,122.33,1500,22600,72,0,4,2980,24080
4e+05,2014,152,3,2.5,1495,936,3,0,0,3,8,1405,90,2006,2006,98144,47.593,122.3,1495,1186,8,0,5.5,2990,2681
8.7e+05,2014,222,3,1.5,2420,5000,2,0,0,4,8,2200,220,1925,1925,98103,47.674,122.35,2070,5000,89,0,4.5,4490,7420
1.333e+06,2014,313,4,4.5,3130,5126,3,0,0,3,10,2450,680,2014,2014,98112,47.624,122.29,2540,7784,0,0,8.5,5670,10914
2.4e+05,2015,395,3,1.75,1630,9450,1,0,0,4,7,1080,550,1977,1977,98032,47.373,122.3,1280,9100,38,0,4.75,2910,10730
6.42e+05,2015,415,6,1,1530,4305,1,0,0,4,7,1530,0,1921,1921,98115,47.686,122.31,1530,3800,94,0,7,3060,5330
3.7e+05,2014,183,2,1,860,5040,1,0,0,3,7,860,0,1956,1956,98117,47.698,122.36,1570,5040,58,0,3,2430,5900
8.55e+05,2014,307,4,3.5,3460,7702,2,0,0,3,10,3460,0,2010,2010,98075,47.594,121.98,3380,7464,4,0,7.5,6840,10924
4.1e+05,2014,228,2,1,1480,4080,1,0,0,3,7,1050,430,1949,1949,98117,47.684,122.39,1310,4080,65,0,3,2790,5560
7.561e+05,2015,431,4,2,2000,8317,1,0,0,4,8,2000,0,1917,1917,98126,47.539,122.38,1390,6001,98,0,6,3390,8001
8.95e+05,2015,469,6,2.5,3550,6533,2,0,0,3,8,3550,0,1925,1925,98144,47.572,122.28,3140,6234,90,0,8.5,6690,9784
2.02e+05,2014,359,2,1,840,7200,1,0,0,4,5,840,0,1907,1907,98032,47.377,122.24,1030,7200,107,0,3,1870,8040
3.18e+05,2014,218,3,1,1010,7200,1,0,0,5,6,1010,0,1948,1948,98155,47.76,122.31,1590,7663,66,0,4,2600,8673
2.99e+05,2014,272,4,2.25,2050,26000,2,0,0,4,8,2050,0,1977,1977,98042,47.342,122.06,2330,31100,37,0,6.25,4380,33150
1.675e+05,2014,264,3,1,760,3090,1,0,0,2,5,760,0,1903,1903,98118,47.551,122.28,1020,5356,111,0,4,1780,6116
4.6405e+05,2014,286,2,1,780,2750,1,0,0,4,7,780,0,1928,1928,98116,47.584,122.39,1320,4440,86,0,3,2100,5220
5.02e+05,2014,201,3,1,1710,5000,1,0,0,5,7,1140,570,1921,1921,98116,47.572,122.39,1670,4000,93,0,4,3380,5710
3.05e+05,2014,346,2,2.25,1610,1968,2,0,0,5,7,1610,0,1979,1979,98056,47.518,122.2,1950,1968,35,0,4.25,3560,3578
6.685e+05,2014,152,4,2.5,2710,5500,2,0,0,3,9,2710,0,1999,1999,98074,47.603,122.02,2710,6242,15,0,6.5,5420,8952
1.59e+05,2014,228,3,1,1320,6534,1,0,0,3,7,1320,0,1952,1952,98055,47.481,122.22,2140,7405,62,0,4,3460,8725
2.25e+05,2014,331,4,2.5,1700,6031,2,0,0,3,8,1700,0,1994,1994,98030,47.358,122.19,1930,6035,20,0,6.5,3630,7735
5.15e+05,2015,438,4,2.25,2200,6967,2,0,0,3,8,2200,0,1986,1986,98011,47.736,122.2,1970,7439,29,0,6.25,4170,9639
6.25e+05,2014,134,4,2.75,1680,11180,1,0,0,4,7,1680,0,1966,1966,98052,47.656,122.13,2400,9627,48,0,6.75,4080,11307
4.25e+05,2014,256,3,3.25,1410,1350,3,0,0,3,8,1410,0,2005,2005,98103,47.698,122.34,1410,1253,9,0,6.25,2820,2663
6.515e+05,2014,346,4,1.5,1500,3075,2,0,0,5,7,1420,80,1929,1929,98103,47.689,122.35,1480,3774,85,0,5.5,2980,5274
3.45e+05,2014,333,2,1,1770,16660,1,0,3,3,8,1220,550,1957,1957,98023,47.335,122.35,2790,20504,57,0,3,4560,22274
2.61e+05,2015,383,4,1.75,1820,9824,1,0,0,5,7,1820,0,1968,1968,98042,47.383,122.09,1410,11013,47,0,5.75,3230,12833
6.08e+05,2014,175,4,2.5,2690,4736,2,0,0,3,7,2690,0,2001,2001,98053,47.687,122.04,2690,4791,13,0,6.5,5380,7481
2.835e+05,2015,366,4,2.5,1990,5577,2,0,0,3,7,1990,0,1999,1999,98092,47.319,122.19,2020,6400,16,0,6.5,4010,8390
2.07e+05,2015,417,3,1.75,1180,21275,1,0,0,4,6,1180,0,1958,1958,98038,47.402,122.04,1490,35100,57,0,4.75,2670,36280
6.95e+05,2014,149,3,2.5,2390,4555,2,0,0,3,9,2390,0,2006,2006,98074,47.62,122.03,2540,4500,8,0,5.5,4930,6890
3.18e+05,2014,243,3,2.25,1410,8909,2,0,2,3,7,1410,0,1988,1988,98198,47.398,122.31,2050,8909,26,0,5.25,3460,10319
1.92e+05,2014,132,2,1,700,10540,1,0,0,3,6,700,0,1953,1953,98166,47.438,122.34,890,10540,61,0,3,1590,11240
2.2e+05,2014,232,4,1.75,1660,11664,1,0,0,3,6,1010,650,1952,1952,98168,47.494,122.33,1670,9975,62,0,5.75,3330,11635
9.82e+05,2014,307,4,2.5,2790,10289,2,0,0,3,9,2790,0,1987,1987,98006,47.548,122.16,2650,10126,27,0,6.5,5440,12916
1.795e+06,2014,341,5,2.75,2880,20274,1,0,3,4,9,1660,1220,1959,1959,98004,47.627,122.22,3750,20220,55,0,7.75,6630,23100
2.3e+05,2014,176,3,1,1060,9946,1,0,0,4,7,1060,0,1956,1956,98188,47.443,122.28,1310,10619,58,0,4,2370,11679
3.755e+05,2014,356,4,2.5,2301,6452,2,0,0,3,9,2301,0,2010,2010,98001,47.346,122.27,2650,6054,4,0,6.5,4951,8355
3.85e+05,2014,342,4,3.25,1790,2460,2,0,0,4,7,1100,690,2000,2000,98106,47.534,122.35,1260,4040,14,0,7.25,3050,5830
1.25e+05,2014,264,2,1,810,8382,1,0,0,4,5,810,0,1942,1942,98146,47.503,122.36,1040,8382,72,0,3,1850,9192
3.05e+05,2015,415,3,1,1250,23680,1,0,0,5,7,1250,0,1967,1967,98059,47.475,122.11,1450,23680,48,0,4,2700,24930
2.68e+05,2014,153,3,1.75,1970,10270,1,0,0,4,8,1970,0,1966,1966,98032,47.362,122.28,1970,8400,48,0,4.75,3940,10370
2.7e+05,2014,278,4,2.5,2701,5821,2,0,0,3,7,2701,0,2013,2013,98092,47.287,122.18,2566,5843,1,0,6.5,5267,8544
8.35e+05,2015,479,3,1,3060,30166,1,0,0,5,8,3060,0,1959,1959,98027,47.566,122.09,1880,19602,56,0,4,4940,22662
4.23e+05,2014,293,3,1.75,1820,6038,1,0,0,4,7,1040,780,1952,1952,98126,47.523,122.38,1700,6040,62,0,4.75,3520,7860
3.82e+05,2015,464,3,2.25,1750,15528,1,0,0,3,8,1270,480,1963,1963,98155,47.774,122.27,2170,12000,52,0,5.25,3920,13750
4.9e+05,2014,338,4,2.25,2020,85813,2,0,0,3,7,2020,0,1995,1995,98027,47.483,122.03,2120,85813,19,0,6.25,4140,87833
4.32e+05,2015,457,3,1.75,1550,8134,1,0,0,4,7,1550,0,1959,1959,98008,47.614,122.12,1360,8000,56,0,4.75,2910,9550
3.5e+05,2015,464,3,2,1440,5469,1,0,0,3,8,1440,0,1988,1988,98029,47.575,122.02,1980,6198,27,0,5,3420,7638
3.75e+05,2014,300,3,2.5,1580,5725,2,0,0,3,7,1580,0,2004,2004,98072,47.761,122.16,1510,5725,10,0,5.5,3090,7305
3.55e+05,2015,451,5,2.75,2530,9375,1,0,0,5,7,1530,1000,1966,1966,98030,47.374,122.21,2250,8200,49,0,7.75,4780,10730
2.735e+05,2015,478,4,2.75,1300,9638,1,0,0,2,7,1300,0,1983,1983,98042,47.368,122.11,1670,9638,32,0,6.75,2970,10938
3.05e+05,2015,447,3,2.5,1690,5175,2,0,0,3,7,1690,0,2002,2002,98038,47.356,122.02,1830,5175,13,0,5.5,3520,6865
2.2e+05,2014,168,3,1,1130,12519,1,0,0,3,7,1130,0,1958,1958,98056,47.496,122.18,1460,12507,56,0,4,2590,13637
5.3e+05,2015,407,5,2.75,3230,13572,1,0,2,3,8,1880,1350,1965,1965,98166,47.439,122.35,2910,15292,50,0,7.75,6140,18522
4.25e+05,2014,170,3,2.5,2540,5612,2,0,0,3,9,2540,0,1999,1999,98059,47.496,122.16,2380,6303,15,0,5.5,4920,8843
5.25e+05,2014,230,4,2.75,2470,7200,1,0,0,5,7,1350,1120,1940,1940,98108,47.563,122.32,1500,6000,74,0,6.75,3970,8470
2.0995e+05,2014,202,3,1.75,1570,15570,1,0,0,3,7,1570,0,1981,1981,98023,47.321,122.36,2000,28200,33,0,4.75,3570,29770
5.365e+05,2014,129,4,1.75,2000,4000,1,0,0,5,7,1450,550,1926,1926,98126,47.566,122.38,1430,4000,88,0,5.75,3430,6000
3.35e+05,2014,204,2,1,1440,8842,1,0,0,3,7,840,600,1950,1950,98155,47.744,122.33,1650,8461,64,0,3,3090,9901
2.9e+05,2015,439,3,2,1310,6265,1,0,0,3,7,1310,0,1988,1988,98038,47.389,122.05,1100,6360,27,0,5,2410,7670
3.25e+05,2015,480,2,1,810,6827,1,0,0,3,6,810,0,1944,1944,98106,47.55,122.36,990,6827,71,0,3,1800,7637
2.3e+06,2014,229,4,3.25,4110,15929,2,1,4,3,12,2720,1390,2001,2001,98115,47.693,122.27,2640,15929,13,0,7.25,6750,20039
3.1e+05,2015,464,3,2.5,1670,4220,2,0,0,3,7,1670,0,2002,2002,98038,47.383,122.03,1670,4238,13,0,5.5,3340,5908
5e+05,2014,331,4,2.5,1900,5001,1,0,0,3,8,1200,700,2008,2008,98133,47.729,122.33,1950,4680,6,0,6.5,3850,6580
3.3e+05,2014,215,4,1.75,1550,50094,1,0,3,4,6,1550,0,1967,1967,98022,47.219,122.06,1720,50094,47,0,5.75,3270,51644
3.98e+05,2014,305,3,1.5,1310,2996,2,0,0,3,7,1310,0,1998,1998,98144,47.588,122.3,1310,2997,16,0,4.5,2620,4307
3.75e+05,2014,208,3,3.25,2760,6420,2,0,2,3,9,2110,650,1991,1991,98031,47.389,122.22,2030,7725,23,0,6.25,4790,10485
5.5e+05,2014,205,3,2.5,2340,4200,1,0,0,3,7,1540,800,1906,1906,98122,47.603,122.3,1590,4200,108,0,5.5,3930,6540
3.5e+05,2014,167,2,2.5,1260,1347,3,0,0,3,8,1260,0,2005,2005,98103,47.699,122.34,1260,1356,9,0,4.5,2520,2616
5.458e+05,2014,204,4,2.5,1980,4500,2,0,0,3,8,1980,0,1989,1989,98029,47.579,122,1770,4595,25,0,6.5,3750,6575
4.5e+05,2014,128,3,2,1510,43560,1,0,0,3,7,1510,0,1954,1954,98077,47.722,122.08,2060,67756,60,0,5,3570,69266
2.715e+05,2014,333,3,2.5,1490,8005,1,0,0,3,7,1090,400,1976,1976,98058,47.436,122.17,1880,7905,38,0,5.5,3370,9395
5.085e+05,2014,338,4,2.75,2520,12500,2,0,0,3,8,1720,800,1979,1979,98074,47.623,122.06,2520,13000,35,0,6.75,5040,15520
1.05e+06,2015,487,4,3.25,4020,11588,2,0,0,3,11,4020,0,2000,2000,98059,47.522,122.16,3190,8066,15,0,7.25,7210,12086
4.08e+05,2014,292,3,2.75,2670,4800,2,0,0,3,8,2670,0,2014,2014,98038,47.348,122.04,2340,5000,0,0,5.75,5010,7670
5.6989e+05,2015,388,4,2.5,2590,6474,2,0,0,3,8,2590,0,2014,2014,98056,47.516,122.19,1960,8679,1,0,6.5,4550,11269
3.26e+05,2015,432,2,1.5,1030,798,3,0,0,3,8,1030,0,2008,2008,98103,47.697,122.34,1020,1026,7,0,3.5,2050,2056
8.87e+05,2015,468,3,2,3000,22040,2,0,2,4,8,2470,530,1942,1942,98177,47.775,122.37,2600,7947,73,0,5,5600,10947
2.95e+05,2015,386,3,1.75,1930,13350,1,0,0,3,8,1930,0,1967,1967,98023,47.332,122.36,2270,13350,48,0,4.75,4200,15280
8.625e+05,2014,342,4,2.5,3220,4400,2,0,2,3,9,2180,1040,1937,1937,98199,47.633,122.39,3000,5000,77,0,6.5,6220,8220
1.339e+06,2014,291,4,3.75,2130,34689,1,1,4,3,9,2130,0,1955,1955,98136,47.549,122.4,3030,28598,59,0,7.75,5160,30728
2.56e+05,2015,394,3,1,1290,4720,1,0,0,3,6,790,500,1948,1948,98106,47.519,122.36,1110,4720,67,0,4,2400,6010
4.299e+05,2015,407,4,1.5,1820,17918,1,0,0,4,8,1190,630,1962,1962,98056,47.521,122.18,1890,15241,53,0,5.5,3710,17061
4.15e+05,2015,465,4,2,1780,12161,1,0,0,5,7,1160,620,1950,1950,98155,47.775,122.32,1780,8170,65,0,6,3560,9950
6.37e+05,2014,303,4,2.75,2850,7510,2,0,0,3,8,2850,0,2008,2008,98125,47.71,122.31,1510,8833,6,0,6.75,4360,11683
5.072e+05,2015,382,3,3.5,1630,1329,2,0,0,3,9,1360,270,2000,2000,98122,47.616,122.31,1580,1319,15,0,6.5,3210,2949
1.093e+06,2015,408,4,2.5,3930,21894,2,0,0,3,11,3930,0,1987,1987,98052,47.721,122.13,3930,20000,28,0,6.5,7860,23930
3.17e+05,2014,236,3,2.25,1358,1204,3,0,0,3,7,1358,0,2007,2007,98133,47.705,122.35,1358,1196,7,0,5.25,2716,2554
4.65e+05,2014,352,5,2.5,2550,6405,2,0,0,3,7,2550,0,2008,2008,98065,47.519,121.87,2190,5900,6,0,7.5,4740,8450
1.5695e+06,2015,393,5,4.5,5620,5800,3,0,3,3,11,4700,920,1999,1999,98199,47.648,122.41,2360,5800,16,0,9.5,7980,11420
6.1999e+05,2015,479,4,2.75,2630,4501,2,0,0,3,8,2630,0,2015,2015,98028,47.775,122.24,2380,4599,0,0,6.75,5010,7229
3.77e+05,2015,492,4,2,1640,5014,1,0,0,4,7,930,710,1982,1982,98106,47.554,122.36,1600,5452,33,0,6,3240,7092
3.4e+05,2014,269,1,1,640,4800,1,0,0,3,6,640,0,1918,1918,98136,47.555,122.38,1250,2847,96,0,2,1890,3487
3.7e+05,2015,376,3,2.25,1770,7667,1,0,0,3,8,1270,500,1966,1966,98177,47.772,122.36,2180,8103,49,0,5.25,3950,9873
5.3e+05,2014,187,3,1.75,1320,2500,1,0,0,3,7,870,450,1918,1918,98105,47.668,122.31,1580,2750,96,0,4.75,2900,4070
9.458e+05,2015,445,4,2.75,3360,9100,1,0,0,4,8,1760,1600,1973,1973,98006,47.564,122.15,2620,8925,42,0,6.75,5980,12285
4.65e+05,2015,390,5,1.5,1750,12491,1,0,0,3,6,1390,360,1961,1961,98033,47.7,122.17,1560,12473,54,0,6.5,3310,14223
3.04e+05,2015,456,3,2.5,1670,5298,2,0,0,3,8,1670,0,2002,2002,98042,47.392,122.17,1920,5298,13,0,5.5,3590,6968
2.1e+05,2014,313,3,1,1200,7500,1,0,0,3,6,1200,0,1905,1989,98178,47.492,122.28,1010,7000,109,1,4,2210,8200
3.5543e+05,2015,432,4,2.5,3238,9112,1,0,2,4,8,1678,1560,1979,1979,98198,47.401,122.31,3056,9668,36,0,6.5,6294,12906
7.33e+05,2014,225,3,1.75,1740,3060,1,0,0,5,8,950,790,1930,2014,98115,47.682,122.31,1800,3960,84,1,4.75,3540,5700
5.95e+05,2015,426,3,1.75,2220,22081,1,0,0,4,7,2220,0,1922,1922,98166,47.469,122.36,2010,12360,93,0,4.75,4230,14580
2.8e+05,2014,221,2,1,720,5000,1,0,0,5,6,720,0,1951,1951,98126,47.52,122.37,810,5000,63,0,3,1530,5720
1.115e+06,2014,188,4,2.5,3180,31931,1,0,0,4,10,2390,790,1978,1978,98007,47.639,122.15,3180,35007,36,0,6.5,6360,38187
2.725e+05,2015,459,3,2.5,2070,9900,1,0,0,3,8,1420,650,1979,1979,98023,47.299,122.37,2070,8250,36,0,5.5,4140,10320
6.6e+05,2015,451,4,1.75,1870,10450,1,0,0,3,8,1620,250,1978,1978,98005,47.594,122.15,2060,10450,37,0,5.75,3930,12320
4.9e+05,2014,341,3,2,2070,10023,1,0,0,3,8,1220,850,1981,1981,98074,47.649,122.06,2130,9694,33,0,5,4200,11764
1.55e+05,2014,133,2,1,910,6232,1,0,0,3,6,910,0,1943,1943,98118,47.533,122.27,1070,6232,71,0,3,1980,7142
2.72e+05,2015,362,3,1.75,2160,7140,1,0,0,4,7,1670,490,1978,1978,98023,47.303,122.37,1930,7350,37,0,4.75,4090,9510
8.25e+05,2014,292,4,3.5,3620,6499,2,0,0,3,9,3620,0,2003,2009,98177,47.733,122.36,2330,7200,11,1,7.5,5950,10820
2.5e+05,2014,205,3,1,1190,6250,1,0,0,3,7,990,200,1954,1954,98108,47.566,122.29,1760,6434,60,0,4,2950,7624
3.209e+05,2015,479,5,2.5,2200,8500,1,0,0,4,7,1400,800,1971,1971,98010,47.307,122.01,1360,8855,44,0,7.5,3560,11055
6.55e+05,2014,270,4,2.5,2630,4000,3,0,0,3,8,2630,0,2002,2002,98117,47.691,122.38,1640,4000,12,0,6.5,4270,6630
6.915e+05,2014,181,4,2.5,2600,7200,2,0,0,3,7,2600,0,1962,2002,98115,47.694,122.27,1790,6175,52,1,6.5,4390,8775
4.25e+05,2014,203,3,1,1280,3200,1,0,0,3,7,1280,0,1903,1903,98122,47.603,122.31,1320,1676,111,0,4,2600,2956
7.25e+05,2014,310,4,2.5,3040,35201,2,0,0,4,10,3040,0,1987,1987,98027,47.487,122.07,2990,35416,27,0,6.5,6030,38456
3.57e+05,2014,340,5,2.5,2750,12350,2,0,0,3,8,2750,0,1987,1987,98031,47.419,122.21,1650,9810,27,0,7.5,4400,12560
6.63e+05,2014,176,3,2,1480,3876,1,0,0,5,7,860,620,1928,1928,98117,47.681,122.38,1660,3774,86,0,5,3140,5254
2.72e+05,2014,317,4,2.5,1870,5692,2,0,0,3,7,1870,0,2004,2004,98058,47.433,122.15,2390,5293,10,0,6.5,4260,7163
7.55e+05,2014,292,3,2.25,3020,13031,2,0,0,3,9,3020,0,1989,1989,98052,47.69,122.1,2480,10204,25,0,5.25,5500,13224
2.99e+05,2014,134,2,1.75,1250,34395,1,0,0,4,7,1250,0,1950,1950,98003,47.28,122.32,1910,26042,64,0,3.75,3160,27292
7e+05,2014,202,3,2.5,2190,7982,2,0,0,3,8,2190,0,2004,2004,98033,47.687,122.19,2090,8888,10,0,5.5,4280,11078
2.7e+05,2014,300,4,2.5,2490,11650,1,0,0,3,7,1390,1100,1990,1990,98148,47.442,122.33,2010,10495,24,0,6.5,4500,12985
1.375e+06,2014,294,4,3.5,3500,9523,2,0,0,3,10,2460,1040,1996,1996,98033,47.685,122.21,3160,5997,18,0,7.5,6660,9497
1.0616e+06,2014,271,4,3,2990,6695,2,0,0,3,10,2990,0,2014,2014,98075,47.582,122.05,2760,6600,0,0,7,5750,9590
6.7473e+05,2015,492,4,2.5,2700,10160,2,0,0,3,9,2700,0,1988,1988,98029,47.569,122.01,2760,9219,27,0,6.5,5460,11919
4.3911e+05,2014,325,2,1.5,1130,1340,2,0,0,3,8,910,220,2008,2008,98116,47.576,122.41,1310,1340,6,0,3.5,2440,2470
7.6245e+05,2015,430,4,1.75,2570,8640,1,0,0,4,8,2570,0,1958,1958,98005,47.596,122.17,2520,8800,57,0,5.75,5090,11370
3.604e+05,2014,318,3,2.5,1630,11592,2,0,0,3,8,1630,0,1987,1987,98011,47.757,122.23,1700,8850,27,0,5.5,3330,10480
3.35e+05,2015,373,2,1.75,1270,1685,2,0,0,3,8,1270,0,2012,2012,98108,47.565,122.3,1270,1843,3,0,3.75,2540,3113
2.8879e+05,2014,177,4,2,1350,942,3,0,0,3,7,1350,0,2008,2008,98027,47.54,122.03,1390,942,6,0,6,2740,2292
2.3e+05,2014,168,2,1,1080,9435,1,0,0,3,6,1080,0,1958,1958,98058,47.459,122.18,1200,9210,56,0,3,2280,10290
2.449e+05,2014,338,1,1,620,8261,1,0,0,3,5,620,0,1939,1939,98106,47.514,122.36,1180,8244,75,0,2,1800,8864
8.75e+05,2014,153,4,2.25,3720,12384,1,0,2,5,8,1860,1860,1970,1970,98075,47.584,122.07,3180,15541,44,0,6.25,6900,19261
4.05e+05,2014,147,2,1,910,6490,1,0,0,3,7,910,0,1942,1942,98115,47.689,122.31,1040,6490,72,0,3,1950,7400
2.75e+05,2014,127,3,2.5,1600,7000,2,0,0,4,8,1600,0,1993,1993,98038,47.353,122.06,1700,7000,21,0,5.5,3300,8600
2.6505e+05,2014,182,2,1.5,800,2119,2,0,0,3,7,800,0,2008,2008,98106,47.554,122.36,1020,4800,6,0,3.5,1820,5600
3.15e+05,2014,271,4,2.25,2180,10754,1,0,0,5,7,1100,1080,1954,1954,98133,47.771,122.34,1810,6929,60,0,6.25,3990,9109
4.35e+05,2014,166,3,2,1980,2674,3,0,0,3,8,1980,0,2007,2007,98136,47.552,122.38,1440,2674,7,0,5,3420,4654
4.03e+05,2014,122,3,2,1960,13100,1,0,2,5,8,1650,310,1957,1957,98166,47.442,122.34,1960,10518,57,0,5,3920,12478
2.7995e+05,2015,424,3,2.25,1850,7480,2,0,0,3,7,1850,0,1978,1978,98058,47.452,122.16,1870,7480,37,0,5.25,3720,9330
3.35e+05,2014,160,3,1.75,2430,9133,1,0,0,4,7,1410,1020,1978,1978,98059,47.512,122.16,1980,9592,36,0,4.75,4410,12022
6.75e+05,2015,451,4,2.5,2370,9679,2,0,0,3,8,2370,0,1984,1984,98027,47.563,122.08,2290,7944,31,0,6.5,4660,10314
4.2e+05,2014,237,3,2,2330,6346,1,0,0,3,6,1600,730,1934,2014,98146,47.514,122.38,1380,8400,80,1,5,3710,10730
1.5186e+06,2014,194,4,4.25,3650,5328,1,0,0,3,9,2330,1320,1907,2014,98119,47.638,122.36,1710,3600,107,1,8.25,5360,7250
2.8e+05,2014,310,4,2.25,1990,7350,1,0,0,4,8,1180,810,1978,1978,98003,47.326,122.33,2030,7210,36,0,6.25,4020,9200
2.85e+05,2014,156,2,1,780,5000,1,0,0,4,6,780,0,1943,1943,98146,47.511,122.36,1030,5000,71,0,3,1810,5780
4.85e+05,2014,139,3,1.75,2200,7706,2,0,2,3,7,2200,0,1908,1988,98198,47.388,122.33,1170,70973,106,1,4.75,3370,73173
2.55e+05,2014,224,3,2.25,1830,7770,1,0,0,4,7,1400,430,1977,1977,98042,47.392,122.16,1960,7272,37,0,5.25,3790,9102
2.3795e+05,2014,189,2,1.75,1460,7926,1,0,0,4,7,1460,0,1987,1987,98042,47.367,122.09,1680,8206,27,0,3.75,3140,9666
7.4e+05,2014,340,3,1.75,2020,9478,1,0,0,4,9,2020,0,1961,1961,98040,47.538,122.24,3050,15594,53,0,4.75,5070,17614
2.89e+05,2014,155,3,2,1680,8424,1,0,0,3,7,1680,0,1993,1993,98022,47.197,122.01,1990,8545,21,0,5,3670,10225
5.56e+05,2014,301,3,1.75,1590,2500,1,0,0,4,7,1190,400,1908,1908,98105,47.667,122.3,1420,3800,106,0,4.75,3010,5390
6.15e+05,2014,243,3,2.5,1980,3128,2,0,0,3,8,1890,90,2009,2009,98027,47.546,122.02,2160,2240,5,0,5.5,4140,4220
1.08e+06,2015,430,5,3.5,3740,11340,2,0,0,3,10,3740,0,2013,2013,98052,47.663,122.14,2040,8715,2,0,8.5,5780,12455
2.1e+05,2014,206,2,1.75,1000,3554,1,0,0,4,8,1000,0,1975,1975,98198,47.381,122.32,1150,4000,39,0,3.75,2150,5000
7.75e+05,2014,331,3,1.75,3520,12350,1,0,4,4,8,1530,1990,1960,1960,98116,47.584,122.38,2140,7800,54,0,4.75,5660,11320
5.75e+05,2015,471,4,2.75,2730,35075,1,0,0,3,8,1530,1200,1979,1979,98072,47.773,122.14,2310,35000,36,0,6.75,5040,37730
1.535e+05,2014,279,2,2.5,1240,3649,2,0,0,3,7,1240,0,1986,1986,98003,47.324,122.32,1400,3721,28,0,4.5,2640,4961
3.525e+05,2015,380,2,2.5,980,1010,3,0,0,3,8,980,0,2008,2008,98117,47.684,122.39,980,1023,7,0,4.5,1960,2003
5.22e+05,2014,205,3,1.75,1630,15600,1,0,0,3,7,1630,0,1958,1958,98033,47.68,122.17,1830,10850,56,0,4.75,3460,12480
5.75e+05,2014,361,4,2.5,2280,27441,2,0,0,3,8,2280,0,1996,1996,98072,47.763,122.12,2350,35020,18,0,6.5,4630,37300
6.66e+05,2014,244,3,2.5,3000,5000,1,0,0,4,7,2110,890,1918,1918,98144,47.578,122.29,1970,5000,96,0,5.5,4970,8000
3.9995e+05,2014,328,3,2.5,1230,922,2,0,0,3,8,1080,150,2009,2009,98199,47.652,122.38,1230,1237,5,0,5.5,2460,2467
9.8e+05,2014,224,3,2.25,2390,4590,2,0,0,3,8,2090,300,1941,1998,98105,47.661,122.28,2280,5179,73,1,5.25,4670,7569
2.9e+05,2015,446,3,2,1260,7346,1,0,0,3,7,1260,0,1987,1987,98031,47.403,122.18,1460,7363,28,0,5,2720,8623
5e+05,2014,331,3,1.5,2220,8994,1,0,0,4,8,1110,1110,1962,1962,98006,47.547,122.17,2220,8994,52,0,4.5,4440,11214
2.675e+05,2014,291,3,2.25,2080,2856,1,0,0,3,7,1550,530,2003,2003,98042,47.42,122.16,2080,2275,11,0,5.25,4160,4355
5.4e+05,2014,154,3,1,1050,4160,1,0,0,4,7,1050,0,1925,1925,98115,47.676,122.3,1580,3680,89,0,4,2630,4730
4.95e+05,2014,324,3,2.25,1280,1517,2,0,0,3,8,1080,200,2008,2008,98107,47.665,122.37,1280,1681,6,0,5.25,2560,2961
7.71e+05,2015,446,4,2,2220,3760,1,0,0,4,7,1370,850,1929,1929,98117,47.688,122.37,1620,3760,86,0,6,3840,5980
2e+05,2014,175,3,1,1150,4800,1,0,0,4,6,1150,0,1938,1938,98002,47.31,122.21,1310,9510,76,0,4,2460,10660
1.325e+05,2015,410,3,0.75,850,8573,1,0,0,3,6,600,250,1945,1945,98146,47.503,122.36,850,8382,70,0,3.75,1700,9232
2.59e+05,2015,396,3,1.75,1270,4815,1,0,0,3,6,980,290,1922,1922,98108,47.55,122.31,1270,6431,93,0,4.75,2540,7701
3.3995e+05,2014,134,3,1,1050,5402,1,0,0,4,7,1050,0,1906,1906,98144,47.587,122.31,1510,4685,108,0,4,2560,5735
7.26e+05,2014,194,5,3,2970,10335,2,0,0,3,9,2970,0,2000,2000,98075,47.598,122.02,2970,10335,14,0,8,5940,13305
3.4e+05,2014,188,3,2.25,2120,13090,1,0,0,3,8,2120,0,1997,1997,98002,47.296,122.22,1400,12039,17,0,5.25,3520,14159
3.41e+05,2014,132,3,1.5,1720,7119,1,0,0,4,7,1720,0,1952,1952,98155,47.754,122.31,1590,7616,62,0,4.5,3310,9336
2.04e+05,2015,464,3,1,1200,12500,1,0,0,3,6,1200,0,1936,1936,98198,47.416,122.33,1200,7500,79,0,4,2400,8700
4.93e+05,2014,167,4,1.75,2030,18295,1,0,0,4,7,2030,0,1975,1975,98034,47.733,122.18,1970,7307,39,0,5.75,4000,9337
5.25e+05,2014,250,3,1.75,2870,26500,1,0,1,3,8,2870,0,1948,1981,98166,47.449,122.36,2420,20500,66,1,4.75,5290,23370
1e+06,2014,202,4,2.5,2610,3277,1,0,0,5,8,1920,690,1922,1922,98103,47.664,122.33,1810,3277,92,0,6.5,4420,5887
5.45e+05,2014,161,3,2.5,2180,15693,1,0,0,4,8,1850,330,1979,1979,98075,47.592,122.08,2270,24000,35,0,5.5,4450,26180
5.74e+05,2015,470,4,2.5,2980,10179,2,0,2,3,9,2980,0,2003,2003,98038,47.389,122.03,2980,8828,12,0,6.5,5960,11808
4.91e+05,2014,277,3,2,2005,7000,1,0,0,3,7,1605,400,1980,1980,98122,47.604,122.3,1750,4500,34,0,5,3755,6505
5.15e+05,2015,460,4,2.5,1850,9248,2,0,0,3,8,1850,0,1997,1997,98028,47.735,122.24,2080,8711,18,0,6.5,3930,10561
6.63e+05,2014,280,3,2.25,2840,59677,1,0,0,3,7,1580,1260,1967,1967,98075,47.583,122.04,2220,31688,47,0,5.25,5060,34528
2.29e+05,2014,331,2,1,810,5100,1,0,0,3,6,810,0,1955,1955,98133,47.732,122.34,1500,5100,59,0,3,2310,5910
2.95e+05,2014,252,3,2.5,1660,8125,1,0,0,3,7,1150,510,1999,1999,98148,47.437,122.33,1250,8125,15,0,5.5,2910,9785
2.8e+05,2014,306,2,1,880,5750,1,0,0,3,6,880,0,1939,1939,98126,47.564,122.38,1190,5750,75,0,3,2070,6630
1.36e+06,2015,443,4,3.5,4120,12626,2,0,1,3,11,3970,150,2014,2014,98034,47.709,122.25,4120,11913,1,0,7.5,8240,16033
3.48e+05,2015,480,3,2.5,2370,7500,1,0,3,3,8,1620,750,1979,1979,98198,47.409,122.33,1960,8062,36,0,5.5,4330,10432
5.9e+05,2015,423,4,2.75,2400,1.0411e+05,2,0,0,3,8,2400,0,1988,1988,98027,47.469,121.99,2270,54450,27,0,6.75,4670,56850
3.2445e+05,2014,287,3,2,1420,16000,1,0,0,3,7,1420,0,1966,1966,98166,47.478,122.36,1900,12630,48,0,5,3320,14050
7.2e+05,2015,408,4,3.25,3276,10801,2,0,0,3,9,3276,0,2008,2008,98166,47.459,122.36,2010,11656,7,0,7.25,5286,14932
9.25e+05,2014,208,3,3.25,2610,4500,1,0,0,4,9,1660,950,1909,1909,98103,47.67,122.34,2110,4500,105,0,6.25,4720,7110
5.07e+05,2014,224,3,2.25,1810,8158,1,0,0,3,8,1450,360,1984,1984,98074,47.626,122.04,1740,9532,30,0,5.25,3550,11342
1.489e+05,2014,341,4,1.75,1700,6000,1,0,0,3,7,1700,0,1967,1967,98002,47.325,122.21,1280,6000,47,0,5.75,2980,7700
2.35e+05,2015,480,3,2,1900,7980,1,0,0,4,7,1340,560,1977,1977,98023,47.305,122.37,1690,7840,38,0,5,3590,9740
1.8241e+06,2015,474,3,2.25,3330,20053,2,0,0,3,9,3330,0,1968,1998,98004,47.639,122.21,2870,20053,47,1,5.25,6200,23383
2.312e+05,2014,299,3,2,1400,8821,1,0,0,3,7,1400,0,1991,1991,98022,47.195,121.99,1450,8721,23,0,5,2850,10121
3.7595e+05,2014,210,3,1.75,1480,7560,1,0,0,3,6,1100,380,1920,1985,98117,47.699,122.36,1510,7250,94,1,4.75,2990,8730
2.95e+05,2015,445,3,2,1400,7384,1,0,0,3,7,1150,250,1979,1979,98058,47.465,122.17,1820,7992,36,0,5,3220,9392
2.525e+05,2014,176,3,2,1900,8002,1,0,0,3,7,1900,0,1991,1991,98023,47.291,122.35,1900,6086,23,0,5,3800,7986
3.75e+05,2014,272,2,1.5,1130,912,2,0,0,3,8,1000,130,2006,2006,98116,47.564,122.39,1500,1474,8,0,3.5,2630,2604
1.9644e+05,2014,150,3,2,1560,7352,1,0,0,3,6,1560,0,1992,1992,98001,47.28,122.25,1120,7950,22,0,5,2680,9510
5.8e+05,2015,463,3,2.5,1740,1280,3,0,2,3,8,1740,0,2008,2008,98116,47.589,122.39,1740,1308,7,0,5.5,3480,3048
4.6e+05,2015,486,5,3,2008,5050,1,0,0,3,7,1216,792,1992,1992,98118,47.538,122.29,2040,5297,23,0,8,4048,7305
7.4e+05,2014,125,4,1.75,2010,3600,1,0,0,3,7,2010,0,1902,1902,98119,47.634,122.37,2010,3600,112,0,5.75,4020,5610
2.9995e+05,2015,477,3,2.25,1370,5000,2,0,0,3,7,1370,0,1990,1990,98019,47.737,121.98,1600,7724,25,0,5.25,2970,9094
3.95e+05,2014,148,3,2.5,2250,3757,2,0,0,3,7,2250,0,2006,2006,98059,47.479,122.13,2250,4556,8,0,5.5,4500,6806
2.54e+05,2014,129,3,2.5,1850,4597,2,0,0,3,8,1850,0,2003,2003,98042,47.376,122.14,2210,5000,11,0,5.5,4060,6850
3e+05,2014,122,3,2.5,2540,5050,2,0,0,3,7,2540,0,2006,2006,98042,47.336,122.06,2280,5050,8,0,5.5,4820,7590
4.77e+05,2014,235,3,2.5,2100,5060,2,0,0,3,7,2100,0,2006,2006,98108,47.563,122.3,1520,2468,8,0,5.5,3620,4568
3.4e+05,2014,254,4,1.75,1900,7313,1,0,0,3,7,1900,0,1973,1973,98034,47.731,122.23,1420,7384,41,0,5.75,3320,9284
3.5e+05,2014,223,3,2,1680,81893,1,0,0,3,7,1680,0,1991,1991,98092,47.325,122.18,2480,38637,23,0,5,4160,40317
6.7e+05,2014,187,5,2.5,2860,68519,2,0,0,5,8,2860,0,1958,1958,98065,47.526,121.83,1670,35910,56,0,7.5,4530,38770
6.4995e+05,2014,251,3,2.5,2150,15304,2,0,0,4,9,2150,0,1979,1979,98006,47.557,122.14,2540,10507,35,0,5.5,4690,12657
9.5e+05,2014,348,4,2.75,3800,12200,2,0,3,4,10,3800,0,1986,1986,98006,47.569,122.16,3710,14796,28,0,6.75,7510,18596
2.65e+05,2014,346,3,1,960,9748,1,0,0,3,5,960,0,1922,1922,98065,47.526,121.81,1600,9958,92,0,4,2560,10918
5.25e+05,2014,263,4,1.5,1580,6360,1,0,0,3,7,1290,290,1945,1945,98115,47.687,122.29,1690,6360,69,0,5.5,3270,7940
3.359e+05,2014,301,4,2.75,2475,4000,2,0,0,3,7,2475,0,2014,2014,98002,47.345,122.21,2475,4000,0,0,6.75,4950,6475
8e+05,2015,396,6,1,1430,20620,2,0,0,3,7,1430,0,1954,1954,98004,47.626,122.21,2450,10080,61,0,7,3880,11510
2.95e+05,2015,458,4,2.5,2030,5754,2,0,0,3,8,2030,0,2001,2001,98042,47.354,122.14,2030,5784,14,0,6.5,4060,7814
4.05e+05,2015,387,3,1.75,1260,7373,1,0,0,4,7,1260,0,1979,1979,98034,47.73,122.23,1360,7373,36,0,4.75,2620,8633
6.6e+05,2014,209,5,2.25,2540,3750,1,0,0,4,7,1510,1030,1925,1925,98115,47.673,122.3,1780,3750,89,0,7.25,4320,6290
4.275e+05,2014,196,3,1,1350,7085,1,0,0,5,7,1350,0,1944,1944,98125,47.732,122.31,1350,7085,70,0,4,2700,8435
3.75e+05,2014,223,4,2.25,2100,12738,2,0,0,4,8,2100,0,1975,1975,98059,47.47,122.12,2000,12090,39,0,6.25,4100,14190
5.4e+05,2014,259,3,1.75,2280,16671,1,0,0,4,6,1760,520,1909,1909,98034,47.71,122.22,1850,9351,105,0,4.75,4130,11631
2.07e+05,2014,278,3,1,1980,18730,1,0,0,4,7,1280,700,1943,1943,98001,47.322,122.28,1356,9450,71,0,4,3336,11430
6.13e+05,2014,300,3,3.25,2440,2812,2,0,0,3,8,1710,730,2005,2005,98027,47.536,122.07,2440,2836,9,0,6.25,4880,5276
3.25e+05,2014,221,2,1,1100,17817,1,0,0,3,7,620,480,1980,1980,98019,47.773,121.9,1790,20009,34,0,3,2890,21109
1.85e+05,2015,402,2,1,1122,9100,1,0,0,4,6,1122,0,1960,1960,98023,47.328,122.34,840,9344,55,0,3,1962,10466
3.886e+05,2015,486,3,2.5,2370,4200,2,0,0,3,8,2370,0,2014,2014,98038,47.37,122.02,2370,4370,1,0,5.5,4740,6740
3.75e+05,2014,245,4,1.75,1680,6834,1,0,0,3,7,1680,0,1948,1948,98125,47.716,122.31,950,7425,66,0,5.75,2630,9105
7e+05,2015,393,3,2.5,2850,36585,2,0,0,3,10,2850,0,1987,1987,98072,47.738,122.1,3340,35671,28,0,5.5,6190,38521
3.99e+05,2015,477,2,2,1110,1155,3,0,0,3,7,980,130,2008,2008,98136,47.55,122.39,1110,1089,7,0,4,2220,2199
5.05e+05,2014,347,3,1.75,2300,11400,1,0,0,4,8,1520,780,1977,1977,98052,47.688,122.13,2300,10140,37,0,4.75,4600,12440
3.59e+05,2014,255,3,2.5,2430,7857,2,0,0,5,8,1730,700,1980,1980,98055,47.455,122.21,2160,8740,34,0,5.5,4590,11170
4.15e+05,2014,250,4,1,1620,4329,1,0,0,3,7,1620,0,1927,1927,98116,47.573,122.39,1220,5520,87,0,5,2840,7140
5.748e+05,2014,293,3,1.5,1630,2946,1,0,0,4,8,1630,0,1932,1932,98115,47.687,122.31,1550,3800,82,0,4.5,3180,5430
5.5e+05,2014,196,3,2.5,2290,6328,2,0,0,3,8,2290,0,2001,2001,98146,47.51,122.38,1600,6180,13,0,5.5,3890,8470
3.4e+05,2015,450,4,2.5,2090,4200,2,0,0,3,7,2090,0,2007,2007,98038,47.366,122.02,2090,4200,8,0,6.5,4180,6290
5.94e+05,2015,386,3,2.25,2080,70567,2,0,0,3,8,2080,0,1990,1990,98072,47.722,122.12,3730,43560,25,0,5.25,5810,45640
3.2e+05,2014,334,3,1,1330,9540,1,0,0,4,7,1330,0,1971,1971,98077,47.758,122.08,1250,10350,43,0,4,2580,11680
90000,2014,133,2,1,790,2640,1,0,0,3,7,790,0,1973,1973,98034,47.735,122.18,1310,2064,41,0,3,2100,2854
6.505e+05,2015,382,5,4.25,3920,11412,2,0,0,3,7,3920,0,1955,2005,98006,47.577,122.15,1400,9750,60,1,9.25,5320,13670
2.1395e+05,2014,223,3,1,1430,7000,1,0,0,3,6,1430,0,1968,1968,98023,47.302,122.37,1050,7700,46,0,4,2480,9130
3.1e+05,2015,491,3,1,1250,10723,1,0,0,4,7,1250,0,1961,1961,98059,47.489,122.14,1520,10723,54,0,4,2770,11973
5.8e+05,2014,269,4,2.25,2610,7700,1,0,0,3,8,1700,910,1977,1977,98027,47.566,122.09,2260,8266,37,0,6.25,4870,10876
2.85e+05,2014,209,4,2,1760,5500,1,0,1,3,7,780,980,1925,2004,98118,47.518,122.27,1510,5500,89,1,6,3270,7260
7.15e+05,2014,262,4,3,1986,6000,2,0,2,4,8,1746,240,1922,1922,98136,47.537,122.39,1930,6200,92,0,7,3916,8186
4.45e+05,2015,415,5,3,3880,7180,2,0,0,3,7,3880,0,2004,2004,98056,47.48,122.18,2160,4793,11,0,8,6040,8673
3.89e+05,2014,216,4,1,1520,9800,1,0,0,4,7,1520,0,1971,1971,98034,47.73,122.24,1540,7700,43,0,5,3060,9220
6.1431e+05,2014,231,2,2.25,2210,5500,1,0,0,4,8,1410,800,1968,1968,98117,47.697,122.39,2140,6600,46,0,4.25,4350,8810
7e+05,2014,139,3,1.75,2010,4905,1,0,0,5,7,1230,780,1912,1912,98122,47.611,122.31,2210,1834,102,0,4.75,4220,3844
2.7e+05,2014,194,2,1,1150,3600,1,0,0,3,6,1150,0,1910,1910,98144,47.573,122.31,1160,4000,104,0,3,2310,5150
2.8995e+05,2015,425,3,2.5,2099,4275,2,0,0,3,7,2099,0,2010,2010,98002,47.352,122.21,2099,4275,5,0,5.5,4198,6374
4.85e+05,2014,149,4,1,1600,4300,1,0,0,4,7,1600,0,1916,1916,98103,47.665,122.34,1610,4300,98,0,5,3210,5900
5.325e+05,2014,221,3,2.5,2160,7500,1,0,1,3,7,1430,730,1979,1979,98074,47.619,122.06,1560,7500,35,0,5.5,3720,9660
4.39e+05,2014,265,1,1,790,2400,1,0,0,3,7,790,0,1918,1918,98122,47.618,122.3,1580,2566,96,0,2,2370,3356
9.25e+05,2015,470,3,3.25,4110,20900,2,0,0,3,9,2630,1480,2002,2002,98006,47.551,122.19,2640,14700,13,0,6.25,6750,18810
5.937e+05,2015,408,3,2.5,2000,22000,2,0,0,3,8,2000,0,1979,1979,98075,47.59,122.08,2180,19800,36,0,5.5,4180,21800
2.5495e+05,2014,236,4,2,2180,8800,1,0,0,5,7,1170,1010,1977,1977,98038,47.368,122.05,1630,8800,37,0,6,3810,10980
4.35e+05,2014,263,3,1.5,1740,6988,1,0,0,3,7,1600,140,1950,1950,98133,47.721,122.33,1650,7500,64,0,4.5,3390,9240
2.53e+05,2014,269,3,1.75,1570,7416,1,0,0,4,7,1570,0,1971,1971,98031,47.412,122.17,1900,7416,43,0,4.75,3470,8986
2.87e+05,2014,262,4,2.25,2270,11997,1,0,2,4,7,1540,730,1959,1959,98198,47.41,122.3,1920,9634,55,0,6.25,4190,11904
3.3e+05,2014,333,4,2,1750,5202,1,0,1,4,6,1070,680,1942,1942,98108,47.568,122.32,2090,5400,72,0,6,3840,7150
7e+05,2015,479,3,1.75,1820,15570,1,0,2,3,8,1820,0,1948,1948,98146,47.507,122.39,2490,9480,67,0,4.75,4310,11300
4.7759e+05,2014,211,3,3.25,2260,7701,2,0,0,3,8,1760,500,2000,2000,98146,47.505,122.38,1880,7529,14,0,6.25,4140,9789
4.1784e+05,2014,181,4,2.5,2530,5048,2,0,0,3,8,2530,0,2014,2014,98038,47.356,122.06,2530,4359,0,0,6.5,5060,6889
2.55e+05,2014,269,5,1.75,1970,8925,1,0,0,5,7,1170,800,1977,1977,98002,47.292,122.2,1910,8025,37,0,6.75,3880,9995
7.2e+05,2014,310,3,2.75,2440,76531,1,0,0,3,10,1640,800,1980,1980,98072,47.767,122.16,1890,10042,34,0,5.75,4330,12482
3.5e+05,2014,160,2,0.75,1392,43710,1,0,0,4,7,1392,0,1978,1978,98070,47.449,122.45,1640,99316,36,0,2.75,3032,1.0071e+05
2.005e+05,2014,176,3,1.75,1260,9346,1,0,0,4,7,1260,0,1963,1963,98030,47.371,122.19,1800,9705,51,0,4.75,3060,10965
9.67e+05,2015,477,4,2.5,3100,7250,2,0,0,3,9,3100,0,2010,2010,98115,47.696,122.32,1240,6670,5,0,6.5,4340,9770
2.9e+05,2014,345,2,1,1200,8750,1,0,0,3,6,1200,0,1948,1948,98155,47.755,122.33,1100,8408,66,0,3,2300,9608
2.8e+05,2014,203,2,1,2280,37500,2,0,0,3,7,2280,0,1932,1932,98136,47.525,122.39,2360,6000,82,0,3,4640,8280
2.95e+05,2014,161,5,3.5,2100,5107,2,0,0,3,7,1410,690,1999,1999,98178,47.511,122.26,1410,5650,15,0,8.5,3510,7750
5.85e+05,2014,178,5,2.5,2670,16777,1,0,0,4,7,1620,1050,1920,1920,98125,47.702,122.3,1610,8227,94,0,7.5,4280,10897
4.2e+05,2015,430,2,2.75,1760,4139,2,0,0,3,8,1760,0,2010,2010,98065,47.517,121.88,1870,3076,5,0,4.75,3630,4836
2.4e+05,2015,439,3,1.75,1100,7373,1,0,0,4,7,1100,0,1968,1968,98092,47.312,122.18,1430,8415,47,0,4.75,2530,9515
6.5e+05,2014,294,3,3.5,1494,1262,3,0,0,3,8,1494,0,2011,2011,98115,47.683,122.32,1494,1264,3,0,6.5,2988,2758
3.3e+05,2014,136,3,1.5,1170,4950,1,0,0,4,7,1170,0,1960,1960,98007,47.606,122.14,1570,7700,54,0,4.5,2740,8870
4.5e+05,2015,426,3,2.25,1620,1057,3,0,0,3,8,1540,80,2009,2009,98027,47.54,122.03,1390,942,6,0,5.25,3010,2562
3.553e+05,2014,145,3,2.5,1620,7410,1,0,0,5,7,1620,0,1955,1955,98133,47.771,122.33,1450,8121,59,0,5.5,3070,9741
4.87e+05,2014,231,2,2.5,1470,2533,2,0,0,3,8,1470,0,2005,2005,98033,47.687,122.17,1470,6511,9,0,4.5,2940,7981
5.85e+05,2014,194,4,1.75,3140,12519,1,0,0,3,7,2320,820,1951,1983,98033,47.694,122.17,2240,7308,63,1,5.75,5380,10448
6.55e+05,2015,403,4,3,2570,8022,1,0,0,4,8,1370,1200,1984,1984,98052,47.696,122.1,2090,8022,31,0,7,4660,10592
8e+05,2014,221,4,2.5,2570,50308,1,0,0,3,10,2570,0,1993,1993,98077,47.742,122.04,3420,37891,21,0,6.5,5990,40461
5.7e+05,2015,402,3,2,1400,1657,2,0,0,3,8,1060,340,2004,2004,98112,47.62,122.3,1540,2275,11,0,5,2940,3675
3.4e+05,2014,347,3,2,1870,3378,1,0,0,3,7,1120,750,1913,1913,98136,47.537,122.39,1870,1872,101,0,5,3740,3742
1.4e+06,2014,239,4,2.5,4070,7800,3,0,0,4,8,3390,680,2002,2002,98115,47.684,122.33,2020,6760,12,0,6.5,6090,10830
3.35e+05,2015,486,3,1,1020,10200,1,0,0,4,7,1020,0,1954,1954,98133,47.75,122.35,1170,8188,61,0,4,2190,9208
1.485e+06,2014,162,4,3.75,4030,10800,2,0,0,3,10,4030,0,2006,2006,98033,47.682,122.2,2160,7200,8,0,7.75,6190,11230
2.7995e+05,2014,155,3,2,1750,9750,1,0,0,3,7,1350,400,1961,1961,98198,47.398,122.3,1900,10125,53,0,5,3650,11875
5.75e+05,2014,310,4,2.5,2040,5508,2,0,0,4,8,2040,0,1996,1996,98029,47.572,122.01,2130,5496,18,0,6.5,4170,7536
3.206e+05,2014,262,3,2,1220,7620,1,0,0,3,6,720,500,1947,2014,98166,47.456,122.35,1640,7620,67,1,5,2860,8840
2.55e+05,2014,238,3,1.5,1490,6604,1,0,0,4,6,1490,0,1918,1918,98166,47.468,122.35,1330,6604,96,0,4.5,2820,8094
7.6e+05,2015,438,4,2.5,3220,4031,2,0,0,3,9,3220,0,2002,2002,98033,47.688,122.16,3150,5083,13,0,6.5,6370,8303
6.85e+05,2014,149,3,1.75,1940,7313,1,0,1,4,8,1440,500,1960,1960,98136,47.524,122.39,2160,7200,54,0,4.75,4100,9140
7.6e+05,2014,189,4,2.25,3300,8365,3,0,0,3,9,3300,0,2014,2014,98126,47.536,122.38,1290,8369,0,0,6.25,4590,11669
6.6e+05,2014,236,3,2,2880,5100,1,0,0,4,7,2080,800,1926,1926,98117,47.681,122.39,1820,5100,88,0,5,4700,7980
2.29e+05,2014,189,4,2.25,2010,7688,1,0,0,3,8,1170,840,1979,1979,98023,47.309,122.4,1990,7688,35,0,6.25,4000,9698
4.75e+05,2015,433,5,2,2050,10200,1,0,0,3,6,1430,620,1956,1956,98198,47.414,122.33,1940,8625,59,0,7,3990,10675
5.42e+05,2015,402,4,1,1540,5000,1,0,0,4,7,1090,450,1922,1922,98115,47.675,122.29,1590,5000,93,0,5,3130,6540
4.17e+05,2015,399,2,1.75,1090,4590,1,0,0,4,7,790,300,1915,1915,98105,47.668,122.32,1390,4080,100,0,3.75,2480,5170
5.7e+05,2015,365,4,1,1490,6000,1,0,0,3,7,1490,0,1918,1918,98136,47.552,122.39,1700,6000,97,0,5,3190,7490
4.95e+05,2014,304,3,1.75,1890,6557,1,0,0,3,8,1890,0,1967,1967,98125,47.703,122.29,1920,6793,47,0,4.75,3810,8683
4.3e+05,2014,136,3,1.75,2150,4333,1,0,0,3,7,1200,950,1956,1956,98136,47.554,122.39,1480,6500,58,0,4.75,3630,8650
1.8e+05,2014,245,2,1,770,9370,1,0,0,3,7,770,0,1947,1947,98155,47.762,122.32,1060,9352,67,0,3,1830,10122
2.35e+05,2015,451,3,1,1430,7599,1,0,0,4,6,1010,420,1930,1930,98168,47.478,122.27,1290,10320,85,0,4,2720,11750
9.1e+05,2015,423,3,3.5,2480,3200,2,0,0,3,10,2480,0,2010,2010,98144,47.595,122.31,1980,3200,5,0,6.5,4460,5680
1.115e+06,2015,470,4,2.5,3690,11191,1,0,3,4,10,2190,1500,1951,1951,98199,47.643,122.41,3460,8160,64,0,6.5,7150,11850
2.99e+05,2014,277,3,1,1520,8320,1,0,0,3,6,1520,0,1953,1953,98133,47.77,122.33,1500,8320,61,0,4,3020,9840
3.35e+05,2015,451,3,1.75,1900,36769,1,0,0,3,8,1900,0,1987,1987,98092,47.304,122.07,1950,35847,28,0,4.75,3850,37747
7.6e+05,2015,437,3,3.25,3320,15022,2,0,0,3,10,3320,0,1989,1989,98166,47.429,122.34,3430,15018,26,0,6.25,6750,18338
5.79e+05,2014,159,2,2,1870,6275,1,0,0,3,8,1870,0,2003,2003,98053,47.711,122.03,1670,5200,11,0,4,3540,7070
4.15e+05,2014,188,4,1.75,1920,7700,2,0,0,4,7,1920,0,1970,1970,98056,47.538,122.18,1310,7700,44,0,5.75,3230,9620
7.75e+05,2014,163,4,2,3140,10875,1,0,1,3,7,1940,1200,1939,1969,98199,47.666,122.41,3300,10080,75,1,6,6440,13220
2.7e+05,2014,248,1,1,720,5196,1,0,0,3,7,720,0,1911,1911,98103,47.693,122.34,1580,5762,103,0,2,2300,6482
6.7e+05,2015,479,4,2.5,2850,25993,2,0,0,4,9,2850,0,1989,1989,98056,47.532,122.17,2480,12672,26,0,6.5,5330,15522
3e+05,2015,394,3,1.75,1280,12776,1,0,0,4,7,1280,0,1977,1977,98031,47.421,122.2,1680,11704,38,0,4.75,2960,12984
4.64e+05,2015,450,5,2,2000,3000,1,0,0,3,6,1200,800,1931,1931,98122,47.603,122.3,1330,4000,84,0,7,3330,6000
5.79e+05,2015,383,4,3.25,1900,2631,2,0,0,3,9,1250,650,2014,2014,98144,47.587,122.31,1710,4502,1,0,7.25,3610,6402
8.6199e+05,2014,187,5,2.75,3595,5639,2,0,0,3,9,3595,0,2014,2014,98053,47.685,122.02,3625,5639,0,0,7.75,7220,9234
7.29e+05,2015,424,3,2.5,2480,7428,2,0,0,3,9,2480,0,1990,1990,98006,47.549,122.19,2600,8322,25,0,5.5,5080,10802
5e+05,2015,472,4,2.5,2900,5760,1,0,0,4,8,1660,1240,1959,1959,98118,47.55,122.27,2250,6098,56,0,6.5,5150,8998
7.12e+05,2014,169,3,2.75,3200,6699,2,0,0,3,9,3200,0,2004,2004,98075,47.588,121.99,3020,6699,10,0,5.75,6220,9899
6.06e+05,2014,277,3,1.75,1970,8540,1,0,3,4,8,1130,840,1950,1950,98177,47.721,122.36,2280,8540,64,0,4.75,4250,10510
4.43e+05,2014,196,4,1.5,1860,12197,1,0,0,3,7,1860,0,1964,1964,98034,47.729,122.23,1510,11761,50,0,5.5,3370,13621
3.39e+05,2014,318,4,2.5,2840,8746,2,0,0,3,8,2840,0,2001,2001,98022,47.19,122.01,2630,9900,13,0,6.5,5470,12740
3.25e+05,2014,145,4,3.5,2630,3435,1,0,3,3,7,1640,990,1984,1984,98188,47.435,122.27,1920,2435,30,0,7.5,4550,5065
2.75e+05,2014,313,3,1.5,1510,16200,1,0,0,3,7,1510,0,1970,1970,98031,47.393,122.17,1650,13950,44,0,4.5,3160,15460
6.5e+05,2015,432,4,2.25,2440,9320,1,0,0,4,7,1880,560,1957,1957,98007,47.593,122.14,1530,9335,58,0,6.25,3970,11775
2.76e+05,2014,339,2,2,1480,6075,1,0,0,5,7,740,740,1919,1919,98118,47.532,122.28,1230,6053,95,0,4,2710,7533
4.3e+05,2014,314,4,2.5,3000,9460,2,0,0,3,9,3000,0,2001,2001,98031,47.396,122.21,3000,8450,13,0,6.5,6000,11450
5.71e+05,2014,317,3,2.5,2510,5186,2,0,0,3,7,2510,0,2001,2001,98053,47.69,122.04,2530,5186,13,0,5.5,5040,7696
2.6e+05,2014,175,2,1,1120,5650,1,0,0,3,6,1120,0,1944,1944,98178,47.498,122.24,1270,6875,70,0,3,2390,7995
3.17e+05,2015,365,3,1.5,1060,5750,1,0,0,2,7,1060,0,1981,1981,98126,47.553,122.37,1060,5750,34,0,4.5,2120,6810
2.9995e+05,2015,445,2,1.5,1390,1756,3,0,0,3,7,1390,0,2005,2005,98133,47.727,122.36,1340,1756,10,0,3.5,2730,3146
3.05e+05,2014,228,3,1.75,1650,9480,1,0,0,3,7,1220,430,1977,1977,98034,47.726,122.19,1540,8400,37,0,4.75,3190,10050
3.7995e+05,2014,196,3,1.75,2040,12065,1,0,0,3,8,2040,0,1987,1987,98038,47.376,122.04,2010,11717,27,0,4.75,4050,13757
4.65e+05,2014,306,5,2.25,3020,10010,1,0,0,3,7,1510,1510,1959,1959,98027,47.525,122.04,1760,10878,55,0,7.25,4780,13898
1.4e+06,2014,279,5,3.25,4300,9270,2,0,3,3,10,2910,1390,1957,2009,98116,47.572,122.41,2780,6610,57,1,8.25,7080,10910
3.85e+05,2014,163,3,2.25,1920,4833,1,0,0,4,7,1060,860,1921,1921,98133,47.707,122.35,1580,5134,93,0,5.25,3500,7054
4.2495e+05,2014,325,4,3.25,3266,5398,2,0,0,3,8,3266,0,2014,2014,98023,47.297,122.35,3087,5152,0,0,7.25,6353,8418
2.7495e+05,2014,152,3,1,1450,8820,1,0,0,3,6,1050,400,1958,1958,98168,47.47,122.26,1510,8820,56,0,4,2960,10270
3.799e+05,2015,412,4,2.5,3181,5831,2,0,0,3,8,3181,0,2014,2014,98003,47.272,122.3,2056,24393,1,0,6.5,5237,27574
5.41e+05,2014,238,3,1.75,1410,4080,1,0,0,4,7,1410,0,1927,1927,98105,47.669,122.32,1820,4080,87,0,4.75,3230,5490
9e+05,2015,425,4,3.5,3070,4440,2,0,0,3,9,2030,1040,1922,2007,98116,47.573,122.41,1780,4800,93,1,7.5,4850,7870
1e+06,2014,209,4,2,1780,15648,1,0,0,5,8,1780,0,1918,1918,98004,47.585,122.2,2320,14963,96,0,6,4100,16743
1.075e+06,2014,340,4,2.75,2990,7389,1,0,0,4,8,2090,900,1923,1923,98144,47.571,122.28,2510,6157,91,0,6.75,5500,9147
4.1245e+05,2015,477,3,2,1910,13505,1,0,0,3,8,1910,0,1955,1955,98034,47.711,122.23,2010,8000,60,0,5,3920,9910
2.6e+05,2014,361,3,1,1180,5350,1,0,0,4,6,1180,0,1959,1959,98178,47.505,122.26,1490,5350,55,0,4,2670,6530
3.3e+06,2014,360,3,3.25,4220,41300,1,1,4,4,11,2460,1760,1958,1987,98008,47.608,122.11,3810,30401,56,1,6.25,8030,34621
3.9e+05,2015,424,4,1.75,2180,7560,1,0,0,4,7,1560,620,1962,1962,98133,47.757,122.34,1810,7352,53,0,5.75,3990,9532
8.64e+05,2015,477,4,2.5,3720,1.0585e+05,2,0,0,4,10,3720,0,1984,1984,98053,47.655,122.03,2830,88256,31,0,6.5,6550,91976
3.5e+05,2014,203,3,1,1130,8201,1,0,0,5,6,1130,0,1948,1948,98155,47.736,122.31,1180,8203,66,0,4,2310,9333
2.4e+05,2014,266,3,2.25,1410,7290,1,0,0,3,7,940,470,1980,1980,98118,47.54,122.27,1550,7375,34,0,5.25,2960,8785
3e+05,2014,181,3,2.75,2090,9620,1,0,0,3,8,1340,750,1987,1987,98023,47.274,122.34,2150,9660,27,0,5.75,4240,11750
7.19e+05,2014,215,3,2.5,2120,9307,2,0,0,4,9,2120,0,1984,1984,98006,47.548,122.14,2290,11524,30,0,5.5,4410,13644
3.25e+05,2015,408,3,2.5,2260,8120,2,0,0,3,8,2260,0,2004,2004,98023,47.292,122.36,2250,7784,11,0,5.5,4510,10044
5.5e+05,2015,408,4,2.5,3350,6605,2,0,0,3,8,2670,680,1990,1990,98011,47.75,122.18,2730,5962,25,0,6.5,6080,9312
6.33e+05,2014,349,5,2.75,3630,30570,2,0,0,3,11,3630,0,2000,2000,98058,47.424,122.1,3620,41965,14,0,7.75,7250,45595
5.1613e+05,2014,194,3,1.75,1510,8250,1,0,0,4,8,1510,0,1962,1962,98008,47.618,122.11,1770,8250,52,0,4.75,3280,9760
6e+05,2015,492,2,1.75,2080,13054,1,0,1,3,7,2080,0,1951,1951,98155,47.743,122.29,2440,13054,64,0,3.75,4520,15134
2.74e+05,2014,221,3,1.5,1450,4694,2,0,0,3,7,1450,0,2011,2011,98038,47.365,122.02,1870,4198,3,0,4.5,3320,5648
3.75e+05,2015,417,2,1,1840,81892,1,0,0,3,6,1840,0,1955,1955,98072,47.769,122.12,2550,40089,60,0,3,4390,41929
2.74e+05,2015,464,3,1.75,1590,7620,1,0,0,4,7,1090,500,1984,1984,98038,47.365,122.05,1590,7620,31,0,4.75,3180,9210
4.41e+05,2014,180,2,1.5,1190,3400,1,0,0,3,7,990,200,1919,1919,98115,47.673,122.32,1410,3150,95,0,3.5,2600,4340
4.02e+05,2014,143,3,2,1540,1827,2,0,0,3,8,1540,0,2005,2005,98029,47.548,122,1540,1827,9,0,5,3080,3367
4.2e+05,2015,423,2,1,1460,7832,1,0,0,3,6,1460,0,1924,1924,98166,47.462,122.35,1460,7632,91,0,3,2920,9092
5.975e+05,2015,453,3,2,2150,5400,1,0,0,4,7,1380,770,1911,1911,98126,47.555,122.38,1940,6500,104,0,5,4090,8650
4.98e+05,2014,134,4,2.75,2270,7375,1,0,0,4,7,1290,980,1973,1973,98034,47.722,122.17,1750,7760,41,0,6.75,4020,10030
4.99e+05,2014,248,3,1.5,1260,3135,1,0,0,4,7,780,480,1944,1944,98107,47.669,122.37,1540,3025,70,0,4.5,2800,4285
4.6e+05,2015,463,2,1,1020,4002,1,0,0,5,7,1020,0,1953,1953,98116,47.583,122.39,1780,5000,62,0,3,2800,6020
2.4495e+05,2015,425,4,2.5,1790,19177,1,0,0,4,7,1790,0,1966,1966,98030,47.362,122.17,1760,11726,49,0,6.5,3550,13516
2.94e+05,2014,224,4,2.5,2040,7800,2,0,0,3,7,2040,0,2003,2003,98168,47.473,122.29,1860,10954,11,0,6.5,3900,12994
5.6e+05,2014,278,3,3.5,1560,2198,2,0,0,3,8,1180,380,2006,2006,98116,47.581,122.4,1550,1467,8,0,6.5,3110,3027
4.45e+05,2014,257,4,2.75,2680,16934,1,0,0,4,7,1340,1340,1958,1958,98106,47.542,122.36,1240,7000,56,0,6.75,3920,9680
6.7e+05,2014,347,4,2.25,2370,9636,1,0,0,3,8,1660,710,1976,1976,98033,47.65,122.19,2350,9588,38,0,6.25,4720,11958
2.7e+05,2015,450,4,2.5,1750,6397,2,0,0,3,7,1750,0,1988,1988,98023,47.308,122.36,1940,6502,27,0,6.5,3690,8252
4.9e+05,2014,157,3,3,1730,2940,3,0,0,3,7,1730,0,1985,1985,98117,47.691,122.39,1690,4410,29,0,6,3420,6140
8.9599e+05,2014,204,4,2.75,3555,6565,2,0,0,3,9,3555,0,2014,2014,98053,47.685,122.02,3625,5637,0,0,6.75,7180,9192
5.54e+05,2014,235,3,2,1830,3500,1,0,0,5,7,1290,540,1909,1909,98116,47.573,122.38,1530,4000,105,0,5,3360,5830
6.95e+05,2014,160,4,3.5,3510,9364,2,0,0,3,10,3510,0,2001,2001,98065,47.54,121.88,3510,9161,13,0,7.5,7020,12671
4.4e+05,2014,140,2,1.75,1300,4000,2,0,0,3,7,1300,0,1948,1948,98105,47.669,122.29,1350,4013,66,0,3.75,2650,5313
7e+05,2015,488,3,1.75,1500,6000,1,0,0,5,7,850,650,1940,1940,98199,47.647,122.4,1700,6000,75,0,4.75,3200,7500
3.8e+05,2015,464,5,2.5,2130,8428,2,0,0,3,7,2130,0,2013,2013,98168,47.473,122.28,1500,11810,2,0,7.5,3630,13940
3.15e+05,2015,444,3,1.75,2380,10450,1,0,0,3,8,2380,0,1966,1966,98023,47.314,122.37,2320,8500,49,0,4.75,4700,10880
6.04e+05,2014,215,6,3.5,2580,13572,1,0,0,3,8,1290,1290,1987,1987,98052,47.68,122.11,2020,11656,27,0,9.5,4600,14236
5e+05,2015,373,3,2.25,1440,15661,1,0,0,3,8,1180,260,1988,1988,98074,47.623,122.04,1440,13963,27,0,5.25,2880,15403
3.3e+05,2014,256,3,1,1570,9136,1,0,0,3,7,1570,0,1953,1953,98133,47.769,122.34,1380,9127,61,0,4,2950,10697
3.349e+05,2015,473,4,1.75,2180,4066,1,0,0,3,6,1270,910,1911,1911,98118,47.549,122.28,1400,1343,104,0,5.75,3580,3523
6.8e+05,2014,166,4,2.75,2500,4950,2,0,0,3,8,2500,0,2010,2010,98053,47.696,122.02,2500,4950,4,0,6.75,5000,7450
2.22e+05,2014,280,3,1.75,1370,8280,1,0,0,4,7,1370,0,1980,1980,98031,47.41,122.17,1850,7820,34,0,4.75,3220,9190
2.75e+05,2014,209,3,2.25,1640,6044,2,0,0,3,7,1640,0,1996,1996,98002,47.284,122.2,1600,7418,18,0,5.25,3240,9058
4.15e+05,2015,459,3,1.5,1510,16800,1,0,0,5,8,1510,0,1956,1956,98133,47.751,122.34,1560,7276,59,0,4.5,3070,8786
2.15e+05,2014,276,3,2,1290,9312,1,0,0,3,7,1290,0,1947,1947,98168,47.481,122.33,1650,7300,67,0,5,2940,8590
3.19e+05,2014,349,3,2,1640,9234,1,0,0,5,7,1060,580,1967,1967,98118,47.516,122.27,2230,10354,47,0,5,3870,11994
1e+06,2015,472,3,2.5,3180,10492,2,0,2,3,10,3180,0,1991,1991,98052,47.655,122.12,3000,9812,24,0,5.5,6180,12992
4.195e+05,2014,287,3,2.5,1360,3188,2,0,0,3,7,1360,0,1986,1986,98052,47.683,122.1,1090,3188,28,0,5.5,2450,4548
3.9e+05,2014,218,3,1.75,1870,40250,1,0,0,5,7,1870,0,1959,1959,98038,47.404,122.04,1870,40250,55,0,4.75,3740,42120
8.8e+05,2014,266,4,3.25,4060,52707,2,0,0,4,9,4060,0,1996,1996,98077,47.761,122.04,3100,50755,18,0,7.25,7160,54815
1.7204e+05,2015,470,3,2.25,1710,7134,1,0,0,4,7,1130,580,1979,1979,98031,47.391,122.19,1790,7455,36,0,5.25,3500,9165
3.65e+05,2014,237,3,2.25,2430,7614,1,0,0,3,8,1900,530,1979,1979,98056,47.507,122.19,1720,11250,35,0,5.25,4150,13680
2.965e+05,2014,349,3,1.5,1580,10100,1,0,0,4,7,1580,0,1961,1961,98055,47.442,122.19,1650,10032,53,0,4.5,3230,11612
1.9e+05,2014,325,3,1.75,1520,9600,1,0,0,4,7,1520,0,1967,1967,98059,47.473,122.15,1590,10183,47,0,4.75,3110,11703
2.755e+05,2015,443,4,1,1290,5000,1,0,0,3,7,1290,0,1957,1957,98146,47.513,122.36,1440,2500,58,0,5,2730,3790
3.05e+05,2014,231,3,2,1490,7697,1,0,0,3,7,1490,0,1994,1994,98059,47.485,122.16,1540,7529,20,0,5,3030,9019
2.3e+05,2014,283,3,2,1410,10625,1,0,0,3,7,1410,0,1980,1980,98042,47.365,122.12,1410,9744,34,0,5,2820,11154
2.3e+05,2014,331,3,1,1060,10228,1,0,0,3,7,1060,0,1948,1948,98155,47.748,122.3,1570,10228,66,0,4,2630,11288
5.521e+05,2014,245,3,3,1330,1379,2,0,0,4,8,1120,210,2005,2005,98122,47.613,122.31,1810,1770,9,0,6,3140,3100
4.585e+05,2015,413,3,1.75,1250,9605,1,0,0,3,7,1250,0,1964,1964,98008,47.633,122.12,1570,9605,51,0,4.75,2820,10855
3.72e+05,2014,341,4,2.5,2070,8658,2,0,0,3,8,2070,0,1999,1999,98178,47.507,122.26,2010,7215,15,0,6.5,4080,9285
5.3e+05,2014,127,3,1,1340,4284,1,0,0,3,7,1080,260,1910,1910,98105,47.663,122.32,1960,4080,104,0,4,3300,5420
3.2e+05,2014,230,3,1,1780,6840,2,0,0,4,6,1780,0,1947,1947,98125,47.727,122.3,1410,7200,67,0,4,3190,8980
3.81e+05,2014,245,2,2,1340,4447,1,0,0,3,8,1340,0,2004,2004,98053,47.718,122.03,1350,4458,10,0,4,2690,5798
6.75e+05,2014,127,3,1.75,1680,10500,1,0,0,4,8,1680,0,1959,1959,98005,47.61,122.17,2250,10400,55,0,4.75,3930,12080
2.9e+05,2014,249,3,2,1700,6498,1,0,0,3,7,1700,0,1986,1986,98038,47.378,122.04,1700,6654,28,0,5,3400,8354
3.07e+05,2014,245,3,1.75,1410,16105,1,0,0,3,7,1410,0,1982,1982,98014,47.693,121.91,1550,18615,32,0,4.75,2960,20025
4.9e+05,2014,140,5,3.5,4460,2975,3,0,2,3,10,3280,1180,2015,2015,98119,47.631,122.37,2490,4231,-1,0,8.5,6950,8691
4.9e+05,2014,353,4,2.5,3630,8387,2,0,0,3,10,3630,0,1997,1997,98042,47.362,122.13,3370,8869,17,0,6.5,7000,12499
5.35e+05,2015,458,3,1,1290,6859,1,0,0,4,7,1290,0,1941,1941,98136,47.532,122.39,1560,6369,74,0,4,2850,7659
2.9e+05,2014,239,4,2.5,2340,52272,2,0,0,2,8,2340,0,1978,1978,98042,47.347,122.09,2480,40500,36,0,6.5,4820,42840
6.4e+05,2015,436,3,2.5,1620,1377,2,0,0,3,8,1100,520,2009,2009,98112,47.62,122.3,1620,1251,6,0,5.5,3240,2871
6.375e+05,2015,396,3,1.75,1680,10685,1,0,0,4,7,1680,0,1966,1966,98033,47.656,122.19,3340,10390,49,0,4.75,5020,12070
3.45e+05,2014,228,2,1,1350,4494,1,0,0,3,7,920,430,1949,1949,98126,47.532,122.38,1470,5225,65,0,3,2820,6575
6.75e+05,2014,152,3,2.25,2610,9002,2,0,0,3,9,2610,0,1988,1988,98052,47.691,122.1,2320,8306,26,0,5.25,4930,10916
1.49e+05,2014,143,3,1,1700,8645,1,0,0,3,6,1700,0,1955,1955,98146,47.49,122.34,1500,7980,59,0,4,3200,9680
2.9e+05,2014,324,3,2,1760,6600,1,0,0,3,7,1760,0,1998,1998,98030,47.384,122.18,2590,6600,16,0,5,4350,8360
4e+05,2015,456,4,2,1420,9301,1,0,0,4,7,1420,0,1963,1963,98008,47.633,122.12,1530,8075,52,0,6,2950,9495
6.3e+05,2014,218,4,2.5,2290,26720,2,0,0,3,8,2290,0,1977,1977,98177,47.75,122.37,2290,26720,37,0,6.5,4580,29010
2.65e+05,2015,433,2,1,910,4600,1,0,0,3,5,910,0,1917,1917,98117,47.692,122.36,1020,4600,98,0,3,1930,5510
4.59e+05,2015,443,3,1,1320,5000,1,0,0,3,7,1320,0,1912,1912,98116,47.571,122.39,1320,4179,103,0,4,2640,5499
2.15e+06,2015,365,3,2.75,3470,9610,3,1,4,3,11,3470,0,1989,2000,98034,47.721,122.26,4130,11875,26,1,5.75,7600,15345
4.55e+05,2015,477,3,1,2400,17239,1,0,0,4,7,1890,510,1940,1940,98028,47.75,122.25,2390,7350,75,0,4,4790,9750
7.685e+05,2015,368,4,1.75,3620,10400,1,0,0,4,8,1820,1800,1965,1965,98005,47.607,122.17,2410,10400,50,0,5.75,6030,14020
2.6e+05,2015,439,3,1.75,1460,10000,1,0,0,4,8,1460,0,1967,1967,98092,47.342,122.19,1930,14175,48,0,4.75,3390,15635
6.8e+05,2015,425,4,2.5,3140,28037,2,0,0,4,10,3140,0,1991,1991,98077,47.73,122.08,2990,35001,24,0,6.5,6130,38141
4.75e+05,2014,342,3,1,1600,7161,1,0,0,3,8,1600,0,1953,1953,98118,47.551,122.26,1760,8280,61,0,4,3360,9880
4.2e+05,2014,242,3,1.75,1770,6000,1,0,0,3,7,1130,640,1952,1952,98125,47.714,122.31,1900,7200,62,0,4.75,3670,8970
7.625e+05,2014,205,3,2.25,3330,15258,2,0,0,3,10,3330,0,1986,1986,98077,47.726,122.06,3360,14850,28,0,5.25,6690,18180
3.75e+05,2014,167,3,1.75,1160,22470,1,0,0,4,7,1160,0,1976,1976,98028,47.76,122.23,1940,15999,38,0,4.75,3100,17159
3.2e+05,2014,154,3,1.5,1650,9380,1,0,0,5,7,1130,520,1978,1978,98058,47.453,122.16,1720,8856,36,0,4.5,3370,10506
3.75e+05,2014,201,3,1.5,1370,9720,2,0,0,3,7,1370,0,1968,1968,98034,47.73,122.2,1510,8775,46,0,4.5,2880,10145
6.85e+05,2015,457,3,1.75,2720,4720,1,0,0,4,7,1580,1140,1925,1925,98105,47.669,122.29,1660,4640,90,0,4.75,4380,7360
2.55e+05,2014,270,3,1.5,910,25500,1,0,0,3,5,910,0,1943,1943,98188,47.456,122.28,1580,10019,71,0,4.5,2490,10929
6.965e+05,2014,257,5,2.25,3210,61419,1,0,0,3,8,3210,0,1979,1979,98077,47.763,122.09,2820,48351,35,0,7.25,6030,51561
4e+05,2014,229,2,1,1180,10800,1,0,0,3,7,1180,0,1984,1984,98011,47.727,122.24,1600,10800,30,0,3,2780,11980
2.7e+05,2015,477,3,2.25,1420,7800,1,0,0,4,7,1130,290,1985,1985,98042,47.36,122.16,1460,7800,30,0,5.25,2880,9220
8.6111e+05,2015,485,4,2.5,3650,7090,2,0,0,3,10,3650,0,2008,2008,98074,47.606,122.05,3860,7272,7,0,6.5,7510,10922
3.1675e+05,2014,195,3,2.5,1256,1154,3,0,0,3,7,1256,0,2005,2005,98125,47.715,122.31,1309,1232,9,0,5.5,2565,2488
2.325e+05,2014,169,3,1,1320,8450,1,0,0,3,6,880,440,1961,1961,98023,47.328,122.34,1320,8450,53,0,4,2640,9770
4.1963e+05,2015,401,4,2.5,2680,11590,2,0,0,4,9,2680,0,1988,1988,98058,47.44,122.16,2580,8225,27,0,6.5,5260,10905
5.55e+05,2015,447,3,1,1250,4590,1,0,0,3,6,970,280,1903,1903,98115,47.676,122.33,1830,4080,112,0,4,3080,5330
6.05e+05,2014,198,3,1.75,2330,6000,1,0,0,4,7,1630,700,1940,1940,98126,47.577,122.38,1600,4000,74,0,4.75,3930,6330
8.7995e+05,2014,140,4,2.25,3500,13875,1,0,4,4,9,1830,1670,1938,1938,98146,47.508,122.39,2960,15000,76,0,6.25,6460,18500
6.23e+05,2015,439,3,2.75,2390,21804,1,0,0,3,8,1450,940,1973,1973,98034,47.734,122.18,2390,10136,42,0,5.75,4780,12526
7.25e+05,2015,365,4,1.75,2000,3750,1,0,0,5,8,1120,880,1950,1950,98117,47.682,122.37,1370,5000,65,0,5.75,3370,7000
5.05e+05,2014,277,4,3,2280,7400,1,0,0,3,7,1340,940,1978,1978,98125,47.711,122.31,1540,7500,36,0,7,3820,9780
2.6995e+05,2014,165,3,2.5,1890,4838,2,0,0,3,8,1730,160,2002,2002,98168,47.48,122.28,1910,7409,12,0,5.5,3800,9299
6.5e+05,2014,264,5,3.5,5110,10018,2,0,0,3,10,3850,1260,2003,2003,98034,47.726,122.17,1790,10018,11,0,8.5,6900,15128
2.9e+05,2014,235,2,1.5,1020,1275,3,0,0,3,8,1020,0,2008,2008,98103,47.7,122.35,980,1415,6,0,3.5,2000,2435
3.2e+05,2014,341,3,3.25,1480,1192,2,0,0,3,8,1180,300,2013,2013,98106,47.556,122.36,1330,1094,1,0,6.25,2810,2574
1.078e+06,2015,475,4,2.75,3160,42733,2,0,0,3,9,3160,0,1995,1995,98053,47.637,121.96,1890,24000,20,0,6.75,5050,27160
5.95e+05,2015,479,3,1,1300,11520,1,0,0,3,6,1300,0,1958,1958,98033,47.683,122.19,1440,8064,57,0,4,2740,9364
4.39e+05,2014,188,4,2.25,2570,9503,2,0,0,3,8,2570,0,1980,1980,98011,47.764,122.17,1950,9600,34,0,6.25,4520,12170
2.15e+05,2014,324,3,1,1260,7897,1,0,0,3,7,1260,0,1979,1979,98022,47.195,122,1560,8285,35,0,4,2820,9545
2.985e+05,2014,208,3,2,2420,8800,1,0,0,4,7,1420,1000,1959,1959,98188,47.432,122.29,1546,8666,55,0,5,3966,11086
3.9e+05,2015,458,3,1,1240,3600,1,0,0,3,7,1240,0,1902,1902,98144,47.599,122.3,1680,3600,113,0,4,2920,4840
5.9e+05,2015,407,3,1.75,2180,6120,1,0,2,3,8,1380,800,1949,1949,98199,47.65,122.41,2020,6122,66,0,4.75,4200,8302
1.01e+06,2014,224,4,2.75,3430,15877,1,0,4,3,11,3430,0,2005,2005,98065,47.536,121.86,4080,14577,9,0,6.75,7510,18007
1.3e+06,2014,195,5,1,1670,6400,1,0,0,3,8,1670,0,1919,1919,98119,47.654,122.37,1910,2983,95,0,6,3580,4653
3.75e+05,2014,349,3,2.5,1670,7740,1,0,0,3,7,1130,540,1974,1974,98126,47.522,122.37,1220,7740,40,0,5.5,2890,9410
2.2706e+05,2015,383,3,1.5,1570,10824,2,0,0,3,7,1570,0,1908,1908,98118,47.54,122.28,1530,8125,107,0,4.5,3100,9695
2.25e+05,2014,243,3,1,1790,6120,1,0,0,3,6,1790,0,1937,1964,98146,47.508,122.34,830,6120,77,1,4,2620,7910
7.15e+05,2014,150,4,1.75,3420,7200,1,0,3,5,8,1770,1650,1947,1947,98125,47.708,122.28,2450,6200,67,0,5.75,5870,9620
2.75e+05,2015,401,3,2.25,1450,4040,2,0,0,3,7,1450,0,2010,2010,98038,47.367,122.02,1610,4040,5,0,5.25,3060,5490
3e+05,2015,369,4,2.5,2600,8572,2,0,0,3,8,2600,0,2003,2003,98001,47.316,122.27,2170,5288,12,0,6.5,4770,7888
3.65e+05,2014,257,2,2,1440,15000,1,0,0,3,7,1440,0,1985,1985,98072,47.765,122.16,1780,15000,29,0,4,3220,16440
6.22e+05,2014,285,3,3.5,1690,1765,2,0,0,3,8,1370,320,2006,2006,98103,47.654,122.34,1690,1694,8,0,6.5,3380,3384
3.5e+05,2015,452,2,2.75,2820,11770,2,0,0,3,7,1630,1190,1947,1947,98168,47.51,122.32,1690,12500,68,0,4.75,4510,15320
3.65e+05,2014,196,3,1,1380,30940,2,0,0,3,8,1380,0,1976,1976,98042,47.334,122.11,2350,32500,38,0,4,3730,33880
3.75e+05,2015,368,5,2.5,2100,14858,1,0,0,5,8,2100,0,1970,1970,98059,47.472,122.12,1980,11730,45,0,7.5,4080,13830
7.95e+05,2014,285,4,2.75,2890,16397,2,0,0,3,10,2890,0,1997,1997,98077,47.71,122.07,3170,16397,17,0,6.75,6060,19287
5.2495e+05,2014,235,3,1.75,1750,3250,1,0,0,4,7,1230,520,1929,1929,98117,47.681,122.37,1480,3600,85,0,4.75,3230,5350
2.3e+05,2014,204,3,1,1300,14000,1,0,0,4,7,1300,0,1958,1958,98198,47.421,122.32,1390,8750,56,0,4,2690,10050
4.6e+05,2014,276,4,2.5,2350,3760,2,0,0,3,8,2350,0,2014,2014,98059,47.479,122.12,2590,4136,0,0,6.5,4940,6486
3.525e+05,2014,161,3,1.75,1170,8182,1,0,0,3,7,1170,0,1962,1962,98155,47.737,122.3,1610,8183,52,0,4.75,2780,9353
8.55e+05,2014,168,4,2.25,2190,4080,2,0,0,3,8,1800,390,1918,1918,98119,47.642,122.36,2100,4080,96,0,6.25,4290,6270
6.25e+05,2014,142,3,1.75,2060,12558,1,0,0,4,7,1350,710,1984,1984,98052,47.666,122.14,1850,8722,30,0,4.75,3910,10782
3.6e+05,2014,169,4,2.5,2850,4650,2,0,0,3,8,2850,0,2004,2004,98038,47.355,122.03,2850,4650,10,0,6.5,5700,7500
5.65e+05,2014,189,3,2.5,2500,7394,2,0,0,3,9,2500,0,1990,1990,98072,47.744,122.17,2790,7642,24,0,5.5,5290,10142
2.0995e+05,2014,177,3,1,970,9583,1,0,0,4,6,970,0,1967,1967,98023,47.304,122.37,970,7875,47,0,4,1940,8845
3.685e+05,2014,222,5,1.75,2810,9360,1,0,0,4,7,1520,1290,1965,1965,98055,47.436,122.19,1770,9360,49,0,6.75,4580,12170
6.18e+05,2014,298,3,2.75,3200,12682,2,0,1,3,9,3200,0,1977,1977,98028,47.744,122.26,2880,10432,37,0,5.75,6080,13632
1.8e+06,2014,140,4,3.5,4460,16953,1,0,0,3,9,2550,1910,1962,1994,98039,47.634,122.23,1980,13370,52,1,7.5,6440,17830
4.03e+05,2015,417,3,2.5,1502,1400,3,0,0,3,7,1502,0,2005,2005,98115,47.695,122.31,1377,1466,10,0,5.5,2879,2968
4.55e+05,2015,413,3,1.5,1250,8004,1,0,0,3,7,1250,0,1965,1965,98008,47.629,122.12,1450,7931,50,0,4.5,2700,9181
7.8e+05,2014,187,4,2,2600,4800,1,0,2,3,8,1400,1200,1953,1953,98119,47.637,122.37,2050,3505,61,0,6,4650,6105
3.9e+05,2014,304,3,1.75,2200,8036,1,0,0,3,7,1270,930,1978,1978,98011,47.776,122.21,1850,7563,36,0,4.75,4050,9763
3.525e+05,2015,484,2,2.5,1570,2399,2,0,0,3,7,1180,390,2009,2009,98106,47.549,122.36,1590,2306,6,0,4.5,3160,3876
2.55e+05,2015,460,3,1,1140,8528,1,0,0,5,7,1140,0,1967,1967,98022,47.21,122,1140,8112,48,0,4,2280,9252
4.45e+05,2014,218,3,2.5,2470,4565,2,0,0,3,7,2470,0,2005,2005,98056,47.514,122.19,2470,5064,9,0,5.5,4940,7534
3.5e+05,2014,266,4,1,1010,6000,1,0,0,3,6,750,260,1925,1925,98136,47.552,122.38,1450,6000,89,0,5,2460,7010
2.7e+05,2015,365,4,2.5,1600,9921,2,0,0,3,7,1600,0,2009,2009,98042,47.368,122.12,2140,5806,6,0,6.5,3740,7406
5.27e+05,2014,290,4,2.5,2900,6736,2,0,0,3,8,2900,0,2013,2013,98059,47.495,122.15,2900,6736,1,0,6.5,5800,9636
6.412e+05,2014,191,3,1,1060,9123,1,0,0,3,7,1060,0,1952,1952,98004,47.622,122.19,1620,9121,62,0,4,2680,10181
5.95e+05,2015,426,4,2.5,2330,7064,1,0,0,4,8,1780,550,1984,1984,98052,47.696,122.1,1740,8075,31,0,6.5,4070,10405
1.735e+06,2014,333,5,3.5,4870,7700,2,0,3,5,10,3650,1220,1929,1929,98144,47.583,122.29,3220,7700,85,0,8.5,8090,12570
3.02e+05,2014,202,3,1,1110,7000,1,0,0,4,7,1110,0,1955,1955,98133,47.754,122.34,1800,7000,59,0,4,2910,8110
4.429e+05,2014,171,4,1.75,1780,2788,1,0,0,4,6,890,890,1943,1943,98199,47.651,122.4,1760,5664,71,0,5.75,3540,7444
4.585e+05,2015,474,3,1.5,1280,1920,1,0,0,3,7,1280,0,1905,1990,98122,47.612,122.3,1280,3150,110,1,4.5,2560,4430
3.97e+05,2014,294,3,1.75,1340,5100,1,0,0,3,7,1340,0,1953,1953,98103,47.694,122.35,1550,5100,61,0,4.75,2890,6440
3.95e+05,2014,306,3,2,1590,10229,1,0,0,3,7,1590,0,1966,1966,98034,47.724,122.23,1320,10222,48,0,5,2910,11812
3.85e+05,2014,305,3,1,1250,21303,1,0,0,3,6,1250,0,1970,1970,98053,47.663,122.06,1250,17920,44,0,4,2500,19170
3.52e+05,2014,236,4,1.75,1850,5712,1,0,0,3,7,1850,0,1954,1954,98115,47.697,122.32,1510,6038,60,0,5.75,3360,7888
3.9995e+05,2014,341,3,3,1860,2875,2,0,0,3,8,1710,150,2009,2009,98126,47.551,122.37,1350,4830,5,0,6,3210,6690
4.6995e+05,2014,310,3,2,1820,1357,3,0,0,3,9,1820,0,2014,2014,98126,47.543,122.38,1710,1372,0,0,5,3530,3192
2.7795e+05,2014,321,3,2.5,2100,6021,2,0,0,3,7,2100,0,1992,1992,98023,47.292,122.38,2091,7547,22,0,5.5,4191,9647
2.17e+05,2015,441,3,1,870,5200,1,0,0,5,6,870,0,1969,1969,98042,47.37,122.08,1020,5200,46,0,4,1890,6070
3.85e+05,2014,222,3,1.75,2160,5863,1,0,0,4,7,1260,900,1928,1928,98144,47.573,122.31,1590,3000,86,0,4.75,3750,5160
2.16e+05,2014,204,3,1.75,1580,9705,1,0,0,4,7,1580,0,1977,1977,98042,47.382,122.09,1580,9942,37,0,4.75,3160,11522
4.3995e+05,2014,269,4,2.25,2460,14600,1,0,0,4,8,1720,740,1977,1977,98042,47.376,122.16,2460,14600,37,0,6.25,4920,17060
3.3e+05,2014,312,3,1,980,7000,1,0,0,3,6,980,0,1953,1953,98133,47.762,122.36,1220,7000,61,0,4,2200,7980
3.8e+05,2014,227,3,1.75,1240,8611,1,0,0,4,7,1240,0,1973,1973,98133,47.718,122.33,1700,8037,41,0,4.75,2940,9277
6.5e+05,2014,208,3,1.75,1550,5000,1,0,0,3,7,1250,300,1911,2011,98107,47.672,122.37,1110,5000,103,1,4.75,2660,6550
9.52e+05,2014,230,2,1.75,3490,88909,1,0,3,3,10,2320,1170,1980,1980,98006,47.546,122.11,3490,40185,34,0,3.75,6980,43675
1.79e+06,2015,415,5,3.75,4360,8504,2,0,4,3,10,3530,830,2014,2014,98033,47.694,122.19,2680,9000,1,0,8.75,7040,13360
7.81e+05,2015,382,3,2.5,2070,4463,1,0,0,5,8,1780,290,1931,1931,98115,47.685,122.31,2070,5000,84,0,5.5,4140,7070
2.916e+05,2015,480,3,1.75,1630,7480,1,0,0,3,7,1330,300,1979,1979,98058,47.451,122.16,1940,7480,36,0,4.75,3570,9110
5.86e+05,2015,445,4,2.25,1930,8338,1,0,0,3,8,1930,0,1968,1968,98125,47.703,122.28,2280,7616,47,0,6.25,4210,9546
2.63e+05,2015,481,4,1.75,1340,8700,1,0,0,3,6,1340,0,1958,1958,98188,47.451,122.29,1240,8700,57,0,5.75,2580,10040
4.1995e+05,2015,493,2,1.75,1350,4003,1,0,0,3,8,1350,0,2004,2004,98053,47.718,122.03,1350,4479,11,0,3.75,2700,5829
6.85e+05,2014,272,4,2.75,1660,5150,1,0,0,5,7,1280,380,1928,1928,98117,47.684,122.36,1490,4017,86,0,6.75,3150,5677
4.915e+05,2014,232,3,2.25,2230,13100,1,0,0,4,8,1510,720,1974,1974,98006,47.541,122.17,2010,10650,40,0,5.25,4240,12880
3.59e+05,2015,387,4,2.25,2710,22860,1,0,0,4,7,1850,860,1962,1962,98001,47.321,122.27,1700,22860,53,0,6.25,4410,25570
7.1e+05,2014,190,4,2.5,2870,8995,1,0,0,5,8,1870,1000,1968,1968,98006,47.568,122.13,2670,9672,46,0,6.5,5540,12542
1.75e+05,2014,166,3,1.5,1220,7300,1,0,0,3,7,1220,0,1973,1973,98001,47.334,122.28,1260,7347,41,0,4.5,2480,8567
4.52e+05,2014,149,4,2.25,2590,10002,1,0,0,4,8,1340,1250,1968,1968,98028,47.769,122.27,1550,10436,46,0,6.25,4140,13026
5.4e+05,2014,318,5,2.5,3370,4850,2,0,0,3,9,3370,0,2007,2007,98056,47.508,122.17,2900,5570,7,0,7.5,6270,8940
1.3375e+06,2014,300,4,2.5,2900,21074,2,0,0,3,11,2900,0,1986,1986,98199,47.67,122.42,3390,20000,28,0,6.5,6290,22900
3.87e+05,2015,466,4,1.75,2500,7690,1,0,0,3,7,1250,1250,1973,1973,98155,47.771,122.31,2040,8646,42,0,5.75,4540,11146
2.575e+05,2014,263,3,1.75,1530,14087,1,0,0,3,7,1070,460,1979,1979,98042,47.315,122.04,1770,13660,35,0,4.75,3300,15190
4.5e+05,2014,332,2,1,950,4560,1,0,0,3,7,950,0,1925,1925,98112,47.629,122.3,2040,4560,89,0,3,2990,5510
3.6e+05,2015,396,3,1.75,1950,7260,1,0,0,3,8,1520,430,1957,1957,98133,47.719,122.33,1950,7548,58,0,4.75,3900,9498
3.6e+05,2014,348,3,1.25,2350,6200,1,0,0,4,7,1320,1030,1966,1966,98007,47.598,122.14,2140,9543,48,0,4.25,4490,11893
6.61e+05,2014,353,4,3.25,2600,2074,2,0,0,3,8,2150,450,2011,2011,98027,47.54,122.03,2510,2074,3,0,7.25,5110,4674
5.3e+05,2015,388,5,1.75,1570,3000,2,0,0,4,7,1570,0,1908,1908,98105,47.668,122.32,1610,3000,107,0,6.75,3180,4570
2.1e+05,2014,201,3,1,1520,8600,1,0,0,3,6,1040,480,1951,1951,98168,47.513,122.33,1320,8600,63,0,4,2840,10120
3.65e+05,2015,430,3,1.75,1820,5555,1,0,0,4,7,1030,790,1939,1939,98103,47.687,122.35,1420,4000,76,0,4.75,3240,5820
1.588e+05,2014,324,3,1,960,8291,1,0,0,3,6,960,0,1950,1950,98146,47.501,122.33,1110,8231,64,0,4,2070,9191
1.1128e+06,2014,290,5,3.5,3090,3600,2,0,0,3,9,2060,1030,2000,2000,98112,47.622,122.31,2240,3904,14,0,8.5,5330,6994
5.78e+05,2014,191,3,2.25,1790,9580,2,0,0,3,8,1790,0,1984,1984,98006,47.554,122.16,2060,9995,30,0,5.25,3850,11785
2.3e+05,2014,166,3,1.75,1400,6956,1,0,0,4,7,1400,0,1957,1957,98031,47.423,122.2,1400,9375,57,0,4.75,2800,10775
2.9e+05,2014,139,4,2.5,1700,7280,2,0,0,4,7,1700,0,1988,1988,98031,47.404,122.17,1950,7475,26,0,6.5,3650,9175
3.005e+05,2015,473,2,1.5,1190,801,3,0,0,3,8,1190,0,2010,2010,98106,47.521,122.36,1190,810,5,0,3.5,2380,2000
4.325e+05,2015,451,3,3,2500,6000,2,0,0,3,8,2500,0,2012,2012,98058,47.441,122.16,2130,6000,3,0,6,4630,8500
4.15e+05,2014,138,3,2.5,2480,8342,2,0,0,3,8,2480,0,1986,1986,98058,47.438,122.13,2300,8303,28,0,5.5,4780,10783
6.5e+05,2014,263,3,2,2300,5000,1,0,0,4,8,1150,1150,1938,1938,98199,47.652,122.41,2300,5000,76,0,5,4600,7300
7.34e+05,2014,264,5,4.25,4110,42755,2,0,2,3,10,2970,1140,2000,2000,98023,47.337,122.34,2730,12750,14,0,9.25,6840,16860
3e+05,2015,479,4,2.5,2450,8932,2,0,0,3,8,2450,0,1990,1990,98023,47.309,122.34,2410,8775,25,0,6.5,4860,11225
5.355e+05,2014,156,3,1.5,1730,40250,2,0,0,4,8,1730,0,1983,1983,98072,47.75,122.11,1730,36250,31,0,4.5,3460,37980
3.96e+05,2015,457,1,1,630,5150,1,0,0,4,5,630,0,1954,1954,98117,47.692,122.37,1390,5150,61,0,2,2020,5780
1.727e+06,2014,194,4,2.25,3470,8000,1,0,1,3,9,2360,1110,1906,2002,98122,47.615,122.29,3010,8000,108,1,6.25,6480,11470
3.825e+05,2015,464,3,1.5,1090,9862,1,0,0,3,8,1090,0,1987,1987,98074,47.626,122.04,1710,9862,28,0,4.5,2800,10952
2.275e+05,2015,478,3,1,1540,9450,1,0,0,4,7,1540,0,1960,1960,98198,47.361,122.31,1210,9450,55,0,4,2750,10990
3.35e+05,2014,196,3,2.75,2850,8039,1,0,0,4,8,1540,1310,1989,1989,98031,47.414,122.2,2240,7727,25,0,5.75,5090,10577
6.75e+05,2014,291,3,2.5,2320,98445,1,0,0,4,8,1380,940,1978,1978,98072,47.732,122.12,2830,54014,36,0,5.5,5150,56334
2.76e+05,2014,175,4,2.25,2460,11250,1,0,0,4,8,2460,0,1959,1959,98002,47.318,122.21,1630,10216,55,0,6.25,4090,12676
2.973e+05,2015,487,3,1.75,1980,9220,2,0,0,3,8,1980,0,1987,1987,98092,47.26,122.22,2080,8305,28,0,4.75,4060,10285
3.155e+05,2014,236,3,1.75,1870,8400,1,0,0,3,7,990,880,1977,1977,98058,47.454,122.16,1750,8400,37,0,4.75,3620,10270
3.1545e+05,2014,285,3,1.75,1130,7500,1,0,0,4,7,1130,0,1908,1908,98108,47.525,122.32,1240,6000,106,0,4.75,2370,7130
1.233e+05,2014,356,3,1,1150,8050,1,0,0,4,7,1150,0,1956,1956,98032,47.374,122.3,1360,8050,58,0,4,2510,9200
7.18e+05,2014,249,3,2.5,2070,7200,2,0,0,3,8,2070,0,2001,2001,98033,47.695,122.21,1650,8877,13,0,5.5,3720,10947
1.95e+06,2014,284,3,2.5,2510,12779,1,0,4,3,10,2510,0,1968,1968,98034,47.698,122.23,2810,12225,46,0,5.5,5320,14735
8.1524e+05,2014,269,5,2.25,2060,4800,2,0,0,3,8,2060,0,1907,1907,98105,47.66,122.28,1740,4800,107,0,7.25,3800,6860
2.08e+05,2015,436,3,1,920,7314,1,0,0,3,6,920,0,1960,1960,98002,47.289,122.22,1010,7420,55,0,4,1930,8340
3.9e+05,2015,486,4,2.25,3060,7920,1,0,0,3,7,1530,1530,1965,1965,98178,47.488,122.25,1850,7800,50,0,6.25,4910,10860
5.25e+05,2014,189,4,2.75,2910,6308,1,0,0,3,8,1640,1270,1985,1985,98011,47.735,122.2,1970,7127,29,0,6.75,4880,10037
83000,2014,149,2,1,900,8580,1,0,0,3,5,900,0,1918,1918,98168,47.473,122.27,2060,6533,96,0,3,2960,7433
2.5e+05,2014,345,3,1.5,2210,11111,1,0,0,3,7,2210,0,1934,1934,98168,47.492,122.31,1250,8422,80,0,4.5,3460,10632
3.3e+05,2014,310,3,1,1070,10563,1,0,0,3,7,1070,0,1969,1969,98072,47.769,122.17,1840,9638,45,0,4,2910,10708
3.5e+05,2014,259,3,2.5,2440,18674,2,0,0,4,8,2440,0,1994,1994,98042,47.367,122.13,2530,10603,20,0,5.5,4970,13043
1.76e+05,2014,216,2,1,770,5200,1,0,0,5,6,770,0,1969,1969,98042,47.363,122.09,1150,5330,45,0,3,1920,6100
5.35e+05,2015,389,3,3.25,1430,1276,3,0,0,3,8,1430,0,2007,2007,98107,47.671,122.38,1430,1243,8,0,6.25,2860,2673
3.95e+05,2014,292,2,1.75,1400,2500,1,0,0,5,7,710,690,1916,1916,98116,47.563,122.39,1250,5700,98,0,3.75,2650,7100
3.5e+05,2014,194,3,2.25,1322,1796,2,0,0,3,8,1087,235,2005,2005,98144,47.598,122.3,1690,2025,9,0,5.25,3012,3347
3.335e+05,2014,297,3,1.75,1320,7200,1,0,0,4,7,1320,0,1977,1977,98028,47.734,122.24,1750,7260,37,0,4.75,3070,8580
2.805e+05,2014,183,4,2.5,1890,6962,2,0,0,3,8,1890,0,1997,1997,98092,47.333,122.19,2170,6803,17,0,6.5,4060,8693
4.28e+05,2015,407,3,2.5,2230,32660,1,0,0,4,8,2230,0,1977,1977,98042,47.332,122.11,2400,33120,38,0,5.5,4630,35350
4.384e+05,2014,251,2,1,1340,8100,1,0,0,4,7,1340,0,1953,1953,98177,47.722,122.37,1700,8100,61,0,3,3040,9440
6.25e+05,2014,225,4,2.25,2070,7200,1,0,0,5,8,1390,680,1977,1977,98033,47.697,122.17,2110,8400,37,0,6.25,4180,10470
5.62e+05,2015,481,3,1.75,1880,5978,1,0,0,5,7,940,940,1957,1957,98144,47.579,122.29,1930,4770,58,0,4.75,3810,6650
2.95e+05,2014,168,3,2,1380,8682,1,0,0,4,7,1380,0,1966,1966,98148,47.424,122.32,1410,10594,48,0,5,2790,11974
3.9995e+05,2014,202,4,1.5,1850,6125,1,0,0,3,6,1110,740,1945,1945,98126,47.535,122.37,990,6125,69,0,5.5,2840,7975
8.6e+05,2014,317,3,1.75,2180,14135,1,0,2,5,8,1300,880,1947,1947,98033,47.673,122.19,3540,10318,67,0,4.75,5720,12498
6.5e+05,2015,450,3,1,1410,4840,1,0,2,4,6,1230,180,1942,1942,98033,47.665,122.2,1410,5400,73,0,4,2820,6810
1.33e+05,2015,450,3,1,980,9115,1,0,0,3,7,980,0,1968,1968,98198,47.374,122.31,1470,8716,47,0,4,2450,9696
2.23e+05,2014,287,3,1.75,1360,10573,1,0,0,4,7,1360,0,1984,1984,98023,47.298,122.37,1580,8280,30,0,4.75,2940,9640
5.1e+05,2014,272,4,2.75,2730,9112,1,0,2,3,9,1740,990,1996,1996,98198,47.401,122.31,3050,10454,18,0,6.75,5780,13184
2.87e+05,2015,439,3,2.5,1820,8722,1,0,0,3,7,1820,0,1926,2008,98022,47.214,121.99,1480,12285,89,1,5.5,3300,14105
4.4e+05,2014,176,4,2.5,2160,7826,1,0,0,4,7,1390,770,1976,1976,98155,47.775,122.28,2190,9900,38,0,6.5,4350,12060
4.2495e+05,2014,360,3,1.75,2090,7505,1,0,0,3,7,2090,0,1967,1967,98034,47.733,122.19,1510,7416,47,0,4.75,3600,9506
2.99e+05,2014,191,3,2.5,1650,4725,2,0,0,3,8,1650,0,2011,2011,98038,47.355,122.06,2000,4725,3,0,5.5,3650,6375
3.1e+05,2014,286,1,1.5,1120,912,3,0,0,3,7,1120,0,2011,2011,98144,47.592,122.3,1380,3200,3,0,2.5,2500,4320
6.23e+05,2014,170,3,2.5,1850,7777,2,0,0,5,8,1850,0,1989,1989,98033,47.691,122.17,1850,8482,25,0,5.5,3700,10332
6e+05,2014,125,3,1.75,1880,6360,1,0,0,4,7,1040,840,1945,1945,98115,47.688,122.29,1770,6175,69,0,4.75,3650,8055
2.21e+05,2014,352,3,1,980,7606,1,0,0,3,7,980,0,1954,1954,98188,47.436,122.29,980,8125,60,0,4,1960,9105
3.845e+05,2015,471,2,1,1130,5236,1,0,0,4,6,1130,0,1942,1942,98146,47.51,122.39,1010,5320,73,0,3,2140,6450
7.82e+05,2015,362,4,3.5,3780,7769,2,0,0,3,9,3110,670,2001,2001,98052,47.691,122.13,3310,7945,14,0,7.5,7090,11725
4.31e+05,2014,129,4,2.25,2170,10500,1,0,2,4,8,1270,900,1960,1960,98166,47.439,122.34,2080,11019,54,0,6.25,4250,13189
1.66e+06,2014,285,4,3.25,4240,11189,2,0,2,3,10,4240,0,2006,2006,98033,47.653,122.19,3390,12540,8,0,7.25,7630,16780
2.105e+05,2014,265,2,1.75,2040,8600,1,0,0,4,6,1430,610,1985,1985,98003,47.276,122.31,1310,7859,29,0,3.75,3350,9899
2.75e+05,2014,318,3,1,1370,17859,1,0,0,4,7,1150,220,1930,1930,98024,47.562,121.86,1460,47044,84,0,4,2830,48414
7.6e+05,2014,201,3,2.5,2050,15020,1,0,2,3,9,1600,450,1960,1960,98177,47.759,122.37,2930,15050,54,0,5.5,4980,17100
3.75e+05,2014,277,4,3,2420,9566,2,0,0,3,7,2420,0,2003,2003,98188,47.469,122.27,2420,9135,11,0,7,4840,11555
2.35e+05,2014,143,2,1,1140,1730,1,0,0,3,8,1010,130,2007,2007,98126,47.549,122.37,1360,1730,7,0,3,2500,2870
3.35e+05,2014,356,2,2,1420,5185,1,0,0,3,7,1420,0,2004,2004,98038,47.354,122.02,2140,4890,10,0,4,3560,6310
5.25e+05,2014,181,2,2.5,1160,1458,2,0,0,3,8,1040,120,2012,2012,98119,47.638,122.37,1650,2311,2,0,4.5,2810,3471
4.65e+05,2014,265,3,1,1100,1.4549e+05,1,0,0,4,6,1100,0,1915,1915,98024,47.57,121.9,1100,11610,99,0,4,2200,12710
5.5e+05,2014,303,3,1.5,1340,6000,1,0,0,4,7,1340,0,1960,1960,98040,47.587,122.25,1590,9000,54,0,4.5,2930,10340
6.575e+05,2014,258,4,1.5,1910,5000,1,0,0,3,7,1610,300,1912,1912,98105,47.66,122.29,2170,5000,102,0,5.5,4080,6910
2.35e+05,2014,266,3,1,960,5030,1,0,0,3,7,960,0,1955,1955,98118,47.561,122.28,1460,5400,59,0,4,2420,6360
8.42e+05,2014,196,4,1.75,2170,9525,1,0,0,3,8,2170,0,1960,1960,98040,47.569,122.22,1910,9525,54,0,5.75,4080,11695
7.425e+05,2015,487,2,3,2020,5000,1,0,0,3,8,1350,670,1952,1952,98117,47.676,122.38,1160,1118,63,0,5,3180,3138
3.93e+05,2014,249,3,2.25,2140,10256,2,0,0,3,8,2140,0,1987,1987,98038,47.375,122.04,2040,11717,27,0,5.25,4180,13857
8.5845e+05,2015,437,3,4.25,3840,9751,2,0,0,3,10,3840,0,1998,1998,98074,47.635,122.06,3230,7189,17,0,7.25,7070,11029
6.54e+05,2014,170,3,3.25,1530,1565,2,0,0,3,8,1280,250,2005,2005,98122,47.618,122.31,1530,1381,9,0,6.25,3060,2911
1.15e+06,2014,321,3,2.75,3230,75889,2,1,4,3,7,3230,0,1925,1993,98023,47.334,122.37,2560,72229,89,1,5.75,5790,75459
3.33e+05,2014,318,5,1.75,1240,8936,1,0,0,3,7,1240,0,1954,1954,98006,47.574,122.14,1600,9341,60,0,6.75,2840,10581
4.35e+05,2015,486,4,3,2270,7245,1,0,0,3,7,1410,860,1979,1979,98155,47.772,122.31,1740,7571,36,0,7,4010,9841
2e+05,2014,353,3,1,960,10815,1,0,0,5,5,960,0,1900,1900,98010,47.309,122.01,1330,10815,114,0,4,2290,11775
4.45e+05,2014,359,3,1,1260,8910,1,0,0,4,7,1260,0,1949,1949,98117,47.7,122.38,1560,8910,65,0,4,2820,10170
2.499e+05,2014,243,3,1,1100,5000,1,0,0,3,7,1100,0,1960,1960,98118,47.543,122.28,1020,5000,54,0,4,2120,6100
3.85e+05,2014,122,3,3.25,1320,1327,2,0,0,3,8,1040,280,2008,2008,98199,47.651,122.38,1440,1263,6,0,6.25,2760,2583
1.81e+06,2015,422,5,2.5,4250,20441,1,0,1,4,11,2490,1760,1984,1984,98004,47.638,122.21,3620,16304,31,0,7.5,7870,20554
1.14e+06,2014,175,4,2.25,3310,1.2763e+05,2,0,0,5,9,3310,0,1924,1956,98072,47.732,122.13,3830,43959,90,1,6.25,7140,47269
1.92e+05,2014,326,3,1.75,1240,10361,1,0,0,3,6,1240,0,1987,1987,98042,47.37,122.15,1240,8834,27,0,4.75,2480,10074
1.94e+06,2015,465,5,3.5,4230,16526,2,0,0,3,10,4230,0,2008,2008,98004,47.593,122.2,3000,12362,7,0,8.5,7230,16592
2.62e+05,2014,149,2,1,1500,4120,1,0,0,3,5,880,620,1928,1928,98055,47.486,122.2,1300,4120,86,0,3,2800,5620
3.9e+05,2014,155,3,2,1463,868,3,0,0,3,7,1463,0,2003,2003,98115,47.684,122.32,1484,4320,11,0,5,2947,5783
2.55e+05,2014,265,5,3.75,2800,9900,1,0,0,3,7,2800,0,1964,1964,98023,47.319,122.34,1700,13200,50,0,8.75,4500,16000
4e+05,2014,332,3,1.75,1920,9102,1,0,0,3,7,1920,0,1968,1968,98072,47.749,122.08,1920,9760,46,0,4.75,3840,11680
2.15e+05,2015,374,2,1.5,1120,1312,2,0,0,3,7,1000,120,2004,2004,98106,47.534,122.36,1560,1314,11,0,3.5,2680,2434
4.71e+05,2014,313,4,1.75,1450,3750,1,0,0,4,7,950,500,1925,1925,98105,47.671,122.3,1850,4000,89,0,5.75,3300,5450
6.06e+05,2014,126,4,2.5,2110,13850,2,0,0,3,9,2110,0,1987,1987,98027,47.55,122.08,2520,10194,27,0,6.5,4630,12304
4.53e+05,2014,317,3,1.75,1430,20193,1,0,0,3,7,1430,0,1955,1955,98006,47.562,122.18,2140,18364,59,0,4.75,3570,19794
2.7e+05,2014,292,3,2,1560,8853,1,0,0,3,7,1560,0,1967,1967,98058,47.431,122.17,1610,8750,47,0,5,3170,10310
4.75e+05,2014,318,2,2.5,1620,14467,2,0,0,3,7,1620,0,1981,1981,98074,47.631,122.03,1470,13615,33,0,4.5,3090,15235
6.15e+05,2014,140,4,2.75,2820,13193,1,0,0,3,8,1860,960,1965,1965,98006,47.558,122.17,2580,13193,49,0,6.75,5400,16013
6.7495e+05,2014,252,4,3.5,2650,3127,2,0,0,3,8,2230,420,2011,2011,98027,47.538,122.05,2330,3137,3,0,7.5,4980,5787
1.4849e+06,2014,263,5,2.5,4570,19252,2,0,0,5,10,4570,0,1965,1965,98040,47.555,122.22,3180,13314,49,0,7.5,7750,17884
3.59e+05,2014,176,5,1.75,1940,6654,1,0,0,4,7,1940,0,1953,1953,98166,47.466,122.36,2300,9500,61,0,6.75,4240,11440
2.28e+05,2014,196,2,1,1800,9236,1,0,0,3,7,1800,0,1954,1954,98030,47.379,122.2,1730,5701,60,0,3,3530,7501
95000,2014,342,2,1,800,8550,1,0,0,3,7,800,0,1947,1947,98198,47.407,122.29,1490,8550,67,0,3,2290,9350
4.6e+05,2014,243,3,2.25,2080,50965,1,0,0,3,8,1590,490,1979,1979,98077,47.751,122.06,2270,51836,35,0,5.25,4350,53916
1.0353e+06,2014,348,4,2.5,2830,5932,2,0,0,3,9,2830,0,2014,2014,98199,47.648,122.41,2840,5593,0,0,6.5,5670,8423
3.6995e+05,2015,484,3,2,1520,4000,1,0,0,5,6,800,720,1943,1943,98106,47.531,122.35,1430,4000,72,0,5,2950,5520
3.2e+05,2014,187,3,1,1120,10576,1,0,0,4,7,1120,0,1969,1969,98077,47.758,122.07,1300,10000,45,0,4,2420,11120
6.15e+05,2015,452,4,1.5,1980,3240,1,0,0,4,8,1780,200,1930,1930,98144,47.584,122.29,2250,4000,85,0,5.5,4230,5980
1.9e+06,2015,465,3,3.75,3150,8550,2,0,0,3,10,3150,0,2007,2007,98112,47.639,122.28,2510,8550,8,0,6.75,5660,11700
6.35e+05,2014,305,4,2.5,4260,36360,1,0,0,4,8,4100,160,1935,1935,98155,47.764,122.3,2430,17888,79,0,6.5,6690,22148
3.85e+05,2015,365,2,1.5,1370,1.5987e+05,1,0,0,3,7,1370,0,1960,1960,98072,47.759,122.09,1370,16217,55,0,3.5,2740,17587
5.8e+05,2014,300,3,2.25,1670,7416,1,0,0,4,7,1220,450,1974,1974,98005,47.603,122.17,1710,7416,40,0,5.25,3380,9086
4.55e+05,2014,313,3,2.5,2090,8653,2,0,0,3,8,2090,0,1989,1989,98011,47.75,122.18,2090,6396,25,0,5.5,4180,8486
5.499e+05,2014,196,3,1.5,1380,3031,1,0,0,4,7,1380,0,1929,1929,98117,47.689,122.38,1440,4005,85,0,4.5,2820,5385
2.6e+05,2014,205,3,2,1170,5450,1,0,0,5,6,1170,0,1902,1902,98118,47.528,122.27,1340,6384,112,0,5,2510,7554
8.435e+05,2014,337,3,2.5,3560,11448,2,0,0,3,11,3560,0,1997,1997,98052,47.713,122.1,3290,11506,17,0,5.5,6850,15066
7.5e+05,2014,349,4,2.25,3140,12150,2,0,0,3,9,3140,0,1979,1979,98074,47.636,122.05,2370,12054,35,0,6.25,5510,15194
2.56e+05,2015,425,4,1.75,1270,6825,1,0,2,3,7,1270,0,1950,1950,98178,47.505,122.24,1800,6930,65,0,5.75,3070,8200
2.25e+05,2014,143,2,1,1300,11867,1,0,0,4,6,1300,0,1975,1975,98010,47.322,121.9,820,11867,39,0,3,2120,13167
1.26e+06,2015,450,2,1.5,2700,7225,1,0,4,3,8,1660,1040,1910,2008,98116,47.589,122.38,2970,5150,105,1,3.5,5670,7850
5.5e+05,2015,458,3,1.75,1360,5850,1,0,0,4,7,1000,360,1938,1938,98116,47.571,122.39,1540,5850,77,0,4.75,2900,7210
3.5e+05,2015,478,4,2.25,1770,7778,2,0,0,3,7,1770,0,1998,1998,98031,47.419,122.2,1770,7591,17,0,6.25,3540,9361
2.5e+05,2014,353,3,1.5,1072,4339,2,0,0,3,7,1072,0,2009,2009,98042,47.386,122.16,1443,4341,5,0,4.5,2515,5413
4.1e+05,2015,488,3,1,1190,5280,1,0,0,4,7,1190,0,1957,1957,98146,47.513,122.38,1280,5280,58,0,4,2470,6470
1.195e+06,2014,183,5,3,3420,18129,2,0,0,3,9,2540,880,1952,2005,98040,47.533,122.22,3750,16316,62,1,8,7170,19736
5.8995e+05,2014,175,5,3,2790,19439,1,0,3,5,7,1500,1290,1973,1973,98058,47.409,122.09,1620,19439,41,0,8,4410,22229
5.33e+05,2015,479,3,3,1280,1085,3,0,0,3,8,1280,0,2004,2004,98103,47.657,122.35,1300,1310,11,0,6,2580,2590
2.6e+05,2014,147,3,2,1630,8018,1,0,0,3,7,1630,0,2003,2003,98001,47.264,122.24,1610,8397,11,0,5,3240,10027
2.75e+05,2015,399,3,2.5,1560,4244,2,0,0,3,7,1560,0,2002,2002,98038,47.383,122.03,1670,4251,13,0,5.5,3230,5811
8.2e+05,2015,376,4,2.75,2420,4635,1,0,0,5,7,2420,0,1905,1905,98103,47.682,122.35,1590,3150,110,0,6.75,4010,5570
6.6e+05,2015,438,3,2.25,1700,12615,1,0,0,4,7,1300,400,1990,1990,98033,47.697,122.2,1950,13163,25,0,5.25,3650,14863
4.5e+05,2014,334,4,1.75,1850,7730,1,0,0,5,7,1100,750,1956,1956,98133,47.748,122.36,2260,8581,58,0,5.75,4110,10431
7e+05,2014,148,2,1.75,2320,5500,1,0,2,3,8,1720,600,1925,2000,98144,47.586,122.29,2380,5000,89,1,3.75,4700,7320
9.85e+05,2014,129,4,2.25,4230,37769,2,0,0,3,11,4230,0,1989,1989,98077,47.729,122.08,3890,37034,25,0,6.25,8120,41264
7.38e+05,2014,242,5,3.5,2790,16952,2,0,2,3,10,1970,820,1991,1991,98166,47.438,122.35,2980,17281,23,0,8.5,5770,20071
2.57e+05,2014,155,4,2.75,2330,7642,1,0,0,3,8,1800,530,1990,1990,98023,47.295,122.37,2320,7933,24,0,6.75,4650,10263
3.84e+05,2014,255,5,2.75,3220,8160,2,0,0,3,9,3220,0,1999,1999,98001,47.315,122.25,2876,11521,15,0,7.75,6096,14741
3.4e+05,2015,407,3,2.5,2240,6000,2,0,0,3,8,2240,0,2003,2003,98059,47.484,122.14,2400,6000,12,0,5.5,4640,8240
3.765e+05,2014,209,3,2,1630,7800,1,0,0,5,7,1630,0,1950,1950,98125,47.733,122.31,1470,7800,64,0,5,3100,9430
1.785e+05,2014,231,2,1,930,3447,1,0,0,4,8,930,0,1978,1978,98198,47.382,122.32,1160,3447,36,0,3,2090,4377
7.829e+05,2014,176,4,3.25,3060,3898,2,0,0,3,10,2300,760,2014,2014,98027,47.531,122.07,2920,3448,0,0,7.25,5980,6508
4.925e+05,2014,201,4,2.75,2760,18306,1,0,0,3,7,1630,1130,1978,1978,98034,47.73,122.22,2470,9856,36,0,6.75,5230,12616
5.1e+05,2014,262,3,2,1600,4510,1,0,0,3,7,990,610,1978,1978,98103,47.694,122.34,1580,4561,36,0,5,3180,6161
3.9875e+05,2014,125,3,2.5,2230,4000,2,0,0,3,7,2230,0,1954,1954,98144,47.58,122.31,1310,4000,60,0,5.5,3540,6230
6.5e+05,2015,473,3,1.75,2330,7200,1,0,0,4,8,1320,1010,1950,1950,98118,47.565,122.27,1820,7200,65,0,4.75,4150,9530
2.25e+05,2015,386,3,2.5,1020,2040,2,0,0,3,7,720,300,2004,2004,98106,47.529,122.36,1060,1478,11,0,5.5,2080,2498
2.45e+05,2014,135,3,1.75,1490,6930,1,0,0,4,7,1490,0,1990,1990,98030,47.368,122.18,1880,6861,24,0,4.75,3370,8351
4.4e+05,2014,162,3,1,1210,5750,1,0,0,4,7,1210,0,1910,1910,98136,47.54,122.39,1160,5000,104,0,4,2370,6210
5e+05,2015,417,4,2.25,2030,8517,1,0,0,4,8,1380,650,1961,1961,98006,47.55,122.17,2230,8824,54,0,6.25,4260,10854
4.01e+05,2014,331,3,2.75,2020,9505,1,0,0,3,7,1260,760,1969,1969,98011,47.74,122.2,2080,11901,45,0,5.75,4100,13921
5.45e+05,2015,473,3,2,1550,4000,1,0,0,3,7,940,610,1955,1955,98199,47.638,122.39,1880,4000,60,0,5,3430,5550
8.38e+05,2015,466,4,2.5,2560,7210,2,0,0,3,9,2560,0,2006,2006,98136,47.553,122.39,2160,10439,9,0,6.5,4720,12999
8.85e+05,2015,463,4,2.5,2620,9157,2,0,0,3,8,2620,0,1996,1996,98033,47.692,122.2,2240,7405,19,0,6.5,4860,10025
3.65e+05,2014,122,3,1,1090,6435,1,0,0,4,7,1090,0,1955,1955,98106,47.533,122.36,1340,6435,59,0,4,2430,7525
2.999e+05,2014,141,3,2.5,2720,6014,2,0,0,3,7,2720,0,2002,2002,98092,47.334,122.17,2760,6537,12,0,5.5,5480,9257
3.25e+05,2014,147,3,1.75,1780,13095,1,0,0,4,9,1780,0,1983,1983,98042,47.367,122.15,2750,13095,31,0,4.75,4530,14875
3.8e+05,2015,484,4,1,1200,2171,1,0,0,3,7,1200,0,1933,1933,98133,47.708,122.34,1130,1598,82,0,5,2330,2798
8.4e+05,2014,132,4,2.75,2600,2750,1,0,0,3,7,1620,980,1936,1936,98119,47.641,122.36,1960,3705,78,0,6.75,4560,6305
2.95e+05,2014,145,3,2.5,1560,4200,2,0,0,3,7,1560,0,2003,2003,98038,47.384,122.03,1560,4200,11,0,5.5,3120,5760
3.55e+05,2014,266,3,2,2160,8091,1,0,0,3,8,2160,0,2000,2000,98003,47.347,122.3,2190,8297,14,0,5,4350,10457
4.52e+05,2014,239,2,1,1220,6000,1,0,0,3,6,880,340,1938,1938,98118,47.565,122.27,1220,6840,76,0,3,2440,8060
2.14e+05,2015,399,3,2,1580,5080,1,0,0,4,6,800,780,1942,1942,98146,47.496,122.35,1580,7114,73,0,5,3160,8694
4.52e+05,2014,208,6,2.25,2660,13579,2,0,0,3,7,2660,0,1937,1990,98125,47.714,122.29,1120,8242,77,1,8.25,3780,10902
4e+05,2014,174,3,2,1230,11413,1,0,0,3,7,990,240,1984,1984,98074,47.632,122.03,1570,11517,30,0,5,2800,12747
1.4e+06,2014,214,4,2.5,4040,9630,1,0,3,4,9,2020,2020,1951,1951,98199,47.641,122.41,3160,8025,63,0,6.5,7200,12065
3.2e+05,2014,153,3,3.25,1530,1602,2,0,0,3,8,1140,390,2013,2013,98106,47.556,122.36,1450,1198,1,0,6.25,2980,2728
3.12e+05,2014,295,3,2.5,1750,4076,2,0,0,3,7,1750,0,2013,2013,98038,47.36,122.05,1810,4090,1,0,5.5,3560,5840
3.85e+05,2014,320,3,2.25,1680,8450,1,0,0,3,8,1340,340,1960,1960,98177,47.758,122.36,1850,8300,54,0,5.25,3530,9980
6.58e+05,2014,149,4,2.75,3310,6166,2,0,0,3,9,3310,0,2008,2008,98065,47.521,121.88,3200,7027,6,0,6.75,6510,10337
6.75e+05,2014,194,4,2.5,2900,5505,2,0,0,3,8,2900,0,2002,2002,98074,47.606,122.02,2970,5251,12,0,6.5,5870,8151
4.18e+05,2014,237,3,2,1250,1306,3,0,0,3,7,1250,0,2001,2001,98107,47.67,122.39,1320,1250,13,0,5,2570,2500
4.75e+05,2014,317,5,2,2040,6180,2,0,0,4,7,2040,0,1908,1908,98118,47.55,122.28,1870,4365,106,0,7,3910,6405
9e+05,2014,319,2,1,1240,5500,1,0,0,3,7,1240,0,1954,1954,98102,47.646,122.32,2080,4400,60,0,3,3320,5640
4.16e+05,2015,457,3,2.5,1790,11542,1,0,0,5,7,1190,600,1969,1969,98059,47.512,122.16,1790,9131,46,0,5.5,3580,10921
7.15e+05,2014,259,4,3.5,3260,1.1058e+05,2,0,0,3,10,3260,0,1997,1997,98053,47.644,122,3470,97895,17,0,7.5,6730,1.0116e+05
8.25e+05,2014,242,4,3.25,4110,14219,2,0,2,4,10,2570,1540,1979,1979,98028,47.738,122.26,2760,12283,35,0,7.25,6870,16393
6.135e+05,2015,477,4,2.5,3020,6068,2,0,0,3,9,3020,0,2006,2006,98072,47.773,122.16,3240,5757,9,0,6.5,6260,8777
4.55e+05,2014,333,4,2.5,2811,7251,2,0,0,3,9,2811,0,2009,2009,98038,47.369,122.06,3040,7250,5,0,6.5,5851,10061
2.85e+05,2015,367,3,1.5,1400,7582,1,0,0,3,7,1400,0,1956,1956,98148,47.454,122.33,1280,7872,59,0,4.5,2680,9272
4.39e+05,2014,276,2,2.5,1350,944,2,0,0,3,9,870,480,2004,2004,98116,47.559,122.39,1440,1350,10,0,4.5,2790,2700
4.49e+05,2014,361,3,1.75,1660,9697,1,0,0,4,7,1660,0,1952,1952,98155,47.756,122.29,2060,20624,62,0,4.75,3720,22284
6.3e+05,2014,299,4,2.5,3220,14463,2,0,0,3,8,3220,0,1978,1978,98074,47.626,122.05,2550,12109,36,0,6.5,5770,15329
1.85e+05,2014,338,3,1,1240,9198,1,0,0,4,7,1240,0,1959,1959,98032,47.37,122.3,1170,8970,55,0,4,2410,10210
3.95e+05,2015,394,4,3,2750,7965,2,0,0,3,9,2750,0,2012,2012,98038,47.348,122.03,2750,6000,3,0,7,5500,8750
3.4995e+05,2014,313,4,1.5,1420,6720,1,0,0,3,7,1420,0,1925,1925,98108,47.552,122.31,1560,5600,89,0,5.5,2980,7020
1.12e+05,2014,205,1,1,1080,3230,1,0,0,3,6,1080,0,1963,1963,98002,47.307,122.22,1210,5760,51,0,2,2290,6840
1.475e+06,2015,471,3,2.5,2570,5000,2,0,0,3,11,2570,0,1984,1984,98102,47.63,122.32,1570,5000,31,0,5.5,4140,7570
2.3895e+05,2014,303,2,1,810,4838,1,0,0,3,5,810,0,1938,1938,98055,47.491,122.2,890,4838,76,0,3,1700,5648
2.1e+05,2014,176,2,1,720,8040,1,0,0,3,6,720,0,1943,1943,98166,47.466,122.36,2300,9500,71,0,3,3020,10220
4.65e+05,2014,132,3,1.5,2020,11358,1,0,0,4,6,1190,830,1956,1956,98033,47.664,122.19,2370,9520,58,0,4.5,4390,11540
5.9e+05,2014,222,4,2.5,2340,8971,2,0,0,3,9,2340,0,1987,1987,98029,47.568,122.01,2510,9219,27,0,6.5,4850,11559
9.8e+05,2014,228,4,2.5,3780,10962,2,0,0,3,10,3780,0,1990,1990,98033,47.653,122.18,3310,11651,24,0,6.5,7090,15431
4.58e+05,2014,342,4,3,3280,62726,1,0,0,3,7,3280,0,1979,1979,98077,47.751,122.06,3210,73616,35,0,7,6490,76896
7.385e+05,2014,167,3,2.5,2300,6009,1,0,0,3,8,2300,0,2005,2005,98053,47.707,122.01,1640,5931,9,0,5.5,3940,8231
7.55e+05,2014,341,3,2.5,2000,1950,3,0,0,3,8,2000,0,2005,2005,98109,47.648,122.36,1560,1340,9,0,5.5,3560,3340
5.45e+05,2014,181,3,2.5,1530,3210,1,0,0,5,7,1010,520,1928,1928,98117,47.691,122.39,1330,4410,86,0,5.5,2860,5940
5.99e+05,2015,425,5,2.5,3470,12003,2,0,0,3,8,3470,0,1978,1978,98074,47.624,122.05,2220,12283,37,0,7.5,5690,15753
5.4e+05,2014,149,3,1.5,2600,5085,1,0,0,4,7,1400,1200,1940,1940,98126,47.566,122.38,1320,4000,74,0,4.5,3920,6600
3.35e+05,2015,478,3,2,1340,1951,1,0,0,3,6,670,670,1915,1915,98144,47.576,122.31,1520,2248,100,0,5,2860,3588
3.645e+05,2014,266,3,1,1600,4489,1,0,2,3,6,800,800,1944,1944,98126,47.569,122.38,1640,6013,70,0,4,3240,7613
3.389e+05,2015,466,3,1.75,1180,4000,1,0,0,3,7,1040,140,1929,1929,98118,47.523,122.28,1430,4000,86,0,4.75,2610,5180
3.2995e+05,2015,382,4,2.25,2140,8874,2,0,0,3,8,2140,0,1986,1986,98092,47.265,122.22,2140,8789,29,0,6.25,4280,10929
3.35e+05,2014,204,3,1.75,1730,15003,1,0,0,3,7,1150,580,1980,1980,98014,47.692,121.92,1900,15483,34,0,4.75,3630,17213
4.46e+05,2014,176,2,1.5,1370,1221,2,0,0,3,8,1080,290,2008,2008,98122,47.604,122.31,1560,2081,6,0,3.5,2930,3451
8.45e+05,2014,269,5,2,1720,9972,1,0,0,4,8,1720,0,1951,1951,98004,47.637,122.22,2700,9023,63,0,7,4420,10743
2.2e+05,2014,161,3,1,1050,6300,1,0,0,3,6,1050,0,1942,1942,98146,47.513,122.37,740,6300,72,0,4,1790,7350
6.6e+05,2014,334,2,1,960,6263,1,0,1,4,6,960,0,1942,1942,98033,47.665,122.2,1460,6054,72,0,3,2420,7014
9.2e+05,2015,466,4,1.5,1850,3600,2,0,0,3,8,1660,190,1929,1929,98112,47.638,122.31,1970,3600,86,0,5.5,3820,5450
6.6e+05,2015,463,3,2,1140,6000,1,0,0,3,7,1140,0,1909,1909,98109,47.637,122.36,1260,4000,106,0,5,2400,5140
4e+05,2014,292,3,1.75,1470,6682,1,0,0,3,7,1470,0,1987,1987,98034,47.731,122.23,1790,7379,27,0,4.75,3260,8849
6.9e+05,2014,176,5,3.5,2720,7598,2,0,0,3,8,1860,860,1993,1993,98115,47.693,122.28,2430,7728,21,0,8.5,5150,10448
2.44e+05,2014,348,2,1,1180,10200,1,0,0,4,7,1180,0,1955,1955,98148,47.436,122.34,1330,10200,59,0,3,2510,11380
2.05e+05,2015,410,3,2.25,1250,952,3,0,0,3,8,1250,0,2008,2008,98133,47.71,122.33,1250,1030,7,0,5.25,2500,2280
1.265e+06,2015,472,4,3,3130,2646,2,0,0,5,9,2290,840,1906,1906,98102,47.627,122.32,2920,4500,109,0,7,6050,7630
3.08e+05,2014,180,3,1,1010,8800,1,0,0,4,7,1010,0,1954,1954,98118,47.548,122.28,1400,4095,60,0,4,2410,5105
1.25e+06,2015,481,5,3.5,3510,4798,2,0,0,3,10,2700,810,2008,2008,98105,47.669,122.28,1460,1684,7,0,8.5,4970,5194
4.97e+05,2014,243,3,3,2060,1850,2,0,0,3,8,1400,660,2007,2007,98119,47.654,122.37,1910,2951,7,0,6,3970,5011
6.6e+05,2015,445,3,3.5,3600,37982,2,0,0,4,8,3600,0,1996,1996,98014,47.698,121.92,2050,18019,19,0,6.5,5650,21619
4.45e+05,2014,187,2,2,1240,2500,2,0,0,3,7,1240,0,1985,1985,98117,47.679,122.39,1660,5000,29,0,4,2900,6240
1.05e+06,2015,473,6,4,5310,12741,2,0,2,3,10,3600,1710,1967,1967,98040,47.57,122.21,4190,12632,48,0,10,9500,17942
3.924e+05,2015,471,5,2.5,2520,27951,1,0,0,3,7,1890,630,1942,1970,98155,47.773,122.32,1830,14373,73,1,7.5,4350,16893
6.535e+05,2014,312,2,2.5,1680,1240,2,0,0,3,8,1120,560,2014,2014,98102,47.637,122.32,2060,3630,0,0,4.5,3740,5310
4.65e+05,2014,177,4,2.5,3060,6000,2,0,0,3,9,3060,0,2012,2012,98038,47.369,122.06,3040,6000,2,0,6.5,6100,9060
3.72e+05,2014,298,3,2.5,1710,5633,2,0,0,3,7,1710,0,1981,1981,98034,47.723,122.16,1540,5000,33,0,5.5,3250,6710
1.21e+06,2014,283,4,3.25,3330,9000,2,0,0,3,9,2870,460,2004,2004,98033,47.684,122.21,2550,6349,10,0,7.25,5880,9679
3.6e+05,2014,292,4,2.5,2160,9528,2,0,0,3,9,2160,0,1992,1992,98001,47.334,122.25,2280,9937,22,0,6.5,4440,12097
2.45e+05,2015,466,4,1.5,1280,8000,1,0,0,3,6,1280,0,1960,1960,98178,47.495,122.25,1420,8211,55,0,5.5,2700,9491
6.15e+05,2015,460,3,1.75,2620,8280,1,0,0,4,7,1330,1290,1948,1948,98177,47.724,122.36,1530,8160,67,0,4.75,4150,10780
5.59e+05,2015,444,3,1.75,1700,6500,1,0,0,3,8,1700,0,1967,1967,98115,47.684,122.28,1880,6000,48,0,4.75,3580,7700
5.18e+05,2014,166,4,2.5,1740,7500,1,0,0,4,7,1220,520,1976,1976,98052,47.693,122.12,1790,7350,38,0,6.5,3530,9090
2.81e+05,2015,474,3,1.75,1350,8737,1,0,0,3,7,1350,0,1966,1966,98188,47.438,122.28,1600,8928,49,0,4.75,2950,10278
7.3e+05,2014,250,2,1.75,1728,95950,1,0,3,3,9,1728,0,2012,2012,98070,47.458,122.44,1720,35735,2,0,3.75,3448,37463
3e+05,2014,331,3,1.75,1810,21138,1,0,0,4,7,1240,570,1977,1977,98058,47.467,122.18,1850,12200,37,0,4.75,3660,14010
5.3e+05,2014,235,4,2.5,2690,46609,2,0,0,3,8,2690,0,1980,1991,98038,47.384,122.01,1500,34800,34,1,6.5,4190,37490
2.1e+05,2014,231,3,1.75,1400,7300,2,0,0,3,6,1400,0,1948,1948,98178,47.5,122.27,1440,10825,66,0,4.75,2840,12225
1.272e+06,2014,353,4,3.25,3020,4000,1,0,0,5,8,1920,1100,1927,1927,98112,47.639,122.28,2400,4000,87,0,7.25,5420,7020
4.355e+05,2015,375,1,1.75,1020,4512,1,0,0,3,7,770,250,1937,1937,98115,47.672,122.27,1230,5029,78,0,2.75,2250,6049
2.18e+05,2014,143,3,1,960,9633,1,0,0,5,6,960,0,1982,1982,98022,47.195,122,1080,8610,32,0,4,2040,9570
4.5e+05,2014,321,4,2,1570,7320,1,0,0,4,7,1570,0,1960,1960,98007,47.597,122.14,1530,8800,54,0,6,3100,10370
4.1e+05,2014,290,4,2.75,2220,8450,1,0,0,4,7,1260,960,1983,1983,98059,47.48,122.16,1580,8450,31,0,6.75,3800,10670
2.55e+05,2014,129,2,1,960,28717,1,0,0,4,6,960,0,1984,1984,98070,47.336,122.5,1860,28717,30,0,3,2820,29677
7.4e+05,2014,305,3,2.25,3440,44374,2,0,3,4,10,2190,1250,1979,1979,98006,47.547,122.11,3470,40185,35,0,5.25,6910,43625
5.8e+05,2014,188,3,2.25,1940,5980,1,0,0,3,7,1520,420,1987,1987,98027,47.548,122.08,1910,6309,27,0,5.25,3850,8249
2.98e+05,2014,321,4,2.5,2420,3825,2,0,0,3,8,2420,0,2003,2003,98042,47.369,122.13,1880,4250,11,0,6.5,4300,6670
7.69e+05,2015,386,4,3.5,3010,6202,2,0,0,3,9,3010,0,2005,2005,98029,47.553,121.99,2520,5001,10,0,7.5,5530,8011
2.35e+05,2015,422,3,1,1310,15022,1,0,0,3,7,1310,0,1934,1984,98168,47.501,122.33,1530,13154,81,1,4,2840,14464
8.175e+05,2014,245,3,3.25,3230,7639,2,0,0,3,10,3230,0,1999,1999,98074,47.634,122.06,3230,7772,15,0,6.25,6460,11002
2.8e+05,2015,477,3,2.5,1610,10022,2,0,0,3,7,1610,0,1996,1996,98003,47.258,122.3,1820,10017,19,0,5.5,3430,11627
5.35e+05,2014,262,1,1,920,5000,1,0,3,4,7,920,0,1906,1906,98103,47.675,122.35,1890,5000,108,0,2,2810,5920
3.05e+05,2014,167,3,2.25,2110,7665,1,0,0,4,7,1360,750,1973,1973,98023,47.308,122.37,1660,8436,41,0,5.25,3770,10546
4.335e+05,2014,139,3,2.5,2200,3360,2,0,0,3,8,2200,0,2009,2009,98118,47.542,122.29,2130,3423,5,0,5.5,4330,5623
3.75e+05,2015,485,3,2.5,2050,7205,2,0,0,3,8,2050,0,2000,2000,98003,47.349,122.3,2050,7264,15,0,5.5,4100,9314
3.29e+05,2015,485,3,1,900,9600,1,0,0,4,7,900,0,1970,1970,98072,47.742,122.17,1220,8240,45,0,4,2120,9140
2.3e+05,2014,304,3,2,1510,3413,2,0,0,3,7,1510,0,1985,1985,98031,47.391,122.17,1570,3777,29,0,5,3080,5287
5.622e+05,2015,440,3,1.5,1900,5250,1,0,0,4,7,1500,400,1943,1943,98117,47.699,122.39,1810,5250,72,0,4.5,3710,7150
6.575e+05,2014,225,3,1.75,980,6002,1,0,0,4,6,980,0,1942,1942,98033,47.664,122.2,1150,6054,72,0,4.75,2130,7034
2.9197e+05,2015,376,1,1,680,21727,1,0,0,3,5,680,0,1952,1995,98058,47.446,122.17,1470,19406,63,1,2,2150,20086
4.2e+05,2014,203,2,1.75,1060,4182,2,0,0,3,7,1060,0,1977,1977,98115,47.679,122.31,1760,4590,37,0,3.75,2820,5650
2.425e+05,2014,262,3,1.75,1550,1905,2,0,0,3,7,1550,0,2005,2005,98055,47.433,122.19,1550,1866,9,0,4.75,3100,3416
3.11e+05,2014,169,3,1.75,1900,3000,1,0,0,5,7,1070,830,1903,1903,98118,47.526,122.27,1130,6000,111,0,4.75,3030,7900
7.65e+05,2014,216,3,1.75,2440,5800,1,0,3,4,8,1320,1120,1945,1945,98199,47.647,122.41,2530,5800,69,0,4.75,4970,8240
3.6e+05,2014,211,2,2.5,1233,1244,2,0,0,3,7,963,270,2007,2007,98136,47.553,122.38,1230,1300,7,0,4.5,2463,2533
2.957e+05,2014,314,4,2.5,1720,5805,2,0,0,3,8,1720,0,2000,2000,98092,47.329,122.21,2360,7700,14,0,6.5,4080,9420
9.7e+05,2015,414,4,3.25,4740,76230,2,0,0,3,10,4740,0,1987,1987,98075,47.593,122.07,3340,49206,28,0,7.25,8080,53946
8.08e+05,2014,237,3,2.5,2550,6240,1,0,3,5,8,1750,800,1957,1957,98117,47.699,122.39,2180,5200,57,0,5.5,4730,7750
2.99e+05,2014,257,3,2.75,3080,19635,1,0,2,4,7,1610,1470,1958,1958,98032,47.384,122.28,2424,12410,56,0,5.75,5504,15490
3.75e+05,2014,166,4,2,1240,3000,1,0,0,3,7,1040,200,1908,1908,98122,47.608,122.3,1480,3500,106,0,6,2720,4740
2.8e+05,2015,437,3,2.5,1608,4818,2,0,0,3,8,1608,0,2012,2012,98092,47.258,122.2,2009,5200,3,0,5.5,3617,6808
3.99e+05,2014,265,3,1,860,9403,1,0,0,4,6,860,0,1942,1990,98033,47.681,122.17,2136,13009,72,1,4,2996,13869
5.45e+05,2015,380,3,2.5,1740,1279,3,0,0,3,8,1740,0,2008,2008,98116,47.589,122.39,1740,1280,7,0,5.5,3480,3020
1.68e+06,2015,422,3,2.5,4090,16972,2,0,2,3,11,3590,500,2007,2007,98177,47.726,122.37,3740,16972,8,0,5.5,7830,21062
2.35e+05,2015,451,3,1,1060,7473,1,0,0,3,7,1060,0,1959,1959,98198,47.37,122.31,1320,7912,56,0,4,2380,8972
4.53e+05,2014,331,3,2.5,1650,1838,2,0,0,4,7,1270,380,1991,1991,98107,47.667,122.37,1550,1558,23,0,5.5,3200,3208
4.5e+05,2014,290,3,1,1350,10000,1,0,0,4,7,1350,0,1954,1954,98006,47.574,122.13,1450,10000,60,0,4,2800,11350
7.15e+05,2015,457,4,2.5,1860,3840,1,0,0,3,7,1170,690,1928,2014,98117,47.689,122.36,1400,3840,87,1,6.5,3260,5700
5.82e+05,2014,132,4,1.75,2120,4650,1,0,1,3,7,1190,930,1951,1951,98117,47.696,122.4,2070,6487,63,0,5.75,4190,8607
2.45e+05,2014,166,2,1,1200,4880,1,0,0,3,6,980,220,1943,1943,98106,47.528,122.35,1040,4880,71,0,3,2240,6080
3.875e+05,2015,444,4,1.75,2400,9900,1,0,0,3,7,1250,1150,1957,1957,98166,47.463,122.36,1960,9900,58,0,5.75,4360,12300
5.25e+05,2014,152,4,2.5,2910,7631,2,0,2,3,9,2910,0,2006,2006,98038,47.355,122,3190,5552,8,0,6.5,6100,8462
7.9999e+05,2015,408,3,2.5,2850,21780,2,0,0,3,10,2850,0,1994,1994,98053,47.645,122.04,3020,21798,21,0,5.5,5870,24648
6.88e+05,2014,147,4,3,3000,4000,1,0,3,3,8,1970,1030,1913,2014,98144,47.574,122.31,1900,4000,101,1,7,4900,7000
3.35e+05,2014,244,2,1.75,1030,1066,2,0,0,3,7,765,265,2006,2006,98136,47.539,122.39,1030,1106,8,0,3.75,2060,2136
2.199e+05,2014,300,3,1,860,6664,1,0,0,3,6,860,0,1944,1944,98178,47.493,122.25,1150,6857,70,0,4,2010,7717
8.9e+05,2014,125,5,3.5,4490,6000,2,0,0,3,10,3200,1290,2006,2006,98027,47.54,122.07,4530,6000,8,0,8.5,9020,10490
3.085e+05,2014,305,2,2,840,14564,1,0,0,5,6,840,0,1942,1942,98106,47.55,122.36,1430,7920,72,0,4,2270,8760
2.79e+05,2015,414,2,2.75,1770,10534,1,0,0,3,8,1210,560,2003,2003,98001,47.277,122.28,1600,17400,12,0,4.75,3370,19170
5.26e+05,2015,433,3,1.75,1780,37801,1,0,0,3,7,1300,480,1977,1977,98075,47.586,122.02,2380,47480,38,0,4.75,4160,49260
3.06e+05,2014,245,3,1,910,8658,1,0,0,3,7,910,0,1955,1955,98155,47.759,122.3,1170,10200,59,0,4,2080,11110
3.4e+05,2014,291,4,2.5,2180,5367,2,0,0,3,7,2180,0,2000,2000,98038,47.377,122.02,2180,5130,14,0,6.5,4360,7310
5.65e+05,2015,407,2,1.75,1720,3000,1,0,0,5,7,860,860,1925,1925,98103,47.686,122.35,1360,4500,90,0,3.75,3080,6220
2.5e+05,2014,226,2,1,740,6840,1,0,0,5,6,740,0,1942,1942,98126,47.517,122.38,740,6840,72,0,3,1480,7580
7.25e+05,2015,458,4,2.5,2750,13950,1,0,3,4,8,1380,1370,1948,1948,98146,47.494,122.36,2460,13950,67,0,6.5,5210,16700
4.84e+05,2015,416,5,2.5,3600,20001,2,0,0,4,9,3600,0,1976,1976,98166,47.448,122.34,2860,21780,39,0,7.5,6460,25380
2.65e+05,2015,408,2,1.5,920,1458,2,0,0,3,7,920,0,1995,1995,98133,47.708,122.34,1110,1598,20,0,3.5,2030,2518
2.9995e+05,2014,326,3,2.5,1320,3150,2,0,0,3,7,1320,0,2005,2005,98118,47.533,122.28,1390,1725,9,0,5.5,2710,3045
5.4995e+05,2015,430,4,2.5,2230,14694,1,0,0,4,7,1180,1050,1981,1981,98074,47.63,122.03,1470,13458,34,0,6.5,3700,15688
2e+05,2014,286,2,1.75,910,2693,1,0,0,3,6,910,0,2003,2003,98038,47.349,122.03,1360,2693,11,0,3.75,2270,3603
2.245e+05,2014,129,4,1,1430,8355,1,0,0,4,7,1430,0,1983,1983,98092,47.318,122.17,1550,7938,31,0,5,2980,9368
4e+05,2014,265,4,1.5,2150,11026,1,0,0,4,7,2150,0,1952,1952,98028,47.764,122.26,1760,10283,62,0,5.5,3910,12433
3.55e+05,2015,403,4,3,2580,9601,2,0,0,4,7,2130,450,1992,1992,98070,47.373,122.43,1900,10092,23,0,7,4480,12672
5.4e+05,2014,273,4,1.75,1840,4280,1,0,0,4,7,920,920,1918,1918,98105,47.668,122.32,1660,4280,96,0,5.75,3500,6120
2.6e+05,2014,290,2,1,750,6720,1,0,0,3,6,750,0,1916,1916,98108,47.552,122.31,920,6720,98,0,3,1670,7470
2.5995e+05,2014,235,4,2,1540,10212,1,0,0,5,7,1540,0,1948,1948,98022,47.206,122,1480,10212,66,0,6,3020,11752
3.7e+05,2015,395,3,2,1680,5036,1,0,1,4,7,1680,0,1987,1987,98055,47.473,122.19,1680,4921,28,0,5,3360,6601
3.56e+05,2014,345,2,2.25,1230,989,3,0,0,3,8,1230,0,2007,2007,98103,47.697,122.35,1230,1223,7,0,4.25,2460,2453
7.75e+05,2015,472,4,1.75,2320,5595,1,0,0,3,7,1510,810,1956,1956,98199,47.64,122.39,1840,5596,59,0,5.75,4160,7916
5.7e+05,2014,181,4,2.5,2590,8483,2,0,0,3,9,2590,0,1991,1991,98011,47.738,122.22,2660,8717,23,0,6.5,5250,11307
3.65e+05,2014,127,5,2.75,2410,5003,1,0,0,3,7,1410,1000,2008,2008,98118,47.53,122.27,1590,5003,6,0,7.75,4000,7413
5.5e+05,2014,153,4,2.5,2170,9600,1,0,0,3,7,1460,710,1980,1980,98052,47.679,122.12,1940,8400,34,0,6.5,4110,10570
5.89e+05,2014,163,4,3,2440,9600,2,0,0,5,7,2440,0,1961,1961,98034,47.704,122.2,2290,9600,53,0,7,4730,12040
5.19e+05,2015,484,2,2,1560,4823,1,0,0,3,8,1560,0,2004,2004,98053,47.711,122.03,1855,4989,11,0,4,3415,6549
5.6e+05,2015,474,3,2,1300,6000,1,0,0,5,7,1300,0,1943,1943,98136,47.548,122.39,1230,6000,72,0,5,2530,7300
2.4e+05,2014,291,3,1.5,1290,8366,1,0,0,3,7,1020,270,1957,1957,98168,47.485,122.32,1770,8400,57,0,4.5,3060,9690
4.015e+05,2014,222,4,2.5,3140,94525,2,0,0,4,8,2280,860,1977,1977,98042,47.416,122.16,1910,14300,37,0,6.5,5050,17440
5.55e+05,2015,463,4,2.5,2450,5079,2,0,0,3,9,2450,0,2001,2001,98056,47.521,122.19,2690,6675,14,0,6.5,5140,9125
4.09e+05,2014,305,2,1,890,3271,1,0,0,4,6,890,0,1918,1918,98116,47.563,122.38,1190,5175,96,0,3,2080,6065
1.452e+06,2015,439,2,3.25,2070,3128,2,1,3,3,9,1760,310,1988,1988,98075,47.569,122.06,2740,3568,27,0,5.25,4810,5638
4.45e+05,2014,312,5,3,2420,11250,2,0,0,3,8,2420,0,2013,2013,98146,47.508,122.36,1510,9950,1,0,8,3930,12370
4.2e+05,2014,217,3,2.5,1470,1571,2,0,0,3,8,1180,290,2007,2007,98116,47.572,122.39,1580,4329,7,0,5.5,3050,5799
5.81e+05,2015,482,2,1,1170,4080,1,0,0,4,7,1170,0,1909,1909,98117,47.678,122.39,1560,4586,106,0,3,2730,5756
5.4e+05,2014,359,3,2.5,3100,1.0019e+05,1,0,0,4,7,1820,1280,1981,1981,98038,47.393,122.07,2430,1.0498e+05,33,0,5.5,5530,1.0808e+05
2.95e+05,2014,292,3,2.25,1330,7200,1,0,0,3,7,900,430,1974,1974,98146,47.51,122.36,1380,9570,40,0,5.25,2710,10900
3.2495e+05,2014,326,3,2.5,1560,9600,1,0,0,3,7,1210,350,1964,1964,98188,47.457,122.27,2070,9600,50,0,5.5,3630,11160
2.46e+05,2014,319,3,2.5,1650,6675,1,0,0,3,8,1290,360,1990,1990,98023,47.29,122.37,1880,6675,24,0,5.5,3530,8325
2.31e+05,2014,269,3,2,1640,4875,1,0,0,4,7,1040,600,1977,1977,98042,47.366,122.09,1640,5200,37,0,5,3280,6840
6.1808e+05,2014,127,3,2.5,2030,6500,2,0,0,3,8,2030,0,1988,1988,98027,47.565,122.09,2030,8485,26,0,5.5,4060,10515
6.726e+05,2014,211,3,2.25,1520,5750,2,0,0,3,8,1400,120,1908,2006,98116,47.579,122.39,1420,5650,106,1,5.25,2940,7170
4.25e+05,2015,407,5,2.5,2840,9425,1,0,0,4,7,1590,1250,1962,1962,98155,47.761,122.3,1900,11600,53,0,7.5,4740,14440
2.438e+05,2014,176,3,1,1140,27760,1,0,0,4,6,1140,0,1981,1981,98027,47.537,121.97,1690,87300,33,0,4,2830,88440
8.405e+05,2014,195,4,2.25,2290,12174,1,1,4,3,7,1490,800,1948,1948,98178,47.511,122.25,2290,9379,66,0,6.25,4580,11669
2.25e+05,2015,447,3,2.25,1590,9200,1,0,0,4,7,1110,480,1979,1979,98092,47.292,122.18,1880,9200,36,0,5.25,3470,10790
5.99e+05,2015,466,4,1,1590,4280,1,0,0,3,7,1590,0,1924,1924,98103,47.667,122.33,2230,4280,91,0,5,3820,5870
8.6e+05,2014,280,3,1.75,2600,15064,1,0,0,4,8,1700,900,1967,1967,98004,47.64,122.2,2940,14984,47,0,4.75,5540,17584
6.41e+05,2014,291,4,2.5,2600,6015,2,0,0,3,8,2600,0,2004,2004,98075,47.597,122.03,2910,5305,10,0,6.5,5510,7905
1.666e+05,2014,313,3,1.75,1150,8690,1,0,0,4,7,1150,0,1977,1977,98042,47.373,122.11,1330,7040,37,0,4.75,2480,8190
5.1e+05,2014,230,3,2.25,2340,6183,1,0,0,3,7,1210,1130,1929,1929,98115,47.698,122.31,1970,6183,85,0,5.25,4310,8523
3.1648e+05,2015,479,4,2.5,1740,4642,2,0,0,3,7,1740,0,2012,2012,98042,47.369,122.12,1950,4642,3,0,6.5,3690,6382
5.25e+05,2014,190,2,1.5,1340,3600,1,0,0,3,7,1340,0,1903,1903,98119,47.636,122.36,1340,3600,111,0,3.5,2680,4940
6.05e+05,2014,159,3,2.5,2670,47480,2,0,3,3,9,2670,0,1981,1981,98072,47.744,122.11,2760,42800,33,0,5.5,5430,45470
6.25e+05,2014,209,4,2.25,2100,8290,2,0,0,4,8,2100,0,1978,1978,98006,47.559,122.13,2100,8290,36,0,6.25,4200,10390
4.115e+05,2014,269,5,3,2420,7740,1,0,0,5,7,1360,1060,1929,1969,98106,47.536,122.36,1840,6780,85,1,8,4260,9200
3.15e+05,2014,313,2,1,2080,14659,1,0,0,3,7,1040,1040,1960,1960,98178,47.486,122.23,1920,15208,54,0,3,4000,17288
7.79e+05,2015,466,5,2.25,2830,7738,2,0,0,4,8,2830,0,1977,1977,98006,47.558,122.14,2300,9840,38,0,7.25,5130,12670
4.75e+05,2014,161,3,2.25,1630,2520,2,0,0,3,7,1630,0,2005,2005,98029,47.549,122,1630,3131,9,0,5.25,3260,4761
7.06e+05,2015,473,5,2.5,2890,15891,2,0,0,3,9,2890,0,1990,1990,98059,47.529,122.16,2590,10556,25,0,7.5,5480,13446
5.35e+05,2014,127,3,2.5,2280,2289,2,0,0,3,8,1880,400,2006,2006,98027,47.538,122.07,2280,2425,8,0,5.5,4560,4705
1.566e+05,2015,407,2,1.75,1210,9750,1,0,0,3,7,1210,0,1984,1984,98038,47.344,122.04,1650,9750,31,0,3.75,2860,10960
2.1e+05,2014,140,4,1.75,2180,28710,1,0,0,3,8,1180,1000,1950,1950,98198,47.405,122.29,2180,28710,64,0,5.75,4360,30890
7.988e+05,2014,166,3,2.75,2670,3738,1,0,0,3,10,1720,950,2013,2013,98056,47.53,122.2,2610,3734,1,0,5.75,5280,6404
6.25e+05,2015,362,3,2.25,1920,8412,1,0,2,3,8,1460,460,1977,1977,98006,47.558,122.13,2490,8700,38,0,5.25,4410,10620
5.2e+05,2015,431,2,1,1250,3708,1,0,0,3,7,1250,0,1926,1926,98117,47.685,122.36,1430,3708,89,0,3,2680,4958
2.19e+05,2014,244,4,1.5,1370,7944,1,0,0,3,7,1370,0,1961,1961,98198,47.422,122.29,1370,9181,53,0,5.5,2740,10551
9.25e+05,2015,399,3,2.75,3640,10300,1,0,0,4,9,2060,1580,1979,1979,98006,47.561,122.15,3110,10625,36,0,5.75,6750,14265
1.25e+06,2014,212,4,3.25,3160,5000,2,0,0,5,9,2360,800,1965,1965,98105,47.66,122.27,2220,4000,49,0,7.25,5380,7160
5.96e+05,2014,224,4,2.25,2270,10000,1,0,0,5,8,1720,550,1974,1974,98006,47.56,122.14,2270,10148,40,0,6.25,4540,12418
6.265e+05,2014,263,3,1.75,1610,3210,1,0,0,5,7,910,700,1928,1928,98103,47.666,122.33,1420,3210,86,0,4.75,3030,4820
3.7023e+05,2015,451,4,3,2050,4000,2,0,0,3,8,2050,0,2014,2014,98001,47.352,122.28,2050,4000,1,0,7,4100,6050
3.75e+05,2014,291,4,2.5,2990,6145,2,0,0,3,8,2990,0,2003,2003,98003,47.261,122.29,2590,6512,11,0,6.5,5580,9502
2.89e+05,2014,140,3,2.5,2090,4700,2,0,0,3,8,2090,0,2002,2002,98042,47.372,122.1,2740,5040,12,0,5.5,4830,7130
7.8e+05,2014,286,5,2.5,1660,4000,1,0,0,5,8,1660,0,1929,1929,98109,47.645,122.35,1210,4000,85,0,7.5,2870,5660
2.755e+05,2015,416,3,1,1060,7246,1,0,0,4,6,1060,0,1981,1981,98056,47.494,122.17,1090,6694,34,0,4,2150,7754
3.8e+05,2015,464,4,2.5,1940,3200,2,0,0,3,8,1940,0,2004,2004,98058,47.458,122.12,1900,3200,11,0,6.5,3840,5140
2.995e+05,2014,292,3,2.5,2090,7163,2,0,0,3,8,2090,0,1989,1989,98003,47.273,122.3,2320,8634,25,0,5.5,4410,10724
2.02e+05,2014,176,2,1,920,7569,1,0,0,4,6,920,0,1950,1950,98168,47.495,122.3,1280,7627,64,0,3,2200,8547
3.85e+05,2014,334,4,2.5,2630,5701,2,0,0,3,7,2630,0,2010,2010,98042,47.375,122.16,2770,5939,4,0,6.5,5400,8569
9.088e+05,2014,290,3,3,3420,7826,2,0,0,4,8,2430,990,1939,1939,98144,47.587,122.29,980,6300,75,0,6,4400,9720
3e+05,2014,293,3,2.5,1800,3253,2,0,0,3,7,1800,0,2001,2001,98108,47.54,122.29,1800,3081,13,0,5.5,3600,4881
5.9995e+05,2014,312,5,3,2600,13674,1,0,0,5,8,1300,1300,1967,1967,98125,47.718,122.3,2150,7800,47,0,8,4750,10400
4.15e+05,2014,297,3,2,2010,33090,1,0,2,5,8,2010,0,1986,1986,98022,47.213,122.01,1840,22620,28,0,5,3850,24630
4.4695e+05,2014,332,5,2.5,2250,7945,1,0,0,4,7,1360,890,1977,1977,98034,47.732,122.22,1820,7866,37,0,7.5,4070,10116
4.85e+05,2015,463,3,1,1020,9835,1,0,0,5,7,1020,0,1955,1955,98006,47.573,122.18,1210,9622,60,0,4,2230,10642
9.2e+05,2014,284,3,1.75,2480,4000,1,0,0,3,8,1240,1240,1948,2014,98122,47.615,122.29,2450,4000,66,1,4.75,4930,6480
5.59e+05,2014,159,3,1.5,2070,5386,1,0,0,4,7,1140,930,1948,1948,98117,47.69,122.37,1770,5386,66,0,4.5,3840,7456
4.0272e+05,2015,460,3,2.75,1160,1073,2,0,0,3,7,880,280,2007,2007,98144,47.579,122.31,1250,5400,8,0,5.75,2410,6560
6.93e+05,2014,151,3,2.5,2460,12028,2,0,0,3,9,2460,0,1996,1996,98052,47.691,122.09,2540,12229,18,0,5.5,5000,14689
1.79e+05,2014,272,2,1,990,8760,1,0,0,3,7,990,0,1977,1977,98003,47.33,122.31,1560,11880,37,0,3,2550,12870
2.63e+05,2014,140,3,1.75,1570,7775,2,0,0,3,7,1570,0,1982,1982,98031,47.388,122.22,1580,8622,32,0,4.75,3150,10192
9.19e+05,2015,376,4,2.5,3620,17133,1,0,4,3,10,2220,1400,1993,1993,98075,47.56,122.03,3530,17026,22,0,6.5,7150,20646
2.615e+05,2015,437,3,1,1130,3600,1,0,0,3,6,1130,0,1908,1908,98144,47.598,122.3,1710,2231,107,0,4,2840,3361
6.85e+05,2015,431,3,2.5,2370,4950,2,0,0,3,8,2370,0,2003,2003,98029,47.547,122.01,2230,4950,12,0,5.5,4600,7320
4.475e+05,2015,438,2,1,1180,5100,1,0,0,3,7,1180,0,1926,1926,98103,47.695,122.35,980,5100,89,0,3,2160,6280
5.105e+05,2014,223,3,1,1270,8000,1,0,0,4,7,1270,0,1957,1957,98007,47.587,122.14,1470,8000,57,0,4,2740,9270
5.84e+05,2014,155,3,2.5,1480,1485,2,0,0,3,8,1280,200,2007,2007,98102,47.638,122.33,1470,1277,7,0,5.5,2950,2757
7.375e+05,2014,276,4,2.5,3200,36276,2,0,0,3,9,3200,0,1993,1993,98053,47.63,121.99,2930,33171,21,0,6.5,6130,36371
4.15e+05,2014,189,4,1.5,1840,11367,1,0,0,4,7,1840,0,1950,1950,98177,47.766,122.36,1690,9800,64,0,5.5,3530,11640
3.05e+05,2014,211,3,2,1830,10873,1,0,0,3,8,1830,0,1989,1989,98023,47.307,122.39,2490,8976,25,0,5,4320,10806
8.2e+05,2015,374,4,3.5,2770,8049,2,0,0,3,9,2770,0,2002,2002,98074,47.647,122.08,3410,7447,13,0,7.5,6180,10217
3.46e+05,2014,173,3,1.75,1270,8100,1,0,0,3,6,880,390,1950,1950,98146,47.483,122.34,1650,8173,64,0,4.75,2920,9443
3.15e+05,2014,348,3,2.5,2240,6097,2,0,0,3,8,2240,0,2002,2002,98038,47.35,122.04,2240,5574,12,0,5.5,4480,7814
3.15e+05,2014,129,5,1.75,2320,8100,1,0,0,4,7,1160,1160,1956,1956,98166,47.463,122.34,1410,7271,58,0,6.75,3730,9591
4.08e+05,2014,243,2,1,810,7440,1,0,0,5,6,810,0,1948,1948,98133,47.735,122.35,830,7500,66,0,3,1640,8310
5.95e+05,2014,209,4,2.5,2910,7287,2,0,0,3,8,2910,0,1998,1998,98065,47.535,121.87,2420,6180,16,0,6.5,5330,9090
4.8495e+05,2014,298,2,1,1000,4956,1,0,2,4,7,1000,0,1916,1916,98107,47.675,122.36,1830,4959,98,0,3,2830,5959
2.7e+05,2014,313,2,1,1040,5700,1,0,0,3,6,1040,0,1922,1922,98118,47.519,122.26,1380,5700,92,0,3,2420,6740
5.02e+05,2014,277,2,1,1570,4704,1,0,1,3,8,1570,0,1931,1931,98136,47.526,122.39,1820,4704,83,0,3,3390,6274
7.1e+05,2014,177,2,1.5,1640,4080,1,0,0,5,7,1540,100,1916,1916,98105,47.662,122.33,1880,4080,98,0,3.5,3520,5720
1.28e+06,2015,400,5,2.5,3400,9500,2,0,1,4,8,3400,0,1977,1977,98027,47.565,122.08,3080,11081,38,0,7.5,6480,14481
5.25e+05,2015,400,4,2.5,2303,16801,2,0,0,3,8,2303,0,1995,1995,98019,47.727,121.97,2080,14013,20,0,6.5,4383,16316
7.525e+05,2014,235,4,2.25,2360,8616,2,0,0,4,8,2360,0,1974,1974,98033,47.65,122.2,2360,9337,40,0,6.25,4720,11697
3.1e+05,2014,160,4,1,1740,11075,1,0,0,3,7,1740,0,1965,1965,98133,47.746,122.33,1580,7684,49,0,5,3320,9424
1.7495e+05,2014,338,2,1,730,6000,1,0,0,3,6,730,0,1950,1985,98198,47.383,122.3,1750,7200,64,1,3,2480,7930
4.875e+05,2014,209,4,2.5,2810,6296,2,0,0,3,9,2810,0,2013,2013,98059,47.502,122.15,2850,6140,1,0,6.5,5660,8950
1.749e+05,2014,311,3,1,1100,6000,1,0,0,2,6,1100,0,1926,1926,98108,47.528,122.32,960,5880,88,0,4,2060,6980
5.35e+05,2015,485,5,2.5,3190,6178,2,0,0,3,8,3190,0,2003,2003,98059,47.51,122.15,2480,7548,12,0,7.5,5670,10738
2.7e+05,2014,335,3,1.75,1800,7763,1,0,0,3,6,1470,330,1984,1984,98030,47.377,122.18,1440,7483,30,0,4.75,3240,9283
3.997e+05,2014,197,4,1.75,1320,4800,1,0,0,4,7,870,450,1930,1930,98106,47.553,122.36,940,4800,84,0,5.75,2260,6120
4.2e+05,2015,445,3,2.5,1970,3667,2,0,0,3,7,1970,0,2004,2004,98065,47.532,121.85,1970,3739,11,0,5.5,3940,5709
6.132e+05,2014,250,3,2.75,2050,3320,1,0,0,4,7,1580,470,1927,1927,98105,47.672,122.3,1760,4150,87,0,5.75,3810,6200
4.83e+05,2015,456,3,2.25,2100,43560,1,0,0,4,8,1330,770,1977,1977,98077,47.751,122.07,2100,43560,38,0,5.25,4200,45660
8.45e+05,2015,436,3,1.75,1600,2538,2,0,0,3,7,1600,0,1929,1929,98102,47.645,122.33,1660,1750,86,0,4.75,3260,3350
3.295e+05,2015,478,3,2.5,2120,22482,1,0,0,5,7,1360,760,1979,1979,98001,47.341,122.27,2330,16016,36,0,5.5,4450,18136
1.049e+06,2014,188,4,3.75,4740,1.2676e+05,2,0,0,4,10,4740,0,1991,1991,98027,47.445,121.98,3060,1.1805e+05,23,0,7.75,7800,1.2279e+05
3.35e+05,2014,135,3,2.25,2150,30476,2,0,0,3,7,2150,0,1991,1991,98188,47.461,122.28,2010,10800,23,0,5.25,4160,12950
6.3e+05,2014,209,4,2,2670,3240,1,0,0,4,9,1780,890,1930,1930,98144,47.584,122.29,1820,4000,84,0,6,4490,6670
5.1e+05,2014,149,3,1.5,2240,3800,2,0,0,3,8,1370,870,1929,1929,98115,47.689,122.31,1690,4275,85,0,4.5,3930,6515
2.95e+05,2014,190,2,1,740,4459,1,0,2,3,5,740,0,1915,1915,98116,47.57,122.41,1490,4700,99,0,3,2230,5440
6.45e+05,2015,400,3,3.75,2050,6000,2,0,0,5,7,1550,500,1910,1910,98103,47.687,122.33,1780,4000,105,0,6.75,3830,6050
4.66e+05,2014,341,3,1.75,1680,9460,1,0,0,4,7,1680,0,1959,1959,98006,47.553,122.18,1690,9448,55,0,4.75,3370,11128
2.5e+05,2014,232,3,2.25,1960,7414,1,0,0,3,7,1490,470,1984,1984,98023,47.298,122.37,1580,8038,30,0,5.25,3540,9998
2.5075e+05,2014,340,5,1.75,2140,12058,1,0,0,4,8,2140,0,1951,1951,98002,47.317,122.21,1640,10125,63,0,6.75,3780,12265
6.5e+05,2014,194,3,2.5,1910,4363,2,0,0,3,9,1910,0,2006,2006,98029,47.548,122,1890,3732,8,0,5.5,3800,5642
2.58e+05,2014,243,3,2.5,1730,6930,2,0,0,3,8,1730,0,1994,1994,98003,47.262,122.31,1780,6930,20,0,5.5,3510,8660
5.17e+05,2014,345,3,1.75,1740,10000,1,0,0,3,7,1740,0,1976,2009,98074,47.617,122.06,1350,7500,38,1,4.75,3090,9240
4.24e+05,2015,466,4,2.5,2650,8685,2,0,0,3,9,2650,0,2006,2006,98001,47.344,122.27,2650,7932,9,0,6.5,5300,10582
7.1e+05,2015,445,3,2.75,2210,7660,1,0,1,4,7,1460,750,1968,1968,98116,47.562,122.4,2110,8750,47,0,5.75,4320,10960
9.69e+05,2014,215,4,2,2450,5000,2,0,4,5,8,2200,250,1919,1919,98116,47.562,122.41,2360,6090,95,0,6,4810,8540
3.9595e+05,2014,250,5,3.5,2738,6031,2,0,0,3,8,2738,0,2014,2014,98023,47.296,122.35,2738,5201,0,0,8.5,5476,7939
4.7999e+05,2014,215,3,2.5,2010,2386,2,0,0,3,8,1390,620,2014,2014,98029,47.553,122,1690,1870,0,0,5.5,3700,3880
2.5e+05,2014,334,3,2,1660,13085,1,0,0,3,7,1010,650,1985,1985,98001,47.33,122.28,1660,7778,29,0,5,3320,9438
5.3e+05,2015,396,3,1,1500,5750,1,0,0,4,7,1050,450,1927,1927,98126,47.568,122.38,1500,5060,88,0,4,3000,6560
4e+05,2015,432,2,1,1220,6300,1,0,0,3,7,760,460,1942,1942,98136,47.53,122.39,1850,4886,73,0,3,3070,6106
3.05e+05,2014,163,3,1.5,1210,5240,1,0,0,4,7,610,600,1983,1983,98106,47.552,122.36,1560,5240,31,0,4.5,2770,6450
3.89e+05,2014,202,2,2,1340,4122,1,0,0,3,8,1340,0,2007,2007,98053,47.718,122.02,1350,4273,7,0,4,2690,5613
2.0842e+05,2014,324,2,1,840,4200,1,0,0,3,5,840,0,1938,1938,98108,47.529,122.32,830,5000,76,0,3,1670,5840
1.22e+05,2015,387,2,1,860,6000,1,0,0,3,6,860,0,1945,1945,98022,47.211,121.98,1300,6000,70,0,3,2160,6860
1.418e+05,2014,139,2,1,930,4743,1,0,0,4,5,930,0,1942,1942,98056,47.497,122.19,930,4779,72,0,3,1860,5709
8.8e+05,2015,457,3,1.75,2070,5000,1,0,0,3,8,2070,0,1920,1920,98144,47.583,122.29,2630,5000,95,0,4.75,4700,7070
1.75e+05,2014,154,2,1,670,2378,1,0,0,3,5,670,0,1919,1919,98126,47.577,122.37,700,2970,95,0,3,1370,3640
6.31e+05,2015,458,4,2,1930,3240,1,0,0,4,7,1930,0,1911,1911,98122,47.616,122.3,1480,3600,104,0,6,3410,5530
8.8474e+05,2014,203,4,3.5,4210,9414,2,0,0,3,9,4210,0,2001,2001,98074,47.607,122.02,3950,8880,13,0,7.5,8160,13090
7.2e+05,2014,188,4,2.25,2410,8400,2,0,0,5,8,2410,0,1965,1965,98008,47.626,122.12,1910,8056,49,0,6.25,4320,10466
4.34e+05,2014,277,3,1.75,1660,8301,1,0,0,5,7,1660,0,1955,1955,98028,47.765,122.26,1660,9489,59,0,4.75,3320,11149
2.3e+05,2015,450,3,2.25,1490,8722,2,0,0,3,7,1490,0,1997,1997,98030,47.365,122.19,1510,8061,18,0,5.25,3000,9551
2.7e+05,2014,218,5,2.5,2630,8470,1,0,0,4,8,2630,0,1968,1968,98002,47.286,122.2,1780,8575,46,0,7.5,4410,11205
2.5995e+05,2015,486,3,2,1010,7896,1,0,0,3,7,1010,0,1984,1984,98031,47.405,122.18,1540,7896,31,0,5,2550,8906
7.7e+05,2014,319,3,1,2230,3200,2,0,2,3,8,1630,600,1918,1918,98109,47.633,122.36,2280,5400,96,0,4,4510,7630
4.14e+05,2015,457,2,1,800,5000,1,0,0,3,6,800,0,1938,1938,98055,47.491,122.2,1220,5000,77,0,3,2020,5800
1.44e+06,2014,284,4,1.75,2410,6000,1,0,0,3,8,2410,0,1911,1911,98109,47.637,122.36,1280,4000,103,0,5.75,3690,6410
7.21e+05,2015,481,4,2,2280,8339,1,0,0,4,7,1220,1060,1954,1954,98115,47.699,122.3,1970,8340,61,0,6,4250,10620
7.32e+05,2014,182,3,3.75,2670,6517,2,0,4,4,8,2020,650,1977,1977,98126,47.57,122.38,2010,6073,37,0,6.75,4680,8743
2.944e+05,2014,324,4,2.5,1788,10183,2,0,0,4,7,1788,0,1990,1990,98002,47.288,122.22,1700,6600,24,0,6.5,3488,8388
6.35e+05,2014,242,3,3.5,1730,1349,3,0,0,3,9,1350,380,2009,2009,98102,47.622,122.33,1830,3300,5,0,6.5,3560,5030
2.75e+05,2015,488,2,1,910,4191,1,0,0,3,6,910,0,1910,1910,98117,47.693,122.36,1480,6050,105,0,3,2390,6960
8.4e+05,2014,148,4,1.75,2330,4000,2,0,0,5,8,1300,1030,1924,1924,98105,47.666,122.29,2040,4000,90,0,5.75,4370,6330
6.75e+05,2014,140,4,3,2690,28300,1,0,0,3,8,2690,0,1954,1999,98166,47.446,122.34,2820,27100,60,1,7,5510,29790
3.5e+05,2014,229,4,2.5,2810,10433,2,0,0,3,8,2810,0,2001,2001,98022,47.19,122.02,2640,9240,13,0,6.5,5450,12050
5.79e+05,2014,214,3,1,1590,5400,1,0,1,3,8,1280,310,1948,1948,98118,47.551,122.26,2140,7161,66,0,4,3730,8751
6.2114e+05,2014,148,3,2.25,2180,7741,2,0,0,3,9,2180,0,1986,1986,98074,47.648,122.07,2300,8581,28,0,5.25,4480,10761
2.7495e+05,2015,380,3,2,1410,7265,1,0,0,4,7,1410,0,1983,1983,98042,47.365,122.08,1390,8060,32,0,5,2800,9470
2.7e+05,2014,238,2,1,1000,10320,1,0,0,3,6,1000,0,1943,1943,98106,47.527,122.36,1100,5160,71,0,3,2100,6160
6.7e+05,2014,176,3,1.5,1490,4400,1,0,0,4,7,1490,0,1906,1906,98122,47.611,122.29,1560,4400,108,0,4.5,3050,5890
6.35e+05,2015,443,4,2.5,2570,27972,2,0,0,3,8,2570,0,1997,1997,98053,47.634,121.97,2500,29761,18,0,6.5,5070,32331
9.21e+05,2014,166,4,1.5,2220,9496,1,0,0,4,7,1490,730,1954,1954,98004,47.623,122.21,1800,8286,60,0,5.5,4020,10506
8.299e+05,2015,413,4,3.5,3840,4000,2,0,0,3,8,2640,1200,2001,2001,98105,47.664,122.29,1620,4000,14,0,7.5,5460,7840
2.45e+05,2014,180,3,2.75,1300,14197,1,0,0,3,7,860,440,1996,1996,98030,47.365,122.18,1550,7596,18,0,5.75,2850,8896
4.75e+05,2015,440,5,2.75,3100,5298,2,0,0,3,7,3100,0,2007,2007,98065,47.537,121.89,2440,5250,8,0,7.75,5540,8350
5.871e+05,2015,445,3,2.25,1670,6414,1,0,0,4,8,1670,0,1961,1961,98117,47.692,122.39,2130,7035,54,0,5.25,3800,8705
1.2e+06,2014,232,3,3.5,4310,10842,2,0,2,3,10,3140,1170,1988,1988,98177,47.773,122.39,2280,11106,26,0,6.5,6590,15416
5.2e+05,2015,478,3,1.5,1580,8841,1,0,0,5,7,1180,400,1923,1923,98103,47.693,122.35,1580,7512,92,0,4.5,3160,9092
1.35e+06,2014,208,5,3.5,4800,14984,2,0,2,3,11,3480,1320,1998,1998,98006,47.554,122.15,4050,19009,16,0,8.5,8850,23809
8.25e+05,2014,360,4,2.5,3220,5262,2,0,0,3,9,3220,0,2003,2003,98033,47.688,122.16,3220,4921,11,0,6.5,6440,8141
4.2e+05,2014,284,3,1,1310,3963,1,0,0,5,7,1310,0,1986,1986,98052,47.683,122.1,1010,3363,28,0,4,2320,4673
2.55e+05,2014,143,3,2,1490,8371,1,0,0,3,7,1490,0,1984,1984,98031,47.396,122.19,1350,7846,30,0,5,2840,9336
3.35e+05,2015,366,3,1,1120,9075,1,0,0,3,7,1120,0,1977,1977,98077,47.755,122.07,1120,9705,38,0,4,2240,10825
5.29e+05,2015,481,3,1.75,2340,7724,1,0,0,3,10,2340,0,2010,2010,98058,47.459,122.13,3040,5787,5,0,4.75,5380,8127
2.92e+05,2014,346,3,1.75,1650,14633,1,0,0,4,7,1650,0,1958,1958,98056,47.498,122.18,1370,12495,56,0,4.75,3020,14145
7.5e+05,2014,325,4,2.75,2640,3750,2,0,0,5,7,1840,800,1911,1911,98117,47.678,122.36,1690,5000,103,0,6.75,4330,7640
2.825e+05,2014,306,4,1,1650,9750,1,0,0,4,7,1650,0,1964,1964,98059,47.499,122.16,1650,10112,50,0,5,3300,11762
5.5787e+05,2014,312,4,2.5,3030,6813,2,0,0,3,9,3030,0,1987,1987,98074,47.63,122.03,2310,8682,27,0,6.5,5340,11712
6.12e+05,2015,438,6,3,3840,14040,1,0,3,3,8,2460,1380,1949,1949,98178,47.506,122.24,2170,6765,66,0,9,6010,10605
1.3e+06,2014,205,3,2.5,3350,7752,1,0,0,3,9,2180,1170,2009,2009,98008,47.626,122.1,2570,7988,5,0,5.5,5920,11338
3.45e+05,2015,362,4,2.25,2320,7350,2,0,0,3,8,2320,0,1973,1973,98058,47.451,122.13,2170,7350,42,0,6.25,4490,9670
6.52e+05,2015,389,3,1,1470,6122,1,0,0,3,8,1200,270,1948,1948,98199,47.652,122.41,2200,6122,67,0,4,3670,7592
7.248e+05,2014,136,3,2,2050,3933,1,0,0,3,8,1180,870,1926,2001,98112,47.644,122.3,1940,4000,88,1,5,3990,6050
4.8145e+05,2014,129,3,2,1410,4800,1,0,0,3,7,1410,0,1940,1940,98117,47.685,122.38,1190,3840,74,0,5,2600,5250
4.1e+05,2015,449,2,1.75,870,4000,1,0,0,3,6,870,0,1941,1941,98126,47.566,122.38,1420,4000,74,0,3.75,2290,4870
4.03e+05,2014,160,2,1,1100,3598,1,0,0,4,7,1100,0,1926,1926,98144,47.574,122.31,1240,3598,88,0,3,2340,4698
4e+05,2014,277,3,1.75,1370,9680,1,0,0,4,7,1370,0,1977,1977,98074,47.613,122.05,1370,10208,37,0,4.75,2740,11578
1.25e+05,2014,245,3,1,920,7314,1,0,0,3,6,920,0,1960,1960,98002,47.289,122.22,1010,7420,54,0,4,1930,8340
5.5e+05,2015,470,4,2.5,2080,4080,1,0,0,5,7,1040,1040,1962,1962,98144,47.572,122.29,1340,4080,53,0,6.5,3420,6160
3.39e+05,2014,256,3,1.75,1320,9450,1,0,0,5,7,1320,0,1943,1943,98166,47.456,122.35,1320,8315,71,0,4.75,2640,9635
3.187e+05,2014,312,4,2.5,2770,19116,1,0,0,4,8,1600,1170,1961,1961,98003,47.339,122.32,2730,18429,53,0,6.5,5500,21199
6.55e+05,2015,438,4,2.5,3500,11306,2,0,2,3,9,3500,0,2005,2005,98065,47.543,121.86,3180,8028,10,0,6.5,6680,11528
2.65e+05,2014,182,4,3,1940,8170,1,0,0,4,7,1940,0,1948,1948,98155,47.738,122.3,1310,8169,66,0,7,3250,10109
3.325e+05,2014,141,3,2.25,1800,10500,2,0,0,3,7,1800,0,1995,1995,98038,47.388,122.03,1870,8555,19,0,5.25,3670,10355
8.35e+05,2014,173,4,2.5,3030,29163,2,0,0,3,10,3030,0,1998,1998,98053,47.657,122.02,2780,40669,16,0,6.5,5810,43699
3.1e+05,2014,155,4,2.25,2192,12128,2,0,0,3,8,2192,0,2006,2006,98030,47.364,122.2,1914,4649,8,0,6.25,4106,6841
5.475e+05,2014,298,3,2.5,2550,10355,2,0,0,3,9,2550,0,1990,1990,98011,47.739,122.2,2550,10084,24,0,5.5,5100,12634
1.16e+06,2015,456,4,3,2680,15438,2,0,2,3,8,2680,0,1902,1956,98039,47.611,122.23,4480,14406,113,1,7,7160,17086
3.77e+05,2015,393,4,2.5,2170,11511,2,0,0,3,8,2170,0,1992,1992,98031,47.389,122.19,1900,8961,23,0,6.5,4070,11131
4.25e+05,2015,460,3,2,1180,1800,2,0,2,3,8,1180,0,1994,1994,98122,47.617,122.3,1500,1948,21,0,5,2680,3128
1.2e+05,2014,297,3,1,1260,7500,1,0,0,3,6,1260,0,1954,1954,98198,47.419,122.33,1260,7500,60,0,4,2520,8760
4.95e+05,2014,127,3,1,990,6000,1,0,0,3,6,990,0,1943,1943,98105,47.672,122.27,1250,6000,71,0,4,2240,6990
3.37e+05,2014,142,3,1,1070,6109,1,0,0,5,7,1070,0,1951,1951,98125,47.721,122.32,1170,7200,63,0,4,2240,8270
1.15e+06,2014,284,4,3.25,4190,10259,2,0,0,3,11,3150,1040,2000,2000,98074,47.633,122.07,4300,11919,14,0,7.25,8490,16109
4.75e+05,2014,140,4,1.75,1650,7775,1,0,0,4,7,1150,500,1950,1950,98133,47.715,122.35,1390,7200,64,0,5.75,3040,8850
8.5e+05,2014,132,4,1.75,2350,11914,1,0,0,4,8,2350,0,1961,1961,98040,47.539,122.23,2240,10706,53,0,5.75,4590,13056
5.9e+05,2014,189,3,2.5,2650,9380,1,0,0,5,8,1680,970,1975,1975,98155,47.776,122.27,2310,9600,39,0,5.5,4960,12250
1.69e+05,2014,229,3,1.5,1470,18459,2,0,0,4,6,1470,0,1916,1916,98023,47.33,122.36,1750,16074,98,0,4.5,3220,17544
6.05e+05,2014,242,4,2.5,2430,11870,1,0,0,5,8,1590,840,1968,1968,98155,47.776,122.28,2430,9600,46,0,6.5,4860,12030
2.05e+05,2014,197,3,1.75,1290,7210,1,0,0,3,7,1290,0,1984,1984,98023,47.289,122.36,1350,7509,30,0,4.75,2640,8799
4.32e+05,2014,194,3,2,1870,7080,1,0,0,4,7,1210,660,1969,1969,98034,47.724,122.18,1620,8000,45,0,5,3490,9870
7e+05,2014,341,3,3.5,3030,11550,2,0,2,3,8,3030,0,1971,2011,98146,47.505,122.38,2340,10560,43,1,6.5,5370,13590
2.11e+05,2014,237,4,2,1710,8288,1,0,0,3,7,1710,0,1970,1970,98031,47.395,122.17,1710,7200,44,0,6,3420,8910
3.01e+05,2014,342,3,1.75,1840,7200,1,0,0,4,7,1220,620,1968,1968,98055,47.456,122.21,1770,8075,46,0,4.75,3610,9915
7.07e+05,2014,134,4,3.25,3200,7081,2,0,0,3,9,3200,0,2004,2004,98075,47.589,121.99,3120,6094,10,0,7.25,6320,9294
6.27e+05,2014,159,4,2,2030,9300,1,0,0,4,8,2030,0,1976,1976,98052,47.666,122.15,1800,9018,38,0,6,3830,11048
7.8e+05,2014,280,3,1.5,1620,7500,1,0,2,4,8,1620,0,1949,1949,98117,47.701,122.38,2440,7800,65,0,4.5,4060,9420
3.8618e+05,2015,491,2,1.5,960,1829,2,0,0,3,7,960,0,2005,2005,98122,47.603,122.31,1470,1829,10,0,3.5,2430,2789
7.4e+05,2015,438,5,2.75,3050,7520,2,0,0,3,8,3050,0,2014,2014,98056,47.525,122.18,2180,10800,1,0,7.75,5230,13850
7.25e+05,2014,190,3,1.75,1690,8489,1,0,0,4,7,1690,0,1959,1959,98004,47.608,122.19,1850,8536,55,0,4.75,3540,10226
3.36e+05,2014,202,4,1,1780,4310,1,0,0,5,6,1780,0,1919,1919,98118,47.549,122.28,1460,4310,95,0,5,3240,6090
5.525e+05,2015,431,4,3.5,3710,10400,2,0,0,3,8,2290,1420,2002,2002,98056,47.504,122.19,1720,4276,13,0,7.5,5430,7986
7.15e+05,2014,307,4,2.5,2570,7980,2,0,0,3,9,2570,0,1998,1998,98074,47.638,122.06,2760,6866,16,0,6.5,5330,9436
2.9185e+05,2015,375,3,1.5,1060,9711,1,0,0,3,7,1060,0,1963,1963,98198,47.41,122.31,1650,9711,52,0,4.5,2710,10771
4.46e+05,2014,139,5,2.75,2190,12687,1,0,0,5,7,1370,820,1978,1978,98028,47.776,122.26,2280,10784,36,0,7.75,4470,12974
3.065e+06,2015,402,5,3,4150,7500,2,0,4,5,11,3510,640,1909,1909,98119,47.63,122.36,2250,4050,106,0,8,6400,8200
5.75e+05,2014,331,2,1.75,1840,4076,1,0,0,3,8,1140,700,1957,1957,98117,47.688,122.39,1540,4076,57,0,3.75,3380,5916
4.555e+05,2014,147,3,2,1460,10311,1,0,0,4,7,1460,0,1975,1975,98052,47.677,122.16,1690,9679,39,0,5,3150,11139
5.25e+05,2014,312,4,2.75,2440,5080,2,0,0,3,8,1750,690,1960,1960,98126,47.555,122.38,1920,6375,54,0,6.75,4360,8815
4.425e+05,2015,395,3,1,1120,8200,1,0,0,4,7,1120,0,1938,1938,98125,47.725,122.29,1820,7205,77,0,4,2940,8325
3.15e+05,2014,160,2,1,1740,3622,1,0,0,4,7,950,790,1924,1924,98118,47.554,122.29,1270,3800,90,0,3,3010,5540
6.2e+05,2015,424,4,2.5,2130,9139,2,0,0,3,9,2130,0,1988,1988,98029,47.565,122.01,2150,8178,27,0,6.5,4280,10308
7.62e+05,2015,392,4,2,2130,5500,1,0,0,5,7,2130,0,1939,1939,98033,47.681,122.2,1490,6000,76,0,6,3620,8130
4.3e+05,2015,443,2,1,760,7114,1,0,0,3,6,760,0,1946,1946,98103,47.7,122.35,780,7102,69,0,3,1540,7862
4.8e+05,2015,451,5,2.5,2040,9597,1,0,0,4,7,1240,800,1963,1963,98052,47.654,122.13,1800,8553,52,0,7.5,3840,10593
1.975e+06,2014,190,6,4.5,4800,9097,2,0,0,3,10,3580,1220,2007,2007,98112,47.626,122.29,2180,6037,7,0,10.5,6980,10837
6.4e+05,2014,221,4,2.5,2460,9973,1,0,0,4,8,1560,900,1965,1965,98177,47.713,122.36,1830,7200,49,0,6.5,4290,9660
6.02e+05,2014,177,4,1.75,2420,37800,1,0,0,4,8,1880,540,1981,1981,98053,47.669,122.02,2780,35532,33,0,5.75,5200,37952
5.36e+05,2014,129,3,1.75,1300,5413,1,0,0,3,7,1300,0,1925,1992,98115,47.699,122.32,1590,6380,89,1,4.75,2890,7680
2.125e+05,2014,154,3,1,920,14400,1,0,0,4,7,920,0,1977,1977,98001,47.282,122.27,1170,9600,37,0,4,2090,10520
4.75e+05,2014,294,3,2.25,1380,1621,2,0,0,3,8,1140,240,2007,2007,98117,47.678,122.38,1460,1403,7,0,5.25,2840,2783
4.368e+05,2015,451,3,1.75,2080,12714,2,0,0,4,8,1540,540,1984,1984,98052,47.706,122.16,2080,12107,31,0,4.75,4160,14187
3.405e+05,2015,389,2,1,940,5413,1,0,0,3,7,940,0,1923,1923,98115,47.696,122.3,1340,5296,92,0,3,2280,6236
4.45e+05,2014,251,4,2.5,2170,5257,2,0,0,3,7,2170,0,1989,1989,98115,47.7,122.31,1430,7528,25,0,6.5,3600,9698
2.16e+05,2015,437,4,2.5,1847,8000,2,0,0,3,7,1847,0,2008,2008,98001,47.287,122.26,1767,8000,7,0,6.5,3614,9847
4.52e+05,2015,481,4,1.75,1570,8268,1,0,0,3,7,1570,0,1979,1979,98011,47.737,122.2,1870,8190,36,0,5.75,3440,9760
3.9995e+05,2014,154,3,1.5,2080,5244,1,0,0,3,7,1190,890,1959,1959,98125,47.714,122.29,1850,6982,55,0,4.5,3930,9062
1.288e+06,2014,225,4,3.5,3700,13175,2,0,0,4,11,3700,0,1989,1989,98006,47.547,122.13,3880,15508,25,0,7.5,7580,19208
2.84e+05,2014,189,3,1.5,1500,10018,1,0,0,4,7,1500,0,1957,1957,98058,47.468,122.16,1500,10937,57,0,4.5,3000,12437
5.43e+05,2014,342,2,1,940,3864,1,0,0,4,8,940,0,1918,1918,98103,47.663,122.34,1440,3956,96,0,3,2380,4896
1.825e+05,2014,297,3,1,910,7194,1,0,0,4,7,910,0,1971,1971,98001,47.334,122.28,1530,7200,43,0,4,2440,8110
5.85e+05,2014,169,4,2.5,2840,11044,2,0,0,3,8,2840,0,2001,2001,98034,47.713,122.24,1934,9605,13,0,6.5,4774,12445
4.6e+05,2014,319,2,1.5,1820,7800,1,0,0,4,7,1240,580,1956,1956,98133,47.751,122.36,1400,7800,58,0,3.5,3220,9620
6.75e+05,2015,386,4,3.5,2140,2278,3,0,0,3,9,2140,0,2005,2005,98107,47.673,122.38,1540,2285,10,0,7.5,3680,4425
4.69e+05,2014,228,3,3.25,1370,1194,3,0,0,3,8,1370,0,2004,2004,98107,47.672,122.39,1800,2678,10,0,6.25,3170,4048
6e+05,2014,338,2,1,2120,6897,1,0,0,4,7,1060,1060,1923,1923,98118,47.557,122.28,1900,4462,91,0,3,4020,6582
6.5e+05,2014,305,3,2.5,2350,3750,2,0,0,3,7,1740,610,2003,2003,98117,47.677,122.36,1590,4700,11,0,5.5,3940,7050
3.5e+05,2015,463,3,2.25,1550,5401,2,0,0,3,7,1550,0,2000,2000,98019,47.737,121.97,1740,4485,15,0,5.25,3290,6035
1.975e+05,2014,169,3,1,1330,5412,2,0,0,5,7,1330,0,1905,1905,98022,47.205,121.99,1710,10825,109,0,4,3040,12155
4.6e+05,2014,161,3,2,2060,4437,1,0,0,3,7,1030,1030,1929,1929,98126,47.571,122.38,1750,4452,85,0,5,3810,6512
5.8e+05,2014,168,4,2.5,3250,5000,2,0,0,3,8,3250,0,2008,2008,98059,47.499,122.15,3230,5507,6,0,6.5,6480,8757
3.65e+05,2015,422,2,1.5,820,1270,2,0,0,3,7,820,0,2009,2009,98144,47.593,122.3,1130,1201,6,0,3.5,1950,2021
4.2e+05,2014,334,3,2.25,1830,7500,1,0,0,4,7,1330,500,1968,1968,98155,47.757,122.31,1830,8720,46,0,5.25,3660,10550
2.8e+05,2014,175,3,1.75,1230,8250,1,0,0,3,7,1230,0,1966,1966,98058,47.453,122.18,1250,8250,48,0,4.75,2480,9480
1.85e+05,2014,232,2,1,820,16030,1,0,0,4,5,820,0,1923,1923,98022,47.204,122,1880,14046,91,0,3,2700,14866
2.45e+05,2014,136,4,1,1530,7200,1,0,0,3,7,1400,130,1948,1948,98178,47.502,122.26,1530,7200,66,0,5,3060,8730
7e+05,2014,216,4,2.5,3100,36562,2,0,0,3,10,3100,0,1994,1994,98077,47.765,122.06,3080,39351,20,0,6.5,6180,42451
3.7e+05,2014,163,4,2.5,2220,5338,2,0,0,3,7,2220,0,2001,2001,98059,47.489,122.15,2220,5338,13,0,6.5,4440,7558
7.15e+05,2014,223,4,2.5,2450,7700,1,0,0,3,8,1250,1200,1958,1958,98040,47.573,122.21,2450,8000,56,0,6.5,4900,10450
8.99e+05,2014,293,4,2.5,3720,30649,2,0,0,3,10,3720,0,1988,1988,98053,47.665,122.06,3220,29434,26,0,6.5,6940,33154
8.25e+05,2014,259,4,1,1820,4000,2,0,0,3,8,1820,0,1923,1923,98102,47.626,122.32,2050,4000,91,0,5,3870,5820
3.65e+06,2015,491,5,3.75,5020,8694,2,0,1,3,12,3970,1050,2007,2007,98004,47.615,122.21,4190,11275,8,0,8.75,9210,16295
6.39e+05,2014,140,4,2.5,2150,12028,2,0,0,4,8,2150,0,1982,1982,98052,47.722,122.1,1800,11777,32,0,6.5,3950,13927
4.3e+05,2014,216,3,3.25,1550,1444,3,0,0,3,8,1550,0,2006,2006,98115,47.677,122.29,1550,1444,8,0,6.25,3100,2994
2.884e+05,2014,141,3,2.25,1870,3230,2,0,0,3,7,1870,0,1997,1997,98056,47.492,122.17,1620,3363,17,0,5.25,3490,5233
7.95e+05,2015,457,2,1,1380,5000,1,0,2,3,5,1380,0,1905,1905,98106,47.571,122.36,1500,5000,110,0,3,2880,6380
7.74e+05,2014,306,4,2.75,2010,7000,2,0,0,5,8,2010,0,1901,1901,98199,47.661,122.4,1420,4400,113,0,6.75,3430,6410
4e+05,2015,382,2,1,920,5120,1,0,0,5,7,920,0,1952,1952,98136,47.557,122.39,1190,5120,63,0,3,2110,6040
4.4015e+05,2014,152,2,1,1110,6800,1,0,0,5,7,1000,110,1947,1947,98133,47.718,122.36,1410,6963,67,0,3,2520,8073
3.27e+05,2014,216,4,1.75,1840,5100,1,0,0,4,5,1840,0,1933,1933,98056,47.521,122.2,2160,5400,81,0,5.75,4000,7240
6.75e+05,2014,293,3,2.25,2770,15886,2,0,0,3,10,2770,0,1982,1982,98177,47.746,122.36,3290,15886,32,0,5.25,6060,18656
3.42e+05,2015,481,3,2.5,1960,3540,2,0,0,3,8,1960,0,2012,2012,98038,47.357,122.06,1840,3825,3,0,5.5,3800,5785
8.65e+05,2015,466,5,3,2830,8854,1,0,0,4,8,1500,1330,1979,1979,98040,47.574,122.21,2260,8604,36,0,8,5090,11434
5.9e+05,2015,465,3,2,1860,3600,1,0,0,3,7,1110,750,1915,1915,98122,47.61,122.3,1680,3695,100,0,5,3540,5555
1.45e+06,2015,447,4,3.5,2820,7809,2,0,0,3,10,2820,0,1995,1995,98004,47.622,122.19,2630,7904,20,0,7.5,5450,10724
4.2e+05,2014,222,3,2,2020,38332,1,0,0,4,7,1010,1010,1975,1975,98027,47.458,122.02,2110,36590,39,0,5,4130,38610
5.895e+05,2015,431,4,1.5,3520,4933,1,0,0,4,8,2270,1250,1929,1929,98108,47.566,122.31,1710,5400,86,0,5.5,5230,8920
8.2e+05,2014,203,2,2.5,2210,4440,2,0,0,4,8,1440,770,1931,1931,98112,47.63,122.3,1560,4920,83,0,4.5,3770,7130
8e+05,2015,457,4,2.75,3260,5000,2,0,0,3,9,3260,0,2007,2007,98027,47.539,122,3450,6218,8,0,6.75,6710,9478
7.7e+05,2015,439,4,3,2320,7200,1,0,0,3,7,1260,1060,1943,2000,98040,47.589,122.23,1760,7200,72,1,7,4080,9520
4.3e+05,2014,270,3,2.5,2360,6699,2,0,0,3,7,2360,0,2003,2003,98065,47.532,121.85,2360,4744,11,0,5.5,4720,7104
5.6e+05,2014,162,4,1.75,1880,3880,1,0,0,4,7,1090,790,1944,1944,98107,47.663,122.36,1390,3880,70,0,5.75,3270,5760
6.99e+05,2014,251,4,2.5,2550,7312,2,0,0,3,9,2550,0,1988,1988,98008,47.644,122.11,2330,7480,26,0,6.5,4880,10030
3.17e+05,2014,243,6,3.5,2120,5840,2,0,0,5,7,2120,0,1979,1979,98055,47.479,122.23,1860,8000,35,0,9.5,3980,10120
4.5e+05,2014,312,3,2,2320,17688,1,0,0,3,8,2320,0,1952,1994,98166,47.452,122.36,1610,14482,62,1,5,3930,16802
6.1095e+05,2014,127,3,3,1680,1570,3,0,0,3,8,1680,0,2014,2014,98103,47.657,122.35,1640,4800,0,0,6,3320,6480
3.8e+05,2015,432,5,3.25,3800,15500,1,0,0,3,7,2490,1310,1965,1965,98032,47.386,122.28,2000,13980,50,0,8.25,5800,17780
4.75e+05,2014,182,4,2.5,2040,7260,2,0,0,4,7,2040,0,1963,1963,98133,47.74,122.33,2040,7360,51,0,6.5,4080,9400
2.3e+05,2014,280,2,1,770,6450,1,0,0,4,6,770,0,1948,1948,98106,47.531,122.36,780,6063,66,0,3,1550,6833
1.62e+06,2014,177,4,3,3900,9750,1,0,4,5,10,2520,1380,1972,1972,98006,47.56,122.16,3410,9450,42,0,7,7310,13350
6e+05,2014,127,3,2.5,2460,1.089e+05,1,0,0,4,9,1860,600,1977,1977,98027,47.482,122,2870,1.0237e+05,37,0,5.5,5330,1.0483e+05
5.1e+05,2014,353,2,1,1310,4000,1,0,0,3,6,1310,0,1913,1913,98103,47.685,122.33,1550,4000,101,0,3,2860,5310
6.125e+05,2014,126,4,2,2060,5000,1,0,0,3,7,1030,1030,1949,2013,98117,47.699,122.38,1280,5000,65,1,6,3340,7060
2.7875e+05,2014,252,2,2,800,5765,1,0,0,4,6,800,0,1936,1936,98133,47.702,122.35,1160,3844,78,0,4,1960,4644
1.265e+05,2015,485,3,1,1130,12212,1,0,0,3,6,1130,0,1942,1942,98146,47.495,122.34,1190,9240,73,0,4,2320,10370
7.13e+05,2014,222,1,1,1180,4000,1,0,2,4,8,840,340,1910,1910,98118,47.556,122.27,1420,4000,104,0,2,2600,5180
2.65e+05,2015,403,3,1,1122,6554,1,0,0,3,5,1122,0,1900,1900,98118,47.514,122.26,1610,5650,115,0,4,2732,6772
3.5e+05,2014,195,3,3,3200,35782,1,0,0,3,8,2360,840,1978,1978,98042,47.412,122.15,3090,37887,36,0,6,6290,41087
6e+05,2014,257,4,2.5,2070,8127,1,0,0,3,9,1590,480,1924,2003,98125,47.732,122.29,2050,8131,90,1,6.5,4120,10201
9e+05,2014,225,4,2.75,3950,10214,1,0,3,3,10,2050,1900,1955,1955,98117,47.697,122.38,3130,8608,59,0,6.75,7080,12558
3.06e+05,2014,255,3,1.75,1980,9800,1,0,0,3,7,1980,0,1991,1991,98030,47.374,122.22,1630,7650,23,0,4.75,3610,9630
2.74e+05,2014,306,3,1.75,1400,8364,1,0,0,4,7,1400,0,1958,1958,98056,47.492,122.18,1210,8160,56,0,4.75,2610,9560
7.1e+05,2014,258,4,2.75,2940,4232,2,0,0,3,9,2940,0,2004,2004,98029,47.553,121.99,2410,4000,10,0,6.75,5350,6940
5.7e+05,2014,352,3,1.75,1370,3300,2,0,0,5,7,1370,0,1927,1927,98105,47.671,122.32,1560,3927,87,0,4.75,2930,5297
3.9995e+05,2014,173,3,1.75,1560,5223,1,0,0,4,7,810,750,1940,1940,98125,47.718,122.29,1440,8491,74,0,4.75,3000,10051
5.65e+05,2015,399,3,1.75,2380,10450,1,0,0,3,8,1400,980,1977,1977,98052,47.641,122.11,2150,9600,38,0,4.75,4530,11980
3.58e+05,2014,202,2,2.5,1278,987,2,0,0,3,7,1002,276,2007,2007,98136,47.553,122.38,1220,1287,7,0,4.5,2498,2565
8.5288e+05,2014,166,4,3.25,3450,6184,2,0,0,3,9,3450,0,2014,2014,98074,47.607,122.05,3020,5369,0,0,7.25,6470,8819
3.1e+05,2014,293,3,2.25,1590,3056,2,0,0,3,7,1590,0,2001,2001,98108,47.543,122.29,1540,2890,13,0,5.25,3130,4480
3.95e+05,2015,456,5,2.5,2820,6305,2,0,0,3,8,2820,0,2003,2003,98003,47.262,122.3,2610,6306,12,0,7.5,5430,9126
2.5595e+05,2014,294,4,1,1500,11050,1,0,0,5,7,1500,0,1964,1964,98058,47.451,122.09,1970,20800,50,0,5,3470,22300
3.6995e+05,2014,191,3,1.75,1640,4860,1,0,0,3,8,1200,440,1965,1965,98125,47.712,122.32,1480,7200,49,0,4.75,3120,8840
4.25e+05,2015,430,3,1,1000,5100,1,0,0,3,7,860,140,1946,1946,98115,47.686,122.29,1000,5100,69,0,4,2000,6100
2.72e+05,2014,195,4,2,1870,6551,1,0,3,3,7,1870,0,2009,2009,98022,47.193,121.98,2280,5331,5,0,6,4150,7201
5.25e+05,2014,339,3,2.25,1290,1182,2,0,0,3,8,1000,290,2006,2006,98102,47.637,122.33,1300,1169,8,0,5.25,2590,2459
6.84e+05,2015,431,4,2.5,2500,8434,2,0,0,4,8,2500,0,1988,1988,98052,47.691,122.1,1900,8131,27,0,6.5,4400,10631
5.55e+05,2014,208,3,3,2410,12183,2,0,0,3,9,2410,0,1988,1988,98011,47.747,122.18,2540,9979,26,0,6,4950,12389
3.6e+05,2015,445,6,2,2210,9870,2,0,0,4,7,2210,0,1969,1995,98059,47.475,122.14,1390,9912,46,1,8,3600,12122
1.25e+06,2014,128,4,3.25,3820,24166,2,0,1,4,11,3310,510,1990,1990,98040,47.526,122.23,2900,18786,24,0,7.25,6720,22606
6.35e+05,2014,218,3,2.5,1780,11000,1,0,0,4,8,1210,570,1980,1980,98006,47.557,122.15,2310,9700,34,0,5.5,4090,11480
2.3795e+05,2015,432,3,1.75,1310,7314,1,0,0,5,6,1310,0,1960,1960,98002,47.289,122.22,1010,7314,55,0,4.75,2320,8624
7.465e+05,2015,462,4,2.5,3460,9699,2,0,0,3,10,3460,0,1987,1987,98074,47.637,122.04,3140,10631,28,0,6.5,6600,14091
1.115e+06,2015,477,4,3.75,4040,14212,2,0,0,3,11,4040,0,2002,2002,98059,47.519,122.15,3940,14212,13,0,7.75,7980,18252
8.7e+05,2015,439,4,1.75,2780,11000,1,0,0,3,9,1560,1220,1964,1964,98004,47.595,122.2,2350,11700,51,0,5.75,5130,14480
2.5e+05,2014,313,4,1.5,1220,4900,1,0,0,3,6,1220,0,1942,1942,98118,47.529,122.27,1410,3000,72,0,5.5,2630,4220
3.2e+05,2014,175,4,2.5,2000,10051,2,0,0,3,7,2000,0,1997,1997,98038,47.362,122.03,2000,6686,17,0,6.5,4000,8686
6.75e+05,2014,229,4,2,1890,5188,1,0,0,4,7,1670,220,1940,1940,98105,47.663,122.29,1800,4848,74,0,6,3690,6738
4.4e+05,2015,386,4,2.25,2080,15750,1,0,0,3,8,1460,620,1976,1976,98034,47.722,122.2,1960,10500,39,0,6.25,4040,12580
3.5245e+05,2014,169,3,2,1430,6000,1,0,0,5,7,1430,0,1945,1945,98155,47.756,122.32,1630,6315,69,0,5,3060,7745
5.3116e+05,2014,268,4,2.75,2810,5046,2,0,0,3,9,2810,0,2014,2014,98038,47.356,122.02,3060,4934,0,0,6.75,5870,7744
5.4e+05,2014,258,3,2.5,2860,8935,2,0,0,3,8,2860,0,2004,2004,98065,47.534,121.86,2650,6167,10,0,5.5,5510,9027
1.2e+06,2014,122,5,2.75,2910,9480,1,0,0,3,8,2910,0,1939,1939,98105,47.655,122.28,2940,6600,75,0,7.75,5850,9510
4.6e+05,2015,383,4,2.25,2860,15054,1,0,0,3,8,1460,1400,1957,1957,98155,47.766,122.3,1730,18525,58,0,6.25,4590,21385
5.382e+05,2014,360,4,3,1780,7260,1,0,0,4,8,1780,0,1964,1964,98008,47.627,122.11,1810,7920,50,0,7,3590,9700
5.675e+05,2014,294,3,2.5,3090,67082,2,0,0,3,9,3090,0,1990,1990,98038,47.403,122.02,3650,62290,24,0,5.5,6740,65380
4.81e+05,2014,202,3,2.75,2290,14810,1,0,0,5,7,1400,890,1967,1967,98056,47.534,122.19,2540,8640,47,0,5.75,4830,10930
5.46e+05,2015,429,2,2.25,1530,1324,2,0,0,3,8,1280,250,2010,2010,98122,47.603,122.31,1410,1689,5,0,4.25,2940,3219
4.0395e+05,2014,159,2,1,710,1136,2,0,0,4,7,710,0,1943,1943,98102,47.641,122.33,1370,1173,71,0,3,2080,1883
8.23e+05,2015,444,3,2.5,2560,9825,2,0,0,4,9,2560,0,1988,1988,98006,47.55,122.14,2710,12034,27,0,5.5,5270,14594
4.25e+05,2014,225,3,2.5,1340,10018,1,0,0,4,7,1340,0,1976,1976,98052,47.637,122.09,2520,13068,38,0,5.5,3860,14408
7.05e+05,2014,352,3,2,1460,6250,1,0,0,4,7,1460,0,1912,1912,98103,47.669,122.33,1690,4750,102,0,5,3150,6210
6.29e+05,2014,194,4,2.5,2660,22050,2,0,0,3,9,2660,0,1996,1996,98059,47.491,122.13,3060,21111,18,0,6.5,5720,23771
4.35e+05,2014,345,3,1.75,2030,13700,1,0,0,3,8,1630,400,1976,1976,98011,47.773,122.2,2120,11200,38,0,4.75,4150,13230
3.525e+05,2014,231,3,1.5,1360,7680,1,0,0,3,7,1360,0,1955,1955,98133,47.744,122.34,1630,7679,59,0,4.5,2990,9039
5.4e+05,2015,451,4,2,2190,8402,2,0,0,4,6,2190,0,1928,1928,98033,47.694,122.17,2210,7802,87,0,6,4400,9992
3e+05,2014,306,3,1,1260,5000,1,0,0,4,6,1260,0,1968,1968,98014,47.649,121.92,1180,7500,46,0,4,2440,8760
4.75e+05,2014,225,5,2.5,2010,3600,1,0,0,3,6,1510,500,1912,1912,98119,47.652,122.37,1780,3600,102,0,7.5,3790,5610
4.67e+05,2015,442,3,2,1840,3432,2,0,0,3,7,1840,0,2012,2012,98155,47.737,122.3,1280,7573,3,0,5,3120,9413
2.55e+05,2014,350,2,1,1360,9367,1,0,0,4,6,680,680,1924,1924,98155,47.769,122.31,1360,7543,90,0,3,2720,8903
8.89e+05,2015,464,4,3.5,4070,10976,2,0,0,3,10,4070,0,2004,2004,98075,47.581,121.97,4080,10106,11,0,7.5,8150,14176
7.445e+05,2014,175,5,2.5,2700,16570,1,0,0,4,8,1750,950,1967,1967,98005,47.614,122.17,2570,11840,47,0,7.5,5270,14540
5.8e+05,2014,300,3,1.5,1800,6250,1,0,0,3,8,1420,380,1947,1947,98116,47.578,122.39,1800,5625,67,0,4.5,3600,7425
4.06e+05,2015,452,3,1.75,1270,6017,1,0,0,4,7,1030,240,1990,1990,98028,47.737,122.22,1630,7381,25,0,4.75,2900,8651
5.8995e+05,2014,324,3,2,2080,12094,2,0,0,4,8,2080,0,1982,1982,98052,47.703,122.16,2230,12204,32,0,5,4310,14284
4.31e+05,2014,250,2,1,1000,6500,1,0,0,4,7,1000,0,1918,1918,98136,47.547,122.39,1280,6500,96,0,3,2280,7500
4.69e+05,2015,450,3,2,1300,22605,1,0,0,3,7,1300,0,1998,1998,98056,47.534,122.19,2250,10215,17,0,5,3550,11515
2.6e+05,2015,424,4,1,1220,7980,1,0,0,3,6,1220,0,1944,1944,98178,47.492,122.24,1210,7920,71,0,5,2430,9140
2.78e+05,2014,223,4,2.25,2400,7738,1,0,0,3,8,2400,0,1964,1964,98148,47.456,122.33,2170,8452,50,0,6.25,4570,10852
8.15e+05,2015,478,4,1.75,2970,14880,1,0,4,5,9,1560,1410,1962,1962,98075,47.591,122.09,3310,13388,53,0,5.75,6280,16358
2.6995e+05,2014,198,3,1,990,9950,1,0,0,5,7,990,0,1961,1961,98056,47.51,122.17,1370,9260,53,0,4,2360,10250
3.5e+05,2014,197,2,1.75,1740,6620,1,0,0,3,8,1740,0,2002,2002,98065,47.526,121.83,1560,5400,12,0,3.75,3300,7140
6.9995e+05,2014,326,2,2.5,2390,7489,1,0,0,3,8,2390,0,2007,2007,98053,47.724,122.03,2170,7489,7,0,4.5,4560,9879
5.15e+05,2015,466,3,2.5,2000,3837,2,0,0,3,8,2000,0,2011,2011,98072,47.771,122.17,2210,4075,4,0,5.5,4210,6075
4.415e+05,2014,250,3,2.5,2420,9592,2,0,0,3,8,1780,640,1993,1993,98059,47.509,122.15,2420,9145,21,0,5.5,4840,11565
3.32e+05,2014,188,3,2.25,2120,14915,1,0,0,3,9,1720,400,1979,1979,98001,47.352,122.28,2320,13100,35,0,5.25,4440,15220
5e+05,2015,445,3,2,1540,3600,1,0,0,3,7,890,650,1994,1994,98122,47.61,122.3,1540,3600,21,0,5,3080,5140
8.189e+05,2015,424,3,1,1080,4120,1,0,0,3,7,980,100,1919,1919,98115,47.677,122.32,1280,3090,96,0,4,2360,4170
6.545e+05,2015,438,4,1,1780,5000,1,0,0,3,8,1780,0,1947,1947,98115,47.676,122.3,2030,5000,68,0,5,3810,6780
2.93e+05,2015,458,4,2.25,2360,6260,2,0,0,3,7,2360,0,1998,1998,98038,47.388,122.05,2144,6773,17,0,6.25,4504,9133
3.5e+05,2015,367,4,2.5,2260,7500,1,0,0,3,8,1460,800,1965,1965,98055,47.465,122.2,2260,7500,50,0,6.5,4520,9760
4.39e+05,2014,292,4,2.25,2060,10070,2,0,0,3,7,2060,0,1975,1975,98034,47.726,122.18,2060,8155,39,0,6.25,4120,10215
6.55e+05,2014,190,4,2.25,2170,4080,2,0,0,3,7,1920,250,1980,1980,98122,47.612,122.29,1890,4400,34,0,6.25,4060,6570
3.15e+05,2014,122,3,1,1160,9180,1,0,0,3,7,1160,0,1968,1968,98077,47.743,122.07,1160,10282,46,0,4,2320,11442
9.9e+05,2014,197,3,2.5,2160,6000,1,0,0,4,8,1880,280,1939,1939,98105,47.658,122.28,2300,6000,75,0,5.5,4460,8160
1.625e+05,2014,271,2,1,760,6141,1,0,0,2,6,760,0,1920,1920,98118,47.547,122.28,900,4120,94,0,3,1660,4880
3.35e+05,2015,426,2,2.25,1420,1246,2,0,0,3,8,1420,0,2007,2007,98106,47.539,122.37,1420,1826,8,0,4.25,2840,3246
3.359e+05,2014,224,2,1,1120,7440,1,0,0,4,7,1120,0,1939,1939,98155,47.74,122.32,1170,7440,75,0,3,2290,8560
2.35e+05,2014,143,4,2.5,1810,39639,1,0,0,3,7,1230,580,1970,1970,98042,47.347,122.11,1810,44866,44,0,6.5,3620,46676
2.67e+05,2014,188,3,1,1400,8100,1,0,0,3,6,1400,0,1944,1944,98125,47.712,122.29,1420,8100,70,0,4,2820,9500
7.85e+05,2015,465,4,2.5,3440,56192,2,0,0,3,9,3440,0,1994,1994,98053,47.697,122.05,3150,44431,21,0,6.5,6590,47871
2.8e+05,2014,264,3,2.5,1600,7936,2,0,0,3,7,1600,0,1996,1996,98038,47.367,122.02,1830,7936,18,0,5.5,3430,9536
3.2995e+05,2014,174,2,1,900,5220,1,0,0,4,6,900,0,1956,1956,98146,47.511,122.39,1480,6660,58,0,3,2380,7560
1.35e+06,2014,201,3,2.5,2390,5500,1,0,3,3,9,1700,690,1952,1952,98199,47.639,122.41,2700,5500,62,0,5.5,5090,7890
3.75e+05,2015,366,4,2.25,2020,12500,2,0,0,2,8,2020,0,1966,1966,98056,47.54,122.17,1800,13175,49,0,6.25,3820,15195
2.95e+05,2014,270,3,1.5,1220,3286,2,0,0,3,7,1220,0,1982,1982,98033,47.717,122.19,1220,2640,32,0,4.5,2440,3860
1.065e+06,2014,175,5,3.25,3370,7947,2,0,0,3,10,3370,0,2001,2001,98033,47.691,122.2,2040,7900,13,0,8.25,5410,11270
4.5e+05,2014,321,3,2.75,2240,3360,2,0,0,3,8,2100,140,2014,2014,98178,47.5,122.23,1790,5873,0,0,5.75,4030,8113
7.9e+05,2015,471,4,2.5,2650,5000,2,0,0,3,8,2650,0,2007,2007,98116,47.56,122.4,1110,6250,8,0,6.5,3760,8900
1.46e+05,2015,399,2,1,780,9750,1,0,0,3,6,780,0,1937,1937,98168,47.482,122.32,1670,9750,78,0,3,2450,10530
4.38e+05,2014,211,3,2.5,1520,1304,2,0,0,3,8,1180,340,2006,2006,98136,47.545,122.39,1270,1718,8,0,5.5,2790,3238
6.01e+05,2014,204,4,1.75,1950,4200,1,0,0,5,7,1040,910,1951,1951,98115,47.675,122.28,1450,5000,63,0,5.75,3400,6950
5.895e+05,2014,156,4,2.5,2630,6326,2,0,0,3,9,2630,0,2008,2008,98065,47.522,121.87,3240,6229,6,0,6.5,5870,8859
2.89e+05,2014,256,2,1,780,4132,1,0,0,3,7,780,0,1942,1942,98136,47.532,122.39,1100,5100,72,0,3,1880,5880
3.5e+05,2014,161,3,3.25,1460,1592,2,0,0,3,8,1130,330,2006,2006,98126,47.548,122.37,1560,1701,8,0,6.25,3020,3161
1.9e+05,2014,188,3,1,910,10575,1,0,0,4,7,910,0,1968,1968,98003,47.274,122.3,1470,10425,46,0,4,2380,11335
5.4e+05,2014,245,3,2.5,1280,1889,3,0,0,3,8,1280,0,2009,2009,98105,47.662,122.32,1450,1889,5,0,5.5,2730,3169
3.67e+05,2015,433,3,2.5,2828,4050,2,0,0,3,8,2828,0,2013,2013,98030,47.382,122.2,2513,4507,2,0,5.5,5341,7335
9.145e+05,2014,135,4,2.5,3950,10856,3,0,0,3,10,3950,0,2013,2013,98075,47.582,122,3200,10856,1,0,6.5,7150,14806
4.24e+05,2014,168,3,2,1670,7700,1,0,0,3,7,1170,500,1972,1972,98034,47.725,122.2,1500,7875,42,0,5,3170,9545
4.82e+05,2014,181,3,2.25,1710,21485,2,0,0,3,7,1710,0,1989,1989,98074,47.62,122.05,1680,21485,25,0,5.25,3390,23195
1.16e+06,2014,257,4,2.5,2790,5450,2,0,0,3,10,1930,860,1925,2000,98112,47.645,122.3,2320,5450,89,1,6.5,5110,8240
9.6995e+05,2014,237,3,2.5,2830,3750,3,0,0,3,10,2830,0,2014,2014,98117,47.68,122.39,1780,5100,0,0,5.5,4610,7930
5.58e+05,2015,459,3,2.5,1680,934,3,0,0,3,8,1680,0,2008,2008,98116,47.589,122.39,1740,1280,7,0,5.5,3420,2960
5.475e+05,2014,223,3,2,1850,9570,1,0,0,4,7,950,900,1940,1940,98115,47.697,122.32,1430,6380,74,0,5,3280,8230
7.45e+05,2014,160,4,3.25,3490,7024,2,0,0,3,10,3490,0,2006,2006,98075,47.583,121.97,3450,6866,8,0,7.25,6940,10356
2.1049e+05,2015,445,3,1,990,8528,1,0,0,3,6,990,0,1966,1966,98023,47.307,122.37,1228,8840,49,0,4,2218,9830
3.1e+05,2014,308,3,2.5,2242,5744,2,0,0,3,8,2242,0,2012,2012,98092,47.26,122.2,2009,5712,2,0,5.5,4251,7954
4.99e+05,2015,457,3,2.5,1690,4851,2,0,0,3,7,1690,0,2004,2004,98053,47.679,122.03,2330,4851,11,0,5.5,4020,6541
2.65e+05,2014,211,3,2.25,1840,6750,1,0,0,4,7,1270,570,1980,1980,98031,47.407,122.17,1750,7004,34,0,5.25,3590,8844
5.25e+05,2014,245,3,1.5,1380,4290,1,0,0,3,7,1080,300,1955,1955,98107,47.674,122.38,1510,3900,59,0,4.5,2890,5280
2.75e+05,2014,270,3,1.5,1030,7184,1,0,0,4,7,1030,0,1968,1968,98056,47.507,122.19,1330,7262,46,0,4.5,2360,8292
5.3e+05,2015,409,3,2.5,2160,9063,2,0,0,3,8,2160,0,1992,1992,98133,47.73,122.33,2160,9063,23,0,5.5,4320,11223
4.6e+05,2014,252,3,1.75,1400,2003,1,0,0,4,8,700,700,1908,2006,98119,47.651,122.37,1370,1281,106,1,4.75,2770,2681
3.875e+05,2015,478,6,2,2400,7684,1,0,0,3,6,1200,1200,1932,2005,98028,47.77,122.27,1290,9800,83,1,8,3690,12200
3.53e+05,2014,256,3,2.75,2170,8396,2,0,0,3,7,2170,0,1995,1995,98038,47.381,122.02,2170,8378,19,0,5.75,4340,10548
7.25e+05,2014,173,4,2.5,3420,30410,2,0,0,3,9,3420,0,1988,1988,98077,47.775,122.09,2940,45916,26,0,6.5,6360,49336
4.3e+05,2015,474,4,1.5,1810,7200,1,0,0,3,7,1810,0,1966,1966,98034,47.721,122.19,2060,7200,49,0,5.5,3870,9010
9.45e+05,2014,143,4,2,2840,13367,1,0,0,3,7,1420,1420,1952,1952,98004,47.624,122.21,2840,12744,62,0,6,5680,15584
3.55e+05,2014,286,4,1,1440,7215,1,0,0,3,7,1440,0,1969,1969,98034,47.713,122.21,1150,7215,45,0,5,2590,8655
3.2e+05,2014,142,3,2.25,998,844,2,0,0,3,7,798,200,2007,2007,98117,47.698,122.37,998,1110,7,0,5.25,1996,2108
3.0995e+05,2014,223,1,1,1120,11800,1,0,0,3,7,1120,0,1950,1950,98168,47.512,122.33,2330,9290,64,0,2,3450,10410
4.5e+05,2014,244,5,3.5,3931,9497,2,0,0,3,10,2650,1281,2014,2014,98023,47.301,122.39,3510,9497,0,0,8.5,7441,13428
6.75e+05,2014,198,4,2.5,2620,6114,2,0,0,3,9,2620,0,2011,2011,98029,47.56,122.01,2620,5808,3,0,6.5,5240,8428
1.625e+05,2015,383,3,1.5,1390,7417,1,0,0,3,7,1390,0,1967,1967,98001,47.337,122.28,1390,7665,48,0,4.5,2780,9055
3.475e+05,2015,373,4,2.5,2156,3562,2,0,0,3,9,2156,0,2012,2012,98030,47.359,122.2,1708,3539,3,0,6.5,3864,5695
3.84e+05,2015,431,3,2.5,1540,1564,2,0,0,3,7,1300,240,1998,1998,98144,47.586,122.31,1540,2875,17,0,5.5,3080,4415
1.01e+06,2014,167,3,3.25,2420,1923,2,0,2,3,10,1840,580,2006,2006,98109,47.637,122.34,1840,2890,8,0,6.25,4260,5310
7.6e+05,2014,278,4,2.5,2960,28005,2,0,0,3,10,2960,0,1989,1989,98072,47.748,122.12,3510,35248,25,0,6.5,6470,38208
2e+05,2014,305,2,1,1250,8520,1,0,0,3,6,1250,0,1928,1928,98126,47.516,122.38,1040,8520,86,0,3,2290,9770
8.9e+05,2015,471,4,2.5,2930,9158,2,0,0,3,9,2930,0,2005,2005,98052,47.706,122.13,3590,8065,10,0,6.5,6520,10995
9.07e+05,2014,324,3,1.5,1340,6000,1,0,1,3,9,1340,0,1927,1927,98105,47.66,122.28,2600,6000,87,0,4.5,3940,7340
5.15e+05,2015,471,5,3,2670,11761,1,0,0,3,7,1370,1300,1981,1981,98052,47.69,122.13,2580,10703,34,0,8,5250,13373
4.92e+05,2014,142,4,2,1640,5000,2,0,0,3,7,1640,0,1907,1983,98107,47.666,122.36,1240,5000,107,1,6,2880,6640
4.5e+05,2014,175,4,2.75,2310,5650,1,0,2,3,8,1330,980,1952,2012,98118,47.513,122.25,2300,5650,62,1,6.75,4610,7960
7.6e+05,2014,200,4,2.5,2990,12788,2,0,0,3,10,2990,0,1988,1988,98075,47.56,122.04,3250,12212,26,0,6.5,6240,15202
7.415e+05,2014,189,2,2.5,2150,5760,1,0,0,3,8,2150,0,2010,2010,98053,47.709,122.02,1640,4680,4,0,4.5,3790,6830
4.02e+05,2014,175,4,2.25,2000,3672,2,0,0,5,7,1650,350,1926,1926,98117,47.677,122.38,2000,5100,88,0,6.25,4000,7100
5.25e+05,2015,472,3,1.5,1840,10956,1,0,0,4,8,1840,0,1970,1970,98033,47.675,122.16,1680,10950,45,0,4.5,3520,12790
5.425e+05,2015,470,4,2.25,1750,10160,1,0,0,3,8,1320,430,1972,1972,98005,47.591,122.16,2170,11165,43,0,6.25,3920,12915
6.95e+05,2015,424,4,3.5,3510,9084,2,0,0,3,10,3510,0,2001,2001,98065,47.54,121.88,3690,9568,14,0,7.5,7200,13078
3.9e+05,2014,306,3,3,1490,2944,2,0,0,3,7,960,530,1993,1993,98199,47.651,122.38,1590,1600,21,0,6,3080,3090
7.5e+05,2014,209,3,2.5,2960,69351,2,1,3,4,9,2960,0,1990,1990,98070,47.4,122.42,2350,41433,24,0,5.5,5310,44393
3.69e+05,2015,403,5,1.5,2550,6300,1,0,0,4,7,1560,990,1959,1959,98056,47.501,122.17,1380,6300,56,0,6.5,3930,8850
3.9738e+05,2014,298,2,1,1030,5072,1,0,0,3,6,1030,0,1924,1958,98115,47.696,122.29,1220,6781,90,1,3,2250,7811
8.7e+05,2015,491,3,2,2320,65340,1,0,0,3,9,2320,0,1992,1992,98074,47.611,122.06,3100,59603,23,0,5,5420,61923
3.89e+05,2015,472,3,1,1330,3740,1,0,0,3,6,1330,0,1903,1903,98118,47.55,122.27,1330,5053,112,0,4,2660,6383
3e+05,2015,445,4,2.5,2890,17349,2,0,0,3,8,2890,0,1994,1994,98023,47.282,122.34,2330,22356,21,0,6.5,5220,25246
4.626e+05,2014,232,3,2,1320,4000,1,0,0,4,6,1020,300,1940,1940,98118,47.551,122.26,2410,6212,74,0,5,3730,7532
5.2495e+05,2014,312,2,2.5,1830,2856,2,0,0,3,7,1830,0,2005,2005,98029,47.552,122,1850,2667,9,0,4.5,3680,4497
4.1525e+05,2015,438,3,1.5,1400,7550,1,0,0,4,7,1400,0,1953,1953,98133,47.757,122.34,1730,7562,62,0,4.5,3130,8962
1.96e+06,2015,472,4,4,4430,31353,2,0,0,3,12,4430,0,1998,1998,98005,47.642,122.16,3900,35237,17,0,8,8330,39667
2.7995e+05,2014,294,3,1.75,1510,11234,1,0,0,3,7,1210,300,1965,1965,98155,47.757,122.33,2080,9076,49,0,4.75,3590,10586
1.35e+05,2015,456,3,1,830,9600,1,0,0,3,7,830,0,1959,1959,98032,47.37,122.3,1240,9198,56,0,4,2070,10028
3.48e+05,2014,256,4,2.5,2720,7697,1,0,0,4,8,2120,600,1987,1987,98058,47.439,122.16,2340,7700,27,0,6.5,5060,10420
8.65e+05,2014,125,4,3,3690,9892,2,0,0,3,10,3690,0,1998,1998,98075,47.594,121.98,3430,11294,16,0,7,7120,14984
6.235e+05,2014,348,4,3,1550,3350,1,0,0,3,7,860,690,1918,2014,98107,47.658,122.36,1310,5000,96,1,7,2860,6550
5.499e+05,2014,303,3,2,1280,960,2,0,0,3,9,1040,240,2014,2014,98122,47.602,122.31,1280,1173,0,0,5,2560,2453
2.55e+05,2014,228,3,1,1170,7395,1,0,0,4,7,1170,0,1969,1969,98055,47.463,122.19,1430,7920,45,0,4,2600,9090
4.025e+05,2014,153,3,3.25,2780,4002,2,0,0,3,8,2780,0,2009,2009,98019,47.735,121.97,1890,4090,5,0,6.25,4670,6870
5.25e+05,2014,133,3,3.5,2876,5086,2,0,0,3,8,2360,516,2007,2007,98072,47.751,122.17,2390,4419,7,0,6.5,5266,7295
6.01e+05,2014,319,4,2.5,2080,5191,2,0,0,3,8,2080,0,2001,2001,98075,47.598,122.02,2170,5518,13,0,6.5,4250,7598
2.8e+05,2014,249,2,1,1260,4800,1,0,0,3,6,1100,160,1947,1947,98126,47.52,122.38,1260,2435,67,0,3,2520,3695
8.95e+05,2014,141,5,3,2876,13927,1,0,2,4,9,1970,906,1973,1973,98040,47.553,122.23,3500,14454,41,0,8,6376,17330
7.52e+05,2014,341,4,1.5,1650,2970,1,0,0,3,7,1650,0,1903,1903,98102,47.623,122.32,1670,2970,111,0,5.5,3320,4620
5.27e+05,2014,249,4,2.5,2830,6163,2,0,0,3,9,2830,0,2000,2000,98056,47.523,122.19,2730,6202,14,0,6.5,5560,9032
4.49e+05,2015,459,5,2.5,2570,61855,1,0,0,4,7,1470,1100,1981,1981,98092,47.301,122.11,1990,49658,34,0,7.5,4560,52228
2.8e+05,2014,280,3,1.75,1360,6603,1,0,0,4,7,1360,0,1981,1981,98058,47.462,122.17,1770,7107,33,0,4.75,3130,8467
7.3e+05,2014,140,4,2.5,3230,7331,2,0,0,3,10,3230,0,2004,2004,98075,47.582,121.97,3480,7447,10,0,6.5,6710,10677
2.84e+05,2014,166,3,2.5,1880,6008,2,0,0,3,7,1880,0,2009,2009,98042,47.337,122.05,2180,5185,5,0,5.5,4060,7065
6.61e+05,2014,232,2,1.5,1750,46173,2,0,0,4,8,1750,0,1964,1964,98072,47.74,122.13,2220,42224,50,0,3.5,3970,43974
3.5e+05,2015,422,3,1.5,1430,12199,1,0,0,3,7,1130,300,1948,1948,98133,47.735,122.33,1490,8196,67,0,4.5,2920,9626
3.055e+05,2014,264,4,2.5,1850,7199,2,0,0,4,7,1850,0,1989,1989,98031,47.403,122.17,1940,7432,25,0,6.5,3790,9282
2.8995e+05,2014,151,3,2.5,1960,3480,2,0,0,3,7,1960,0,2004,2004,98056,47.48,122.18,2560,3500,10,0,5.5,4520,5460
5.57e+05,2015,426,3,3.5,1710,2096,2,0,0,3,8,1290,420,2008,2008,98122,47.605,122.31,1630,1543,7,0,6.5,3340,3253
6.13e+05,2014,135,4,2,1550,4815,1,0,0,3,7,1550,0,1909,1909,98103,47.667,122.34,1680,4013,105,0,6,3230,5563
5.3e+05,2015,436,3,1.75,1520,9605,1,0,0,3,7,1520,0,1975,1975,98052,47.667,122.14,2040,9900,40,0,4.75,3560,11420
1.516e+05,2014,279,2,1,1060,16988,1,0,0,3,6,1060,0,1954,1954,98058,47.431,122.16,2320,10580,60,0,3,3380,11640
7.85e+05,2014,222,2,0.75,1260,4800,1,0,2,4,6,1080,180,1942,1942,98033,47.684,122.21,2660,7200,72,0,2.75,3920,8460
5.65e+05,2015,488,3,1,910,5212,1,0,0,3,7,910,0,1951,1951,98115,47.674,122.28,1520,6300,64,0,4,2430,7210
4.7e+05,2014,223,3,1,1170,4400,1,0,0,3,7,870,300,1951,1951,98199,47.658,122.39,1240,4400,63,0,4,2410,5570
6.8e+05,2014,156,3,2.25,2270,23900,1,0,0,3,9,1820,450,1975,1975,98177,47.751,122.37,2520,28300,39,0,5.25,4790,30570
3.75e+05,2015,388,4,1.75,1870,12500,1,0,1,5,6,1030,840,1943,1943,98056,47.511,122.2,2060,14141,72,0,5.75,3930,16011
5.85e+05,2014,195,3,2.5,2050,11690,2,0,0,4,9,2050,0,1989,1989,98059,47.528,122.16,2410,10172,25,0,5.5,4460,12222
2.5e+05,2014,190,3,2,1440,5457,2,0,0,3,7,1440,0,1986,1986,98038,47.378,122.05,1480,6286,28,0,5,2920,7726
5.67e+05,2015,478,3,2.25,1800,6875,1,0,0,4,8,1230,570,1974,1974,98052,47.677,122.11,1800,8749,41,0,5.25,3600,10549
1.648e+06,2014,222,4,3.5,4610,12500,2,0,2,3,11,4610,0,2003,2003,98033,47.651,122.2,2340,11538,11,0,7.5,6950,16148
3.45e+05,2014,190,3,1.75,3140,8571,1,0,0,4,8,1670,1470,1985,1985,98023,47.307,122.34,2590,7949,29,0,4.75,5730,11089
7.75e+05,2014,251,4,2.5,2540,28563,1,0,0,3,10,2540,0,1984,1984,98052,47.718,122.11,2790,20301,30,0,6.5,5330,22841
7.65e+05,2015,413,3,3,3270,38088,2,0,0,3,10,3270,0,1992,1992,98053,47.669,122.03,1870,37457,23,0,6,5140,40727
5.35e+05,2014,272,3,2.5,1960,47044,2,0,0,4,8,1960,0,1978,1978,98077,47.757,122.07,2020,29004,36,0,5.5,3980,30964
3.4e+05,2014,333,3,1.75,1280,16200,1,0,0,3,8,1030,250,1976,1976,98077,47.743,122.07,1160,10565,38,0,4.75,2440,11845
3.5e+05,2014,196,3,1,1790,3876,1,0,0,5,7,1090,700,1904,1904,98144,47.575,122.29,1360,4080,110,0,4,3150,5870
4.25e+05,2015,408,3,1,1180,8400,1,0,0,3,7,1180,0,1951,1951,98125,47.703,122.3,1740,7020,64,0,4,2920,8200
4.45e+05,2014,317,4,1,1460,4600,1,0,2,3,6,780,680,1946,1946,98126,47.566,122.38,1560,4600,68,0,5,3020,6060
2.03e+05,2015,484,3,1,840,6500,1,0,0,5,6,840,0,1969,1969,98042,47.364,122.08,920,4680,46,0,4,1760,5520
1.955e+06,2015,403,3,1.75,3330,12566,1,1,4,4,8,1940,1390,1960,1960,98040,47.529,122.22,3730,16560,55,0,4.75,7060,19890
2.81e+05,2014,194,3,1,1300,5782,1,0,0,4,6,1300,0,1959,1959,98065,47.524,121.82,1020,7200,55,0,4,2320,8500
7.1e+05,2015,372,4,2.5,2870,11304,2,0,0,3,9,2870,0,1980,1980,98006,47.555,122.15,2690,9940,35,0,6.5,5560,12810
1.098e+06,2015,477,4,3.5,4570,16219,2,0,0,3,11,4570,0,2002,2002,98075,47.586,121.97,4700,16500,13,0,7.5,9270,21070
8.85e+05,2015,492,3,1.5,2200,2880,2,0,0,5,7,1440,760,1904,1904,98112,47.631,122.31,2440,4640,111,0,4.5,4640,6840
5.42e+05,2014,134,4,1.75,1900,8250,1,0,0,4,7,950,950,1955,1955,98006,47.577,122.15,1480,8360,59,0,5.75,3380,10260
5.75e+05,2014,236,3,2.5,1750,4797,2,0,0,4,7,1750,0,1991,1991,98033,47.695,122.2,1750,4293,23,0,5.5,3500,6043
1.65e+06,2015,401,4,3,3900,9750,1,0,4,5,10,2520,1380,1972,1972,98006,47.56,122.16,3410,9450,43,0,7,7310,13350
4.41e+05,2015,430,3,2.5,1890,11036,1,0,0,3,8,1460,430,1973,1973,98133,47.743,122.35,2040,7524,42,0,5.5,3930,9414
2.564e+05,2015,409,3,1.5,1490,7800,1,0,0,3,7,1010,480,1963,1963,98003,47.343,122.3,1570,7800,52,0,4.5,3060,9290
7.9e+05,2015,456,4,3,5370,69848,2,0,0,3,10,3500,1870,2005,2005,98042,47.317,122.05,4443,94403,10,0,7,9813,99773
3.61e+05,2015,445,5,2.75,2380,7500,1,0,0,3,7,1300,1080,1984,1984,98178,47.501,122.23,2400,6000,31,0,7.75,4780,8380
3.08e+05,2014,299,3,1,1980,39150,1,0,0,3,6,1580,400,1932,1932,98030,47.382,122.22,1860,11811,82,0,4,3840,13791
3.6e+05,2015,478,4,2.5,2640,7388,2,0,0,3,7,2640,0,2003,2003,98038,47.35,122.03,2640,6383,12,0,6.5,5280,9023
7.79e+05,2014,243,3,1.75,1990,5600,1,0,1,3,8,1330,660,1941,1941,98199,47.65,122.42,2630,6780,73,0,4.75,4620,8770
3.75e+05,2015,444,5,1.75,2230,7560,1,0,0,3,7,1230,1000,1959,1959,98178,47.505,122.26,1380,6570,56,0,6.75,3610,8800
9.475e+05,2014,132,4,2.25,3290,12329,1,0,0,4,10,3290,0,1968,1968,98040,47.564,122.22,3170,12329,46,0,6.25,6460,15619
8.35e+05,2014,334,4,2.75,4030,10240,2,0,2,3,8,3310,720,1943,1994,98177,47.717,122.36,2490,7680,71,1,6.75,6520,11710
3e+05,2014,211,4,2.5,2080,2999,2,0,0,3,8,2080,0,1998,1998,98059,47.491,122.16,1630,3148,16,0,6.5,3710,5228
2.55e+05,2014,159,2,1,1200,9000,1,0,2,5,6,1200,0,1917,1917,98198,47.404,122.32,1660,9000,97,0,3,2860,10200
5.35e+05,2014,174,3,2.5,2070,4132,2,0,0,3,8,2070,0,1999,1999,98074,47.604,122.02,1530,5606,15,0,5.5,3600,7676
1.5e+06,2015,471,4,3.25,3470,5222,2,0,0,3,10,2830,640,2005,2005,98033,47.684,122.21,3090,6758,10,0,7.25,6560,10228
1.37e+06,2014,156,2,2.25,2460,16940,1,0,4,4,9,1930,530,1936,1936,98117,47.679,122.4,2260,6851,78,0,4.25,4720,9311
5e+05,2014,181,5,3.25,3130,12087,2,0,0,3,8,2180,950,1975,1975,98027,47.534,122.05,2410,10350,39,0,8.25,5540,13480
5.99e+05,2014,189,7,2.5,2580,5750,1,0,0,4,7,1880,700,1901,1901,98122,47.602,122.29,2280,5750,113,0,9.5,4860,8330
4.8e+05,2014,217,3,1.75,1710,4080,1,0,0,4,7,1130,580,1979,1979,98136,47.556,122.39,1200,4080,35,0,4.75,2910,5790
2.35e+05,2014,242,4,1,1610,24000,1,0,0,3,6,1610,0,1947,1947,98001,47.275,122.25,1270,9600,67,0,5,2880,11210
2.785e+05,2015,467,3,2,1570,5250,1,0,0,3,7,1570,0,1998,1998,98092,47.316,122.19,1570,5250,17,0,5,3140,6820
2e+06,2014,148,4,3,4260,18000,2,0,2,3,11,4260,0,2000,2000,98040,47.535,122.24,3540,17015,14,0,7,7800,21275
1.3e+06,2014,313,3,3.25,3400,5979,2,0,0,4,9,2290,1110,1937,1937,98105,47.658,122.27,3090,6435,77,0,6.25,6490,9835
3.1e+05,2014,292,3,3.25,3130,9302,2,0,0,3,8,2190,940,1987,1987,98023,47.308,122.34,2350,7949,27,0,6.25,5480,11079
6.5e+05,2014,293,4,2.5,2770,5612,2,0,0,3,7,2770,0,2001,2001,98053,47.686,122.04,2770,5177,13,0,6.5,5540,7947
4.6e+05,2015,467,4,1.75,1560,7200,1,0,0,3,6,860,700,1943,1943,98115,47.7,122.28,1420,7200,72,0,5.75,2980,8760
5e+05,2014,166,3,1.75,1540,10800,1,0,0,5,6,770,770,1947,1947,98040,47.576,122.22,2020,10800,67,0,4.75,3560,12340
4.023e+05,2014,312,3,1.75,1480,4050,1,0,0,3,7,870,610,1926,1926,98115,47.681,122.3,1350,4500,88,0,4.75,2830,5980
4.57e+05,2014,324,3,1,1170,3348,1,0,0,4,7,1170,0,1924,1924,98117,47.687,122.38,1590,4219,90,0,4,2760,5389
6.66e+05,2014,303,3,2.25,2780,31510,2,0,0,3,8,2780,0,1979,1979,98053,47.67,122.02,2890,36400,35,0,5.25,5670,39180
8.925e+05,2014,232,3,1.75,2120,56192,1,0,1,3,9,1720,400,1959,1959,98177,47.767,122.37,2240,20500,55,0,4.75,4360,22620
2.025e+05,2015,456,3,1.5,1510,9898,1,0,0,3,7,1110,400,1954,1954,98148,47.43,122.33,1420,9250,61,0,4.5,2930,10760
7.15e+05,2015,452,3,2.5,2770,39529,2,0,0,3,9,2770,0,1987,1987,98053,47.65,122.04,3010,35435,28,0,5.5,5780,38205
3.72e+05,2015,382,3,1,2298,10140,1,0,0,3,7,2298,0,1969,1969,98052,47.691,122.08,2580,24724,46,0,4,4878,27022
8.8257e+05,2014,180,4,2.5,3560,5265,3,0,0,3,8,3560,0,2014,2014,98052,47.705,122.11,3220,4892,0,0,6.5,6780,8452
3.2103e+05,2015,393,4,2.25,2820,16770,1,0,0,4,8,1920,900,1966,1966,98023,47.319,122.36,2320,13850,49,0,6.25,5140,16670
7.7e+05,2014,153,3,2.5,2430,54059,2,0,0,3,10,2430,0,1987,1987,98027,47.466,121.99,2910,49658,27,0,5.5,5340,52088
9.5e+05,2014,216,4,2.25,2620,10920,1,0,0,3,9,2620,0,1965,1965,98005,47.612,122.16,2370,11907,49,0,6.25,4990,14527
5.62e+05,2015,466,3,2,3250,50529,2,0,0,4,8,3250,0,1978,1978,98075,47.585,122.02,2370,47480,37,0,5,5620,50730
2.31e+05,2015,464,3,1.75,1220,8817,1,0,0,3,7,1220,0,1978,1978,98023,47.311,122.4,2000,8028,37,0,4.75,3220,9248
5.8e+05,2014,332,5,2.5,2720,5000,1,0,0,4,7,1530,1190,1939,1939,98117,47.683,122.38,1210,5000,75,0,7.5,3930,7720
4.6463e+05,2014,275,4,2.75,2040,8996,1,0,0,4,8,1260,780,1974,1974,98033,47.666,122.19,2470,9180,40,0,6.75,4510,11220
9.15e+05,2014,160,6,3.75,2930,14980,2,0,3,3,9,2930,0,2013,2013,98006,47.544,122.12,3210,10787,1,0,9.75,6140,13717
1.45e+06,2014,291,5,3.5,4170,9090,2,0,0,3,10,4170,0,2008,2008,98004,47.592,122.2,1930,13635,6,0,8.5,6100,17805
2.55e+05,2014,307,2,2,1140,8400,1,0,0,2,7,1140,0,1954,1954,98148,47.435,122.33,1130,9375,60,0,4,2270,10515
4.15e+05,2014,147,5,1.5,1900,10226,1,0,0,3,7,1130,770,1961,1961,98034,47.723,122.23,1690,10227,53,0,6.5,3590,12127
6.4848e+05,2014,143,4,2.75,2250,5700,1,0,0,3,8,1200,1050,1951,1951,98109,47.641,122.34,1720,3850,63,0,6.75,3970,6100
4.85e+05,2015,367,3,2.5,1540,7120,1,0,0,3,7,770,770,1938,2013,98038,47.373,122.04,1000,6638,77,1,5.5,2540,8178
2.5995e+05,2015,383,3,1,1460,5825,1,0,0,5,5,1260,200,1942,1942,98056,47.496,122.19,1150,5926,73,0,4,2610,7386
3.1495e+05,2015,446,3,2.25,1654,8479,2,0,0,3,7,1654,0,1995,1995,98038,47.363,122.04,1654,8479,20,0,5.25,3308,10133
1.107e+05,2014,139,2,1,680,8064,1,0,0,3,6,680,0,1941,1941,98188,47.469,122.3,1340,10800,73,0,3,2020,11480
8.703e+05,2014,132,4,2.5,2350,3150,1,0,0,4,8,1690,660,1910,1910,98103,47.66,122.33,1750,3150,104,0,6.5,4100,5500
9.5e+05,2015,424,5,2.5,3450,35880,2,0,0,3,11,3450,0,1992,1992,98052,47.717,122.1,3450,26820,23,0,7.5,6900,30270
9e+05,2014,250,3,2.75,2980,12600,1,0,0,3,8,1590,1390,1941,2012,98033,47.674,122.2,1520,9660,73,1,5.75,4500,12640
7.75e+05,2015,443,5,2.75,3750,12077,2,0,4,3,10,3750,0,2005,2005,98038,47.352,122,3120,7255,10,0,7.75,6870,11005
3.465e+05,2014,175,3,1,1150,11802,1,0,0,4,7,1150,0,1932,1958,98106,47.562,122.36,1880,6082,82,1,4,3030,7232
4.7e+05,2015,375,4,2.5,2700,6769,2,0,0,3,9,2700,0,1999,1999,98042,47.375,122.16,2880,7968,16,0,6.5,5580,10668
4.595e+05,2014,185,3,1.75,1470,4950,1,0,0,3,7,1030,440,1984,1984,98133,47.733,122.34,1100,5250,30,0,4.75,2570,6720
6.35e+05,2014,196,3,2.5,1530,2978,1,0,0,3,7,1210,320,1997,1997,98117,47.68,122.39,1640,5100,17,0,5.5,3170,6630
5.05e+05,2015,431,2,1,1070,8130,1,0,0,3,7,1070,0,1942,1942,98117,47.697,122.37,1360,7653,73,0,3,2430,8723
2.29e+05,2014,221,3,1,1370,56628,1,0,0,3,7,1370,0,1942,1942,98003,47.306,122.31,1768,8702,72,0,4,3138,10072
3.5e+05,2014,167,3,2,1380,3600,3,0,0,3,8,1380,0,2015,2015,98122,47.607,122.31,1480,3600,-1,0,5,2860,4980
2.73e+05,2014,257,3,2.5,1650,5994,2,0,0,4,7,1650,0,1989,1989,98030,47.36,122.19,1930,6666,25,0,5.5,3580,8316
2.85e+05,2014,139,4,1.75,2080,13629,1,0,0,4,7,1040,1040,1955,1955,98178,47.487,122.23,1780,14659,59,0,5.75,3860,16739
3.905e+05,2015,445,3,2.25,1530,1279,2,0,0,3,7,1116,414,2007,2007,98177,47.703,122.36,1320,1427,8,0,5.25,2850,2957
2.899e+05,2014,191,3,1.75,1220,7004,1,0,0,5,7,1220,0,1966,1966,98058,47.449,122.16,1640,7210,48,0,4.75,2860,8430
6.05e+05,2015,415,2,1.75,1760,5000,1,0,0,4,7,940,820,1927,1927,98117,47.682,122.37,1530,5000,88,0,3.75,3290,6760
4.39e+05,2014,298,5,2,2610,5009,1,0,0,3,7,1710,900,1988,1988,98117,47.697,122.37,1600,5040,26,0,7,4210,7650
9.05e+05,2014,237,4,3.5,2980,3000,2,0,0,3,9,2340,640,2008,2008,98115,47.677,122.33,1810,4545,6,0,7.5,4790,7525
4.35e+05,2015,408,3,2,2040,6880,2,0,0,4,7,2040,0,1954,1954,98133,47.76,122.35,1710,7597,61,0,5,3750,9637
1.11e+06,2015,474,4,2.5,2990,8640,1,0,0,5,8,2100,890,1959,1959,98005,47.593,122.17,2270,8800,56,0,6.5,5260,11790
7.48e+05,2015,362,4,3.5,2770,3330,2,0,0,3,8,1970,800,2001,2001,98052,47.633,122.11,2180,3380,14,0,7.5,4950,6150
8.6e+05,2014,182,4,1.75,1880,3720,1,0,0,4,7,1880,0,1924,1924,98109,47.643,122.36,2090,4095,90,0,5.75,3970,5975
3.41e+05,2014,159,4,1.75,1920,7665,1,0,0,4,8,1500,420,1975,1975,98058,47.448,122.13,2100,7344,39,0,5.75,4020,9264
2.4e+05,2015,459,3,1.75,1760,6500,1,0,0,3,7,1150,610,1987,1987,98038,47.365,122.05,1760,8125,28,0,4.75,3520,9885
6.5e+05,2014,126,3,1.5,1630,7475,1,0,1,3,7,1160,470,1940,1940,98115,47.672,122.27,2320,7475,74,0,4.5,3950,9105
3.49e+05,2015,477,4,2.5,1830,4694,2,0,0,3,7,1830,0,2003,2003,98038,47.357,122.02,1830,5175,12,0,6.5,3660,7005
3.55e+05,2014,255,3,1,1360,8968,1,0,0,3,7,1360,0,1956,1956,98125,47.711,122.29,1490,7355,58,0,4,2850,8715
2.23e+05,2015,436,3,1,1220,71191,1,0,0,3,6,1220,0,1952,1952,98023,47.326,122.35,1960,15378,63,0,4,3180,16598
4.8e+05,2015,401,4,2.5,2980,4074,2,0,0,3,8,2980,0,2011,2011,98019,47.734,121.97,2320,4255,4,0,6.5,5300,7235
4.3e+05,2014,194,3,2.5,1440,7320,1,0,0,5,7,1440,0,1954,1954,98125,47.718,122.32,1160,6941,60,0,5.5,2600,8381
5.25e+05,2015,374,4,3,2650,4924,2,0,0,3,8,2650,0,2011,2011,98028,47.773,122.24,2380,4733,4,0,7,5030,7383
6.2e+05,2014,259,2,1.75,1680,8187,1,0,0,4,8,1680,0,1983,1983,98027,47.56,122.08,2390,7801,31,0,3.75,4070,9481
5.35e+05,2015,458,2,1.75,2330,7280,1,0,0,3,7,1450,880,1982,1982,98188,47.428,122.28,1830,12178,33,0,3.75,4160,14508
2.7995e+05,2015,412,4,2.75,2420,8700,1,0,0,4,7,2420,0,1914,1914,98002,47.311,122.23,1070,4804,101,0,6.75,3490,7224
2.39e+05,2014,313,2,2,1470,2052,1,0,0,3,7,1470,0,1986,1986,98003,47.309,122.33,1470,2052,28,0,4,2940,3522
6.45e+05,2014,175,3,2.75,1850,16960,1,0,2,4,8,1850,0,1953,1953,98177,47.713,122.36,2470,13761,61,0,5.75,4320,15611
4.29e+05,2014,229,3,1.75,2520,5043,1,0,0,3,8,1260,1260,1957,1957,98126,47.534,122.37,1360,4920,57,0,4.75,3880,7440
3.6e+05,2014,248,1,2.25,2060,10600,1,0,0,3,7,1560,500,1927,1983,98003,47.329,122.3,2060,11880,87,1,3.25,4120,13940
3.04e+05,2014,272,2,2.25,1320,1034,3,0,0,3,7,1320,0,1996,1996,98133,47.704,122.34,1330,1206,18,0,4.25,2650,2526
5.1e+05,2014,250,3,1.75,1610,11950,1,0,2,3,7,1210,400,1984,1984,98052,47.67,122.14,1610,9363,30,0,4.75,3220,10973
5.5e+05,2015,446,2,1,980,3080,1,0,0,3,7,980,0,1910,1946,98103,47.665,122.34,1450,3333,105,1,3,2430,4313
5.25e+05,2015,485,3,1.75,2620,38350,1,0,0,4,8,1320,1300,1977,1977,98027,47.462,121.99,2170,36962,38,0,4.75,4790,39582
7.35e+05,2014,265,3,2,1610,3600,2,0,2,5,8,1610,0,1925,1925,98144,47.597,122.29,2540,6600,89,0,5,4150,8210
3.3562e+05,2015,436,3,2.25,1800,15903,1,0,0,3,8,1340,460,1986,1986,98038,47.381,122.04,2000,15233,29,0,5.25,3800,17033
4.35e+05,2014,326,3,1.75,1750,16748,1,0,0,3,7,1330,420,1978,1978,98072,47.742,122.09,1750,16050,36,0,4.75,3500,17800
3.95e+05,2014,174,4,1.75,1540,5120,1,0,0,5,6,770,770,1943,1943,98126,47.536,122.37,1080,5120,71,0,5.75,2620,6660
4.95e+05,2014,312,4,2.5,3390,7870,2,0,0,3,8,3390,0,2014,2014,98188,47.454,122.27,1960,10069,0,0,6.5,5350,13459
2.4e+05,2015,395,3,2,1460,7526,1,0,0,3,7,1460,0,1968,1968,98003,47.346,122.3,1580,7526,47,0,5,3040,8986
5.2e+05,2014,273,3,2.5,1480,1165,3,0,0,3,8,1480,0,2006,2006,98144,47.62,122.3,1480,1231,8,0,5.5,2960,2711
3.97e+05,2014,284,3,1,860,6380,1,0,0,4,7,860,0,1927,1927,98115,47.694,122.31,1250,6380,87,0,4,2110,7240
3.199e+05,2014,215,4,2.75,2475,4000,2,0,0,3,7,2475,0,2014,2014,98002,47.345,122.21,2166,4000,0,0,6.75,4641,6475
6.348e+05,2014,339,4,3,3280,4904,2,0,0,3,7,3280,0,2005,2005,98053,47.68,122.03,2600,5004,9,0,7,5880,8284
4.46e+05,2014,211,4,2,1940,6350,1,0,0,4,7,970,970,1951,1951,98103,47.695,122.36,960,6350,63,0,6,2900,8290
2.02e+05,2015,456,2,1,740,6550,1,0,0,4,5,740,0,1946,1946,98168,47.481,122.33,1080,8515,69,0,3,1820,9255
4.85e+05,2014,174,3,2.5,1500,5412,1,0,0,5,7,900,600,1920,1920,98136,47.55,122.39,1090,5412,94,0,5.5,2590,6912
6.4e+05,2014,264,4,2.5,2970,34981,2,0,0,3,9,2970,0,1998,1998,98077,47.736,122.04,3170,30277,16,0,6.5,6140,33247
3.32e+05,2014,170,3,2,1510,7884,1,0,0,3,6,1510,0,1942,2014,98166,47.468,122.35,1050,7620,72,1,5,2560,9130
3.8e+05,2014,163,4,2.5,2540,6365,2,0,0,3,8,1870,670,2000,2000,98055,47.461,122.22,2290,5942,14,0,6.5,4830,8482
1.457e+06,2014,269,4,1.5,2650,6900,2,0,0,4,9,2400,250,1909,1909,98112,47.627,122.31,2420,6900,105,0,5.5,5070,9550
1.21e+06,2015,472,4,3.75,4980,18069,2,0,3,3,11,4980,0,2006,2006,98065,47.535,121.86,4080,14577,9,0,7.75,9060,19557
2.5e+05,2015,425,3,2,1560,32137,1,0,0,5,7,910,650,1976,1976,98092,47.32,122.12,1470,29150,39,0,5,3030,30710
6.48e+05,2015,399,5,2.5,2210,10772,1,0,2,3,9,1430,780,1964,1964,98155,47.738,122.29,2720,9858,51,0,7.5,4930,12068
3.385e+05,2014,257,4,2.5,2717,4513,2,0,0,3,8,2717,0,2005,2005,98001,47.337,122.27,2550,4841,9,0,6.5,5267,7558
4.25e+05,2015,445,3,2.5,1800,14036,2,0,0,3,8,1800,0,1993,1993,98019,47.733,121.97,2450,14025,22,0,5.5,4250,15825
6.57e+05,2015,379,2,3,1570,1281,3,0,0,3,8,1570,0,2014,2014,98107,47.674,122.38,1570,2500,1,0,5,3140,4070
3.45e+05,2014,300,2,2.25,1110,1290,3,0,0,3,8,1110,0,2006,2006,98103,47.697,122.34,1360,1251,8,0,4.25,2470,2361
7.2e+05,2014,220,3,2.5,1430,2200,1,0,0,4,7,1430,0,1910,1910,98103,47.66,122.33,1740,4275,104,0,5.5,3170,5705
4.145e+05,2015,395,3,1,1050,6002,1,0,0,3,7,840,210,1941,1941,98115,47.699,122.32,1180,6003,74,0,4,2230,7053
6.1e+05,2014,290,5,2.25,2520,11700,2,0,0,3,9,2520,0,1977,1977,98074,47.632,122.05,2530,12000,37,0,7.25,5050,14520
5.448e+05,2015,471,5,2.75,3190,5857,2,0,0,3,9,3190,0,2004,2004,98058,47.458,122.12,3100,5857,11,0,7.75,6290,9047
5.8e+05,2014,191,7,2.75,2310,2400,1,0,0,3,6,2310,0,1915,1915,98117,47.678,122.39,1340,3825,99,0,9.75,3650,6135
8.25e+05,2014,302,4,2.5,2560,4000,2,0,0,5,8,1610,950,1929,1929,98117,47.688,122.39,1760,4000,85,0,6.5,4320,6560
4.638e+05,2015,451,3,1.5,980,7770,1,0,0,4,7,980,0,1968,1968,98033,47.692,122.2,1470,7350,47,0,4.5,2450,8330
1.85e+05,2014,320,3,1.5,1280,4031,2,0,0,4,6,1280,0,1985,1985,98002,47.334,122.22,1150,4500,29,0,4.5,2430,5780
3.55e+05,2014,340,3,1,1240,5400,1,0,0,4,7,1060,180,1940,1940,98133,47.712,122.36,1429,5400,74,0,4,2669,6640
5.3995e+05,2014,349,3,2.25,1670,1596,3,0,0,3,8,1670,0,2014,2014,98136,47.54,122.39,1640,1310,0,0,5.25,3310,2980
9.25e+05,2014,258,4,1.75,2440,11793,1,0,4,3,8,1420,1020,1950,1950,98115,47.681,122.27,2500,8028,64,0,5.75,4940,10468
2.25e+05,2015,424,3,1,1490,15850,1,0,0,3,7,1490,0,1946,1946,98133,47.741,122.35,1950,13228,69,0,4,3440,14718
8.348e+05,2014,230,3,3.5,3470,4171,3,0,0,3,9,3470,0,2008,2008,98034,47.711,122.23,3430,4268,6,0,6.5,6900,7738
5.38e+05,2014,349,3,2.5,2250,11632,2,0,0,3,8,2250,0,1988,1988,98056,47.527,122.17,2360,11632,26,0,5.5,4610,13882
1.45e+06,2014,324,4,3.5,4300,1.0887e+05,2,0,0,3,11,4300,0,2014,2014,98074,47.626,122,4650,1.075e+05,0,0,7.5,8950,1.118e+05
2.2e+05,2015,470,2,1,1060,10423,1,0,0,3,7,1060,0,1965,1965,98125,47.705,122.31,2240,10200,50,0,3,3300,11260
1.5e+05,2014,325,2,1,720,4120,1,0,0,5,5,720,0,1915,1915,98002,47.303,122.22,940,6180,99,0,3,1660,6900
8e+05,2014,173,3,2.25,2380,11824,1,0,0,4,9,1450,930,1972,1972,98040,47.537,122.22,2750,11491,42,0,5.25,5130,13871
3.25e+05,2014,300,3,2,1670,17071,1,0,0,3,7,1100,570,1988,1988,98014,47.69,121.91,1660,15593,26,0,5,3330,17263
1.735e+06,2014,287,4,3.5,4010,9654,2,0,0,3,10,4010,0,2007,2007,98004,47.589,122.2,1870,9873,7,0,7.5,5880,13883
3.5e+05,2015,368,3,1,950,9451,1,0,0,4,7,950,0,1977,1977,98034,47.731,122.19,1480,8352,38,0,4,2430,9302
5.75e+05,2014,301,3,3.5,2514,1559,2,0,0,3,8,2024,490,2007,2007,98034,47.704,122.21,2090,10454,7,0,6.5,4604,12968
4.7e+05,2014,232,4,1,2590,18224,1,0,0,4,7,2000,590,1911,1911,98118,47.532,122.29,1800,7080,103,0,5,4390,9670
3.55e+05,2014,297,3,0.75,1420,3060,1,0,0,4,7,860,560,1923,1923,98103,47.687,122.35,1350,4000,91,0,3.75,2770,5420
5.5e+05,2014,262,3,2.25,1700,1481,3,0,0,3,8,1700,0,2002,2002,98103,47.66,122.35,1560,1350,12,0,5.25,3260,3050
6.725e+05,2014,177,3,2.25,2400,5300,1,0,0,4,7,1250,1150,1939,1939,98117,47.688,122.38,1540,4800,75,0,5.25,3940,7200
2.3995e+05,2014,133,3,1,1900,33888,1,0,0,4,5,1900,0,1942,1942,98001,47.274,122.27,1430,19200,72,0,4,3330,21100
9.62e+05,2014,284,4,2.75,3340,5700,2,0,0,3,11,3340,0,2013,2013,98059,47.506,122.15,3340,6940,1,0,6.75,6680,10280
3.85e+05,2015,471,5,1.75,2190,8250,1,0,2,3,7,1190,1000,1963,1963,98055,47.489,122.22,2570,8250,52,0,6.75,4760,10440
3.4e+05,2015,428,4,2.5,1910,7201,1,0,0,3,7,1210,700,1987,1987,98198,47.391,122.32,1690,7554,28,0,6.5,3600,9464
2.6e+05,2014,352,3,2.25,1950,9600,1,0,0,4,7,1200,750,1987,1987,98092,47.276,122.15,1760,8850,27,0,5.25,3710,10800
2.5e+05,2014,285,2,1,890,6380,1,0,0,3,6,890,0,1951,1951,98115,47.691,122.3,990,6380,63,0,3,1880,7270
8.85e+05,2014,170,3,2.25,2060,9552,1,0,0,4,9,1610,450,1975,1975,98040,47.54,122.23,2930,11212,39,0,5.25,4990,13272
3.9995e+05,2014,215,3,2.25,1360,1041,2,0,0,3,8,1094,266,2006,2006,98117,47.693,122.38,1522,1382,8,0,5.25,2882,2742
1.47e+05,2014,346,3,1,1070,14000,1,0,0,3,7,1070,0,1960,1960,98178,47.497,122.28,920,12500,54,0,4,1990,13570
6.23e+05,2014,283,4,2.75,2300,12633,2,0,0,3,9,2300,0,1984,1984,98074,47.622,122.03,2240,9246,30,0,6.75,4540,11546
6.2725e+05,2015,440,4,2.5,2830,10677,2,0,0,3,9,2830,0,1993,1993,98011,47.742,122.21,2970,9619,22,0,6.5,5800,12449
2.72e+05,2014,218,3,2,1200,5700,1,0,0,5,7,1200,0,1942,1942,98178,47.503,122.24,1190,6384,72,0,5,2390,7584
1.7e+05,2014,154,2,1,1500,18540,1,0,0,3,8,1500,0,1950,1950,98168,47.473,122.28,1700,9355,64,0,3,3200,10855
2.25e+05,2014,287,2,1,800,6050,1,0,0,4,6,800,0,1944,1944,98178,47.5,122.24,880,6050,70,0,3,1680,6850
4.75e+05,2015,396,4,2.5,2320,10046,2,0,0,3,7,2320,0,2006,2006,98065,47.541,121.89,2320,5253,9,0,6.5,4640,7573
4.625e+05,2014,318,2,2,1540,7290,2,0,0,3,7,1540,0,1948,1983,98136,47.551,122.39,1540,7072,66,1,4,3080,8612
4.11e+05,2014,203,3,1.75,1490,9844,1,0,0,4,7,1190,300,1959,1959,98155,47.763,122.3,1840,10150,55,0,4.75,3330,11640
2.9e+05,2014,201,2,1,850,6800,1,0,0,3,7,850,0,1948,1948,98133,47.728,122.34,870,6800,66,0,3,1720,7650
2.94e+05,2014,320,3,2,1650,11256,1,0,0,4,7,1250,400,1957,1957,98168,47.471,122.26,1860,11256,57,0,5,3510,12906
2.87e+05,2014,342,2,1.5,720,4346,1,0,0,4,6,720,0,1942,1942,98106,47.523,122.35,790,4346,72,0,3.5,1510,5066
3.8e+05,2014,169,4,2.25,2150,20181,1,0,0,3,7,1090,1060,1963,1963,98028,47.763,122.25,2150,10480,51,0,6.25,4300,12630
5.49e+05,2014,167,2,2.5,1380,953,3,0,0,3,9,1380,0,2006,2006,98103,47.665,122.36,1430,3400,8,0,4.5,2810,4780
3.7851e+05,2015,464,2,1,770,5185,1,0,0,3,7,770,0,1947,1947,98126,47.546,122.38,1260,6550,68,0,3,2030,7320
1.9e+05,2014,319,3,1,1200,8316,1,0,0,4,6,1200,0,1953,1953,98002,47.323,122.22,1250,8316,61,0,4,2450,9516
4.8e+05,2014,298,4,2.5,3230,16171,2,0,3,3,9,2520,710,2001,2001,98001,47.318,122.25,2640,8517,13,0,6.5,5870,11747
2.6e+05,2014,263,3,2,1810,7209,1,0,0,4,7,1240,570,1978,1978,98032,47.366,122.28,1750,7209,36,0,5,3560,9019
3e+05,2015,439,3,1.75,1500,8352,1,0,2,5,6,750,750,1943,1943,98056,47.488,122.19,1500,8447,72,0,4.75,3000,9947
5.8e+05,2014,176,4,1.75,1720,6975,1,0,0,3,8,1420,300,1975,1975,98052,47.651,122.12,2210,7875,39,0,5.75,3930,9595
9.52e+05,2014,348,3,3.5,2760,4500,2,0,0,3,9,2120,640,2004,2004,98119,47.653,122.37,1950,6000,10,0,6.5,4710,8760
4.38e+05,2014,188,2,2,1270,1372,3,0,0,3,8,1270,0,2000,2000,98115,47.678,122.32,1610,3090,14,0,4,2880,4360
5.46e+05,2014,155,2,1,970,3400,1,0,0,3,7,970,0,1924,1924,98109,47.644,122.36,1180,3600,90,0,3,2150,4570
4.53e+05,2015,446,3,1,2160,11484,1,0,0,4,7,2160,0,1968,1968,98034,47.728,122.19,2270,10080,47,0,4,4430,12240
4.85e+05,2014,198,4,1,1150,2560,1,0,0,3,7,1150,0,1909,1909,98109,47.637,122.36,1890,3000,105,0,5,3040,4150
3.8995e+05,2014,142,4,2.5,3140,8060,2,0,0,3,9,3140,0,1991,1991,98023,47.309,122.34,3000,8060,23,0,6.5,6140,11200
2.35e+05,2014,153,3,1,1250,15603,1,0,0,4,7,1250,0,1959,1959,98056,47.509,122.17,1720,10220,55,0,4,2970,11470
2.38e+05,2014,304,3,2.5,1650,2807,2,0,0,3,7,1650,0,2004,2004,98055,47.433,122.2,1460,1875,10,0,5.5,3110,3525
7.2689e+05,2015,465,5,3,2970,7261,2,0,0,3,9,2970,0,1999,1999,98075,47.599,122.02,2970,8437,16,0,8,5940,11407
3.9e+05,2014,243,3,1,1000,6947,1,0,0,3,7,1000,0,1947,1947,98125,47.714,122.32,1000,6947,67,0,4,2000,7947
8.1e+05,2014,139,4,2.5,3480,59242,2,0,0,3,11,3480,0,1988,1988,98072,47.739,122.1,2930,39400,26,0,6.5,6410,42880
5.785e+05,2014,347,3,1,1490,5700,1,0,0,3,7,1490,0,1916,1916,98103,47.655,122.33,2290,5700,98,0,4,3780,7190
7.25e+05,2014,294,3,2,2110,5800,1,0,0,4,7,1990,120,1927,1927,98103,47.664,122.34,1620,4300,87,0,5,3730,6410
5.68e+05,2014,188,4,1.75,2790,17476,1,0,2,3,7,1450,1340,1956,1956,98166,47.456,122.37,2790,16401,58,0,5.75,5580,19191
3.05e+05,2014,277,4,2.5,2230,6487,2,0,0,3,7,2230,0,2003,2003,98092,47.329,122.17,2230,6882,11,0,6.5,4460,9112
2.05e+05,2014,170,3,1,960,7314,1,0,0,5,6,960,0,1960,1960,98002,47.289,122.22,990,7314,54,0,4,1950,8274
2.6e+05,2014,332,3,1.75,1710,6400,1,0,0,4,7,1240,470,1976,1976,98023,47.304,122.38,1600,6400,38,0,4.75,3310,8110
4.4583e+05,2014,147,3,2.5,1870,5449,2,0,0,3,8,1870,0,2003,2003,98011,47.756,122.22,2000,7687,11,0,5.5,3870,9557
2.77e+05,2014,237,3,2.25,2160,9612,2,0,0,3,7,2160,0,1994,1994,98022,47.193,122.01,1970,9247,20,0,5.25,4130,11407
3.8995e+05,2014,263,3,2.5,1700,6396,2,0,0,3,7,1700,0,2003,2003,98065,47.533,121.87,1700,4444,11,0,5.5,3400,6144
3.85e+05,2014,197,3,1.5,1360,2030,3,0,0,3,8,1360,0,2008,2008,98103,47.696,122.35,1360,1167,6,0,4.5,2720,2527
4.6e+05,2014,146,2,1.5,2730,19877,1,0,0,4,8,1570,1160,1976,1976,98019,47.77,121.9,1450,19509,38,0,3.5,4180,22239
3.625e+05,2014,173,2,1.5,940,1768,2,0,0,3,7,940,0,2009,2009,98144,47.593,122.3,1130,1159,5,0,3.5,2070,2099
7.55e+05,2014,125,4,2.5,2120,10202,1,0,0,4,7,1620,500,1960,1960,98005,47.586,122.17,1570,10762,54,0,6.5,3690,12882
5.37e+05,2014,148,3,2.5,1550,12920,2,0,0,5,7,1550,0,1999,1999,98033,47.697,122.19,2610,10800,15,0,5.5,4160,12350
3.61e+05,2014,216,3,2,1950,8698,1,0,0,3,8,1950,0,1999,1999,98042,47.39,122.15,2330,7212,15,0,5,4280,9162
5.5e+05,2015,477,3,1,1140,8180,1,0,0,3,7,1140,0,1959,1959,98005,47.585,122.17,1510,8588,56,0,4,2650,9728
2.45e+05,2014,265,3,1.5,1550,9126,1,0,0,5,7,1550,0,1957,1957,98022,47.201,122,1450,9282,57,0,4.5,3000,10832
4.75e+05,2014,182,4,2,2100,13468,1,0,0,5,7,1050,1050,1962,1962,98125,47.714,122.29,1470,8675,52,0,6,3570,10775
3.095e+05,2014,298,3,1,1250,7320,1,0,0,3,7,1250,0,1968,1968,98059,47.507,122.16,1770,7320,46,0,4,3020,8570
2.7e+05,2014,235,4,1.5,1930,15000,1,0,0,5,7,1930,0,1946,1946,98198,47.386,122.31,1620,7500,68,0,5.5,3550,9430
1e+06,2014,263,3,2.75,2370,8900,1,0,4,4,9,1670,700,1971,1971,98006,47.565,122.16,2840,8956,43,0,5.75,5210,11326
6.85e+05,2014,280,5,2.5,3160,5635,2,0,0,3,9,3160,0,2003,2003,98027,47.536,122.07,3670,6087,11,0,7.5,6830,9247
6.67e+05,2014,205,5,2,1900,5470,1,0,0,3,7,1180,720,1930,1965,98105,47.667,122.3,1300,3250,84,1,7,3200,5150
1.45e+06,2014,301,5,2.75,3090,19865,1,0,0,4,9,3090,0,1953,1953,98039,47.623,122.23,2970,19862,61,0,7.75,6060,22952
7.25e+05,2014,325,4,1.75,2700,6000,1,0,0,4,8,1450,1250,1953,1953,98199,47.654,122.39,2080,6000,61,0,5.75,4780,8700
5.35e+05,2014,141,2,1,1030,4841,1,0,0,3,7,920,110,1939,1939,98103,47.686,122.34,1530,4944,75,0,3,2560,5974
6.51e+05,2014,244,3,2,1940,6440,1,0,2,5,7,970,970,1940,1940,98116,47.566,122.39,1730,4640,74,0,5,3670,6580
3.45e+05,2015,386,3,2.5,2340,8414,1,0,0,3,7,1280,1060,1993,1993,98188,47.468,122.27,2340,7268,22,0,5.5,4680,9608
3.6995e+05,2015,484,2,2.75,1370,1140,2,0,0,3,8,1080,290,2009,2009,98133,47.705,122.34,1370,1090,6,0,4.75,2740,2460
4.53e+05,2015,436,3,2.5,1750,3900,2,0,0,3,8,1750,0,1977,1977,98052,47.664,122.13,1750,5700,38,0,5.5,3500,7450
5.53e+05,2014,276,3,2.75,3160,9072,2,0,0,3,9,3160,0,2005,2005,98056,47.515,122.18,3160,9072,9,0,5.75,6320,12232
5.4e+05,2014,163,5,3,3610,9775,2,0,0,3,8,3610,0,2003,2003,98038,47.355,122.01,2800,8582,11,0,8,6410,12192
3.1995e+05,2014,169,2,1,920,8341,1,0,0,3,7,920,0,1939,1939,98146,47.502,122.38,2330,9792,75,0,3,3250,10712
4.0095e+05,2014,325,4,2.5,2578,4554,2,0,0,3,9,2578,0,2014,2014,98092,47.26,122.19,2647,4554,0,0,6.5,5225,7132
3.549e+05,2014,263,3,1,1720,16552,1,0,0,4,7,1720,0,1971,1971,98059,47.477,122.15,1550,15457,43,0,4,3270,17177
7.0564e+05,2015,409,3,2.25,2400,12350,1,0,0,4,8,1420,980,1968,1968,98033,47.653,122.19,2615,12043,47,0,5.25,5015,14443
4.21e+05,2014,255,2,1.5,1400,11245,1,0,0,5,7,1400,0,1947,1947,98155,47.747,122.32,1220,11241,67,0,3.5,2620,12641
2.35e+06,2015,415,6,4.25,5550,11547,2,0,2,3,11,4270,1280,2014,2014,98033,47.655,122.2,3480,11547,1,0,10.25,9030,17097
6.91e+05,2015,388,4,3,3040,11651,2,0,0,3,10,3040,0,1987,1987,98074,47.635,122.04,2540,11815,28,0,7,5580,14855
2.17e+05,2015,447,3,2.5,1340,4200,2,0,0,3,7,1340,0,2002,2002,98002,47.294,122.23,990,4520,13,0,5.5,2330,5860
3.4995e+05,2014,279,4,1.75,1780,5000,1,0,0,5,7,890,890,1903,1903,98108,47.533,122.29,1860,5000,111,0,5.75,3640,6780
2.1e+05,2014,201,2,1,700,7303,1,0,0,5,5,700,0,1953,1953,98056,47.493,122.17,960,6060,61,0,3,1660,6760
7.17e+05,2014,162,3,2.5,2480,5137,2,0,0,3,9,2480,0,2000,2000,98052,47.684,122.16,2480,6023,14,0,5.5,4960,8503
2.65e+05,2015,429,3,2.5,1890,6088,2,0,0,3,7,1890,0,1996,1996,98002,47.289,122.22,1700,6600,19,0,5.5,3590,8490
4.35e+05,2014,299,4,2.5,2190,6578,2,0,0,3,7,2190,0,2004,2004,98065,47.531,121.85,2190,5416,10,0,6.5,4380,7606
3.8e+05,2014,202,3,1.75,1750,10870,1,0,0,5,7,1750,0,1968,1968,98056,47.499,122.19,1230,10868,46,0,4.75,2980,12618
2.99e+05,2015,477,3,2.5,1572,4000,2,0,0,3,8,1572,0,2013,2013,98092,47.261,122.2,1608,5175,2,0,5.5,3180,6747
3.95e+05,2015,471,3,2.5,1960,3953,2,0,0,3,8,1960,0,1999,1999,98059,47.49,122.16,1690,3593,16,0,5.5,3650,5553
1.2e+06,2015,407,4,2.5,3350,11688,1,0,2,3,10,1760,1590,1995,1995,98006,47.551,122.13,4240,10804,20,0,6.5,7590,14154
5.2e+05,2014,223,4,2.5,2280,8798,2,0,0,4,8,2280,0,1987,1987,98028,47.747,122.25,2180,8632,27,0,6.5,4460,10912
2.3175e+05,2015,451,3,1,1020,7615,1,0,0,3,7,1020,0,1981,1981,98058,47.429,122.15,1470,9515,34,0,4,2490,10535
2.75e+05,2014,353,3,1,1290,11250,1,0,0,3,7,1290,0,1956,1956,98166,47.474,122.34,1410,11196,58,0,4,2700,12486
3.33e+05,2014,218,4,2.5,2623,7184,2,0,0,3,8,2623,0,2012,2012,98092,47.259,122.2,2010,4939,2,0,6.5,4633,7562
2.55e+05,2014,127,5,2.25,2060,8632,1,0,0,3,7,1030,1030,1962,1962,98146,47.488,122.33,1010,11680,52,0,7.25,3070,13740
5.07e+05,2014,169,3,2.5,2120,7201,2,0,0,3,8,2120,0,2003,2003,98133,47.717,122.34,1930,7206,11,0,5.5,4050,9326
4.9e+05,2014,160,4,2.5,3020,8302,2,0,0,4,10,3020,0,1994,1994,98042,47.363,122.13,3020,8406,20,0,6.5,6040,11426
4.4e+05,2014,244,1,1,850,6567,1,0,0,4,6,850,0,1940,1940,98010,47.327,122.04,2160,9794,74,0,2,3010,10644
6.74e+05,2015,376,3,3.25,2320,6744,2,0,0,3,9,1930,390,2014,2014,98125,47.713,122.29,1700,6744,1,0,6.25,4020,9064
8e+05,2015,396,4,2.5,4940,10037,1,0,4,3,9,3450,1490,1953,1953,98178,47.51,122.25,2430,9272,62,0,6.5,7370,14212
2.97e+05,2014,299,2,1.5,1430,1650,3,0,0,3,7,1430,0,1999,1999,98125,47.722,122.29,1430,1650,15,0,3.5,2860,3080
2.75e+05,2014,154,3,2.5,1720,8755,1,0,0,3,8,1000,720,1983,1983,98023,47.319,122.39,1720,8690,31,0,5.5,3440,10410
2.3e+05,2014,360,6,1.5,1810,4838,1,0,0,4,5,1050,760,1905,1905,98055,47.487,122.2,1300,4838,109,0,7.5,3110,6648
3.3e+05,2015,477,4,2,1820,9450,1,0,0,3,7,1100,720,1962,1962,98155,47.761,122.33,1540,9450,53,0,6,3360,11270
3.2e+05,2014,152,5,2.5,3020,21441,1,0,0,4,8,1510,1510,1978,1978,98042,47.339,122.13,1610,16445,36,0,7.5,4630,19465
7.5e+05,2014,242,3,1,1640,6516,1,0,0,4,7,1440,200,1935,1935,98103,47.669,122.34,1770,4000,79,0,4,3410,5640
2.6e+05,2014,140,4,2.5,1990,6671,2,0,0,3,7,1990,0,1989,1989,98023,47.308,122.36,1862,6566,25,0,6.5,3852,8556
5.5e+05,2014,335,3,2.5,3070,14400,1,0,3,5,9,1720,1350,1985,1985,98198,47.372,122.32,2020,18211,29,0,5.5,5090,21281
9.8e+05,2015,479,4,1.75,2260,17711,1,0,1,4,9,2260,0,1968,1968,98040,47.55,122.21,2880,16594,47,0,5.75,5140,18854
4.75e+05,2014,318,4,2.25,1970,7532,1,0,0,3,8,1390,580,1983,1983,98052,47.722,122.11,1970,8248,31,0,6.25,3940,10218
2.3495e+05,2014,249,3,2,1430,10850,1,0,0,3,7,1430,0,1994,1994,98001,47.267,122.23,1610,8015,20,0,5,3040,9445
3.3e+05,2015,467,3,1.75,1250,8100,1,0,0,3,7,1250,0,1951,2004,98146,47.502,122.35,1300,8175,64,1,4.75,2550,9425
3.77e+05,2014,235,1,1,950,10585,1,0,0,3,6,950,0,1929,1929,98115,47.697,122.3,1400,7056,85,0,2,2350,8006
2e+05,2014,194,1,1.5,1010,1157,2,0,0,3,8,950,60,2007,2007,98126,47.549,122.37,1360,1688,7,0,2.5,2370,2698
5.5e+05,2015,465,3,2.25,2120,18255,1,0,0,3,8,1590,530,1984,1984,98074,47.628,122.04,2120,12997,31,0,5.25,4240,15117
7.125e+05,2014,277,5,2,2280,5400,1,0,0,4,7,1340,940,1947,1947,98105,47.667,122.28,1770,5000,67,0,7,4050,7280
4.78e+05,2015,383,3,2.25,1570,9500,1,0,0,4,7,1070,500,1977,1977,98033,47.684,122.19,2250,9583,38,0,5.25,3820,11153
4.45e+05,2014,190,2,1,840,3840,1,0,0,4,7,840,0,1926,1926,98117,47.684,122.38,1310,3840,88,0,3,2150,4680
3.4e+05,2015,409,3,1,1840,8100,1,0,0,4,7,920,920,1953,1953,98166,47.455,122.35,1250,8100,62,0,4,3090,9940
3.97e+05,2014,230,4,2.5,1790,6590,2,0,0,3,7,1790,0,2005,2005,98059,47.483,122.13,1950,5180,9,0,6.5,3740,6970
6.57e+05,2014,236,5,2.5,2530,10190,1,0,0,4,7,1290,1240,1960,1960,98008,47.616,122.11,2040,8560,54,0,7.5,4570,11090
4.3e+05,2014,318,3,1.75,1810,7300,1,0,0,4,7,1240,570,1976,1976,98034,47.73,122.19,1460,7560,38,0,4.75,3270,9370
3.38e+05,2015,463,2,1,690,6400,1,0,0,3,6,690,0,1943,1943,98126,47.529,122.37,1000,6400,72,0,3,1690,7090
2.79e+05,2015,446,3,2.5,1920,7779,2,0,0,3,7,1920,0,1989,1989,98031,47.402,122.17,1960,7536,26,0,5.5,3880,9456
1.02e+06,2014,332,6,2.25,2550,5000,2,0,0,4,7,2550,0,1907,1907,98117,47.678,122.4,1480,5000,107,0,8.25,4030,7550
5.18e+05,2014,273,4,2.75,2440,12051,1,0,0,5,8,1440,1000,1966,1966,98133,47.746,122.35,2030,8006,48,0,6.75,4470,10446
4.21e+05,2015,477,3,2.5,1930,4505,1,0,3,4,7,1440,490,1973,1973,98198,47.346,122.33,1550,4505,42,0,5.5,3480,6435
2.27e+05,2015,445,2,1,1040,9100,1,0,0,4,7,1040,0,1937,1937,98133,47.741,122.35,1950,13228,78,0,3,2990,14268
9.985e+05,2014,271,2,1,1570,4400,1,0,0,4,8,1570,0,1914,1914,98122,47.611,122.29,1850,4400,100,0,3,3420,5970
3.355e+05,2014,211,5,3,2240,19090,1,0,0,4,8,1700,540,1968,1968,98058,47.442,122.15,2280,20000,46,0,8,4520,22240
6.1e+05,2015,382,4,2.75,2640,8400,1,0,2,3,8,1440,1200,1947,1947,98144,47.588,122.29,2610,6000,68,0,6.75,5250,8640
5.75e+05,2015,424,2,1,1250,4320,1,0,0,4,7,850,400,1911,1911,98103,47.655,122.35,1520,4320,104,0,3,2770,5570
5.171e+05,2015,463,3,1.75,1580,9719,1,0,0,5,7,1580,0,1962,1962,98056,47.54,122.18,1760,8539,53,0,4.75,3340,10119
6.087e+05,2014,306,4,2.5,2260,9696,1,0,0,3,9,2260,0,1983,1983,98074,47.643,122.07,2400,12111,31,0,6.5,4660,14371
1.785e+05,2014,201,2,1,740,6460,1,0,0,3,6,740,0,1953,1953,98146,47.508,122.34,1170,6975,61,0,3,1910,7715
3.72e+05,2015,376,3,2.5,1920,15260,2,0,0,3,7,1920,0,1990,1990,98019,47.732,121.96,2370,15235,25,0,5.5,4290,17155
4.51e+05,2014,342,4,1.75,1680,7800,1,0,0,3,7,1330,350,1966,1966,98008,47.629,122.12,1680,7210,48,0,5.75,3360,8890
2.99e+05,2014,299,3,2,1730,6007,1,0,0,3,8,1730,0,2004,2004,98030,47.357,122.2,2000,6245,10,0,5,3730,7975
5.2495e+05,2014,139,3,1.75,1890,3825,1,0,0,3,7,1290,600,1974,1974,98117,47.683,122.38,1320,3825,40,0,4.75,3210,5715
5.499e+05,2014,201,2,1.75,1140,936,2,0,0,3,8,940,200,2014,2014,98105,47.665,122.28,1160,1327,0,0,3.75,2300,2467
6.585e+05,2014,206,2,1,1410,5101,1,0,0,3,8,1410,0,1927,1927,98103,47.687,122.33,1410,4224,87,0,3,2820,5634
4.69e+05,2014,152,3,1,950,4250,1,0,0,5,6,950,0,1948,1948,98122,47.609,122.31,2130,5120,66,0,4,3080,6070
7.15e+05,2014,354,4,2.5,2970,5722,2,0,0,3,9,2970,0,2005,2005,98074,47.613,122.04,3940,4848,9,0,6.5,6910,7818
4.54e+05,2015,401,4,2.5,3040,12522,2,0,0,3,7,3040,0,2000,2000,98019,47.725,121.96,2490,9742,15,0,6.5,5530,12782
3.5978e+05,2014,331,3,2.5,1850,3400,2,0,0,3,7,1850,0,2010,2010,98053,47.687,122.01,1850,3400,4,0,5.5,3700,5250
7.4e+05,2014,209,4,3.5,3760,57063,2,0,0,3,9,2950,810,1998,1998,98053,47.633,121.96,2870,28945,16,0,7.5,6630,32705
2.59e+05,2014,203,2,1,1210,17389,1,0,0,4,5,1210,0,1948,1948,98059,47.504,122.15,2140,14419,66,0,3,3350,15629
6.298e+05,2014,181,3,2.5,2390,1984,2,0,0,3,8,2220,170,2008,2008,98027,47.541,122.03,2150,1984,6,0,5.5,4540,4374
7.21e+05,2015,446,4,2.75,2690,5400,2,0,0,3,7,2210,480,1940,2009,98117,47.696,122.37,1620,5400,75,1,6.75,4310,8090
2.695e+05,2014,214,2,1,800,1200,2,0,0,3,7,800,0,1999,1999,98103,47.697,122.35,806,1200,15,0,3,1606,2000
4.769e+05,2015,486,3,1,1240,5758,1,0,0,4,6,960,280,1910,1910,98116,47.568,122.4,1460,5750,105,0,4,2700,6990
8.383e+05,2014,244,6,2.5,3760,12978,1,0,0,3,9,2360,1400,1967,1967,98117,47.698,122.38,2300,7362,47,0,8.5,6060,11122
4.5e+05,2014,176,2,1.75,840,3340,1,0,0,3,6,700,140,1912,1912,98107,47.669,122.36,1700,3980,102,0,3.75,2540,4820
9.25e+05,2014,297,4,3.75,4420,9492,2,0,1,3,9,3420,1000,1962,2005,98125,47.721,122.28,2880,9900,52,1,7.75,7300,14320
3e+05,2014,279,4,2.5,1910,8058,2,0,0,3,8,1910,0,1992,1992,98031,47.389,122.17,1910,6500,22,0,6.5,3820,8410
8.18e+05,2015,395,4,2.5,4020,44431,2,0,0,3,10,4020,0,1987,1987,98072,47.747,122.13,3440,52900,28,0,6.5,7460,56920
2.15e+05,2014,347,5,1.5,1980,7958,1,0,0,3,7,1980,0,1962,1962,98058,47.457,122.17,1510,8438,52,0,6.5,3490,10418
7.73e+05,2014,134,3,2.75,2470,3600,2,0,0,3,9,2470,0,2007,2007,98029,47.541,121.99,2570,3600,7,0,5.75,5040,6070
6.5e+05,2015,447,5,2.25,2400,13450,1,0,0,5,7,1200,1200,1957,1957,98008,47.601,122.12,1950,10361,58,0,7.25,4350,12761
4.4645e+05,2014,224,3,1.5,1480,7749,1,0,0,5,7,1480,0,1960,1960,98126,47.514,122.38,1140,5320,54,0,4.5,2620,6800
7.161e+05,2014,194,3,1,1640,4000,1,0,0,5,7,1640,0,1909,1909,98103,47.656,122.35,2140,4000,105,0,4,3780,5640
4.099e+05,2015,447,3,2.5,1690,1200,2,0,0,3,8,1410,280,2013,2013,98106,47.539,122.37,1690,1760,2,0,5.5,3380,3450
5.05e+05,2014,276,3,2.5,1995,1483,3,0,0,3,8,1760,235,2005,2005,98102,47.602,122.31,1520,1173,9,0,5.5,3515,3168
5.399e+05,2014,209,3,2.5,2500,4203,2,0,0,3,8,2500,0,2001,2001,98065,47.535,121.88,2460,4798,13,0,5.5,4960,7298
3.48e+05,2015,380,4,2.5,2070,3808,2,0,0,3,8,2070,0,2003,2003,98058,47.45,122.12,1900,2992,12,0,6.5,3970,5062
7.425e+05,2014,129,4,2.75,3100,3773,2,0,0,3,8,2000,1100,1919,1996,98122,47.616,122.29,2130,3777,95,1,6.75,5230,6877
3.21e+05,2014,256,4,2.5,2430,5366,2,0,0,3,8,2430,0,2002,2002,98092,47.335,122.19,2100,5414,12,0,6.5,4530,7844
8.2e+05,2014,197,5,2.75,2830,6137,2,0,0,3,9,2830,0,2010,2010,98074,47.593,122.06,3170,6285,4,0,7.75,6000,9115
3.9e+05,2015,450,3,1,1010,7920,1,0,0,3,6,1010,0,1925,1925,98126,47.525,122.37,1520,7560,90,0,4,2530,8570
5.775e+05,2014,314,3,2.5,2280,10879,2,0,0,3,9,2280,0,1984,1984,98074,47.622,122.03,2400,9536,30,0,5.5,4680,11816
9.75e+05,2015,486,5,2.5,3020,9648,1,0,2,4,9,1980,1040,1977,1977,98006,47.559,122.13,2890,12598,38,0,7.5,5910,15618
3.65e+05,2014,148,3,1.5,1300,12240,1,0,0,3,7,1300,0,1963,1963,98028,47.737,122.24,2040,9326,51,0,4.5,3340,10626
2.25e+05,2015,426,4,1.75,1420,10300,2,0,0,3,7,1420,0,1950,2001,98002,47.312,122.22,1420,10300,65,1,5.75,2840,11720
2.6e+05,2015,414,3,1.75,2160,22702,1,0,0,4,7,2160,0,1981,1981,98019,47.736,121.98,1820,22687,34,0,4.75,3980,24847
9.2e+05,2014,208,3,2.25,3650,5353,2,0,4,4,7,2200,1450,1947,1947,98144,47.595,122.29,1950,4970,67,0,5.25,5600,8620
3.3495e+05,2014,290,4,1.75,1700,40973,1,0,0,3,8,1700,0,1961,1961,98031,47.344,122.2,2760,40973,53,0,5.75,4460,42673
4.1e+05,2015,470,3,1,1410,5000,1,0,0,3,6,980,430,1925,1925,98116,47.577,122.4,1410,5000,90,0,4,2820,6410
1.5e+06,2015,430,3,3,3110,9015,1,0,4,4,10,1590,1520,1980,1980,98033,47.662,122.2,3150,11447,35,0,6,6260,14557
5.81e+05,2014,181,4,1,1630,2566,1,0,0,3,7,1630,0,1921,1921,98122,47.618,122.3,1220,2314,93,0,5,2850,3944
3.35e+05,2015,474,2,1,1800,8900,1,0,0,3,6,900,900,1945,1945,98168,47.51,122.32,2040,10450,70,0,3,3840,12250
4.32e+05,2015,481,3,2,1400,6380,1,0,0,4,7,700,700,1924,1924,98125,47.702,122.32,1690,5800,91,0,5,3090,7200
1.68e+06,2014,244,4,3.75,4490,34982,2,0,0,3,12,4490,0,1998,1998,98005,47.641,122.16,4470,37525,16,0,7.75,8960,42015
4.755e+05,2014,273,3,1,1500,9416,1,0,0,4,8,1500,0,1952,1952,98133,47.714,122.33,1440,7200,62,0,4,2940,8700
8.8e+05,2014,190,6,2.5,2640,3680,2,0,0,5,8,1760,880,1922,1922,98126,47.577,122.38,1960,3680,92,0,8.5,4600,6320
1.052e+06,2015,477,3,2.25,2880,6092,2,0,4,4,8,1920,960,1983,1983,98116,47.588,122.38,2880,5308,32,0,5.25,5760,8188
1.33e+06,2015,457,4,3.5,3440,9776,2,0,0,3,10,3440,0,2006,2006,98040,47.537,122.22,2400,11000,9,0,7.5,5840,14440
3.5e+05,2014,285,4,1.75,2420,8400,1,0,0,5,7,1620,800,1964,1964,98056,47.502,122.17,1660,8400,50,0,5.75,4080,10820
2.18e+05,2015,392,2,1.5,2010,7755,2,0,0,3,7,2010,0,1952,1952,98178,47.495,122.23,1360,8037,63,0,3.5,3370,10047
1.265e+06,2014,251,4,3.25,3640,3604,2,0,2,5,9,1960,1680,1913,1913,98122,47.614,122.28,1940,4600,101,0,7.25,5580,8240
2.329e+05,2014,332,3,1.5,910,5120,1,0,0,3,6,910,0,1973,1973,98106,47.524,122.36,1410,5132,41,0,4.5,2320,6042
4.265e+05,2014,190,4,2.5,2700,6515,2,0,0,3,9,2700,0,1998,1998,98058,47.436,122.11,2900,6710,16,0,6.5,5600,9410
2.219e+05,2014,285,2,1,780,6727,1,0,0,3,6,780,0,1939,1939,98168,47.473,122.28,1860,10124,75,0,3,2640,10904
4.395e+05,2015,473,3,2.5,1600,6510,1,0,0,3,7,940,660,1983,1983,98155,47.768,122.31,1600,10507,32,0,5.5,3200,12107
3.23e+05,2015,414,3,1.75,1950,15037,1,0,0,3,7,1950,0,1989,1989,98014,47.689,121.91,1760,15181,26,0,4.75,3710,17131
2e+05,2014,248,3,1,1010,8108,1,0,0,3,7,1010,0,1955,1955,98155,47.735,122.31,1110,8108,59,0,4,2120,9118
5.6175e+05,2014,286,5,1.75,2040,8996,1,0,2,4,7,1020,1020,1962,1962,98008,47.588,122.12,1950,8270,52,0,6.75,3990,10310
4.139e+05,2014,262,4,2.25,1770,5236,2,0,0,3,7,1770,0,2007,2007,98056,47.514,122.19,2470,5064,7,0,6.25,4240,6834
3.21e+05,2015,474,5,2.75,3030,7000,1,0,0,4,7,1540,1490,1978,1978,98032,47.366,122.28,1790,7330,37,0,7.75,4820,10360
1.05e+06,2015,400,4,2.5,3250,48037,1,0,2,3,8,2030,1220,1985,1985,98074,47.633,122.07,2970,48037,30,0,6.5,6220,51287
9.6e+05,2014,293,4,2.5,3430,43560,1,0,2,5,10,3430,0,1979,1979,98005,47.643,122.18,3700,44431,35,0,6.5,7130,47861
6.4995e+05,2015,439,6,2,1900,8240,1,0,0,2,7,1200,700,1964,1964,98125,47.704,122.3,1900,8240,51,0,8,3800,10140
5.85e+05,2014,142,4,1.75,3000,42200,1,0,3,3,7,1500,1500,1950,1950,98056,47.526,122.2,2500,9821,64,0,5.75,5500,12821
2.78e+05,2014,307,4,2.5,1940,6887,2,0,0,3,7,1940,0,1990,1990,98023,47.291,122.35,1870,6144,24,0,6.5,3810,8084
85000,2015,425,2,1,910,9753,1,0,0,3,5,910,0,1947,1947,98032,47.39,122.24,1160,7405,68,0,3,2070,8315
2.5995e+05,2014,196,3,2.5,1578,7340,2,0,0,3,7,1578,0,2010,2010,98030,47.377,122.19,1850,7200,4,0,5.5,3428,8778
4.99e+05,2014,301,3,2.5,1861,1587,2,0,0,3,8,1578,283,2007,2007,98034,47.704,122.21,2090,10454,7,0,5.5,3951,12315
3.5e+05,2014,136,1,1,700,5100,1,0,0,3,7,700,0,1942,1942,98115,47.679,122.3,1010,5100,72,0,2,1710,5800
4.25e+05,2015,453,3,2.5,1230,23522,1,0,0,4,7,1230,0,1978,1978,98059,47.515,122.16,2340,23522,37,0,5.5,3570,24752
4.49e+05,2014,173,4,2.5,1850,5040,1,0,0,3,7,1230,620,1930,2013,98126,47.539,122.37,1010,5040,84,1,6.5,2860,6890
5.24e+05,2014,320,3,2.25,2140,6720,1,0,0,3,8,1440,700,1961,1961,98117,47.695,122.4,2060,6720,53,0,5.25,4200,8860
6.39e+05,2014,190,4,2,1840,5419,1,0,0,4,7,920,920,1942,1942,98199,47.648,122.4,1800,5419,72,0,6,3640,7259
4.4e+05,2014,209,3,2.25,1880,7989,1,0,0,3,7,1280,600,1982,1982,98125,47.708,122.3,1820,7414,32,0,5.25,3700,9294
4.25e+05,2014,218,2,1,970,2700,1,0,0,4,7,770,200,1926,1926,98115,47.685,122.31,1570,3348,88,0,3,2540,4318
1.2e+06,2015,408,4,2.25,2860,10702,2,0,0,3,10,2860,0,1982,1982,98004,47.645,122.19,2890,10572,33,0,6.25,5750,13432
3.495e+05,2014,235,3,1.75,1260,7128,1,0,0,4,7,1260,0,1969,1969,98034,47.726,122.2,1330,7326,45,0,4.75,2590,8586
5.5e+05,2014,284,3,2.75,2330,4780,2,0,3,3,8,1730,600,1930,1988,98198,47.346,122.33,1100,5336,84,1,5.75,3430,7666
7.2579e+05,2014,339,4,2.5,3070,5762,2,0,0,3,10,3070,0,2000,2000,98075,47.585,122.08,3630,6500,14,0,6.5,6700,9570
3.71e+05,2015,491,3,1.75,1970,9512,1,0,0,3,8,1970,0,1968,1968,98058,47.455,122.15,2250,10573,47,0,4.75,4220,12543
2.6675e+05,2014,244,3,2.25,1650,10000,2,0,0,3,7,1650,0,1988,1988,98198,47.386,122.31,1420,10000,26,0,5.25,3070,11650
2.0995e+05,2014,298,3,1.75,1100,5525,1,0,0,5,6,1100,0,1968,1968,98042,47.362,122.08,1050,5200,46,0,4.75,2150,6300
2.36e+05,2015,437,3,1.75,1090,7647,1,0,0,3,7,1090,0,1994,1994,98003,47.261,122.3,1660,9219,21,0,4.75,2750,10309
4.53e+05,2015,425,3,1.75,1600,7232,1,0,0,3,8,1600,0,1966,1966,98008,47.629,122.12,1970,8120,49,0,4.75,3570,9720
7.2e+05,2015,462,3,2.5,2820,14250,2,0,0,3,11,2820,0,1991,1991,98074,47.64,122.05,2820,12600,24,0,5.5,5640,15420
4.5e+05,2015,430,4,2.75,2980,13260,1,0,0,4,8,1800,1180,1979,1979,98056,47.515,122.2,1920,10731,36,0,6.75,4900,13711
6.8995e+05,2014,221,4,2.75,2520,8433,2,0,0,3,8,2520,0,2014,2014,98125,47.721,122.29,1890,7772,0,0,6.75,4410,10292
5.462e+05,2015,451,4,2.25,2090,8579,2,0,0,3,8,2090,0,1987,1987,98074,47.636,122.03,1850,8843,28,0,6.25,3940,10933
3.65e+05,2014,197,4,3.5,2720,6781,2,0,0,3,8,2100,620,1999,1999,98055,47.461,122.22,2280,5942,15,0,7.5,5000,8662
5.3995e+05,2014,228,5,3,3100,5250,2,0,0,3,7,3100,0,2006,2006,98065,47.537,121.89,2460,5250,8,0,8,5560,8350
3.75e+05,2015,484,2,1,790,5120,1,0,0,3,6,790,0,1950,1950,98136,47.557,122.39,1250,5120,65,0,3,2040,5910
2.75e+05,2014,297,3,3,1590,7750,1,0,0,3,7,1060,530,1997,1997,98038,47.362,122.05,1680,7500,17,0,6,3270,9090
3.1999e+05,2014,284,3,2.25,1840,7326,1,0,0,5,7,1370,470,1979,1979,98031,47.396,122.17,2050,7475,35,0,5.25,3890,9315
3.35e+05,2014,204,3,3,2031,7702,2,0,0,3,9,2031,0,1988,1988,98023,47.306,122.35,2390,7700,26,0,6,4421,9731
2.25e+05,2014,284,3,2.25,1650,7739,1,0,0,3,8,1290,360,1986,1986,98003,47.353,122.3,1650,6033,28,0,5.25,3300,7683
8.44e+05,2014,225,4,3.25,3090,67518,2,0,0,3,10,3090,0,1988,1988,98053,47.667,122.05,3200,65775,26,0,7.25,6290,68865
3.95e+05,2014,155,4,3,1980,7931,1,0,0,4,7,1160,820,1983,1983,98133,47.751,122.33,1910,7931,31,0,7,3890,9911
7.25e+05,2015,460,4,3.25,2610,2552,2,0,0,3,10,2160,450,2008,2008,98027,47.532,122.08,2610,2664,7,0,7.25,5220,5274
4.55e+05,2015,484,2,1,1140,11480,1,0,0,3,6,1140,0,1907,1907,98118,47.533,122.27,1550,8150,108,0,3,2690,9290
2.9988e+05,2014,189,3,2.5,1460,3044,2,0,0,3,7,1460,0,2000,2000,98108,47.544,122.3,1490,3044,14,0,5.5,2950,4504
5.13e+05,2015,473,4,2.5,2660,8887,1,0,0,4,8,1880,780,1967,1967,98166,47.439,122.34,1910,9620,48,0,6.5,4570,12280
2.45e+05,2014,188,4,2.25,2600,6390,1,0,0,3,8,1390,1210,1978,1978,98023,47.317,122.37,2110,6700,36,0,6.25,4710,9300
3.75e+05,2014,168,3,2.5,1950,6871,2,0,0,3,8,1950,0,1997,1997,98155,47.76,122.31,1950,7663,17,0,5.5,3900,9613
4.5e+05,2015,438,3,2.5,3800,13071,2,0,0,3,10,2730,1070,1994,1994,98023,47.308,122.4,2980,11110,21,0,5.5,6780,14910
4e+05,2014,283,4,1,1420,4875,1,0,0,3,7,1420,0,1930,1930,98115,47.694,122.32,1110,5413,84,0,5,2530,6833
8.9e+05,2014,163,4,2.25,2770,13500,2,0,0,3,8,2770,0,1974,1974,98040,47.543,122.23,2300,13500,40,0,6.25,5070,16270
5.95e+05,2014,229,2,1.5,870,4800,1,0,0,3,7,870,0,1924,1924,98119,47.651,122.37,2090,4800,90,0,3.5,2960,5670
2.537e+06,2015,450,4,3,3710,20000,2,0,2,5,10,2760,950,1936,1936,98105,47.67,122.26,3970,20000,79,0,7,7680,23710
3.5e+05,2015,390,2,1,840,5551,1,0,0,3,6,840,0,1952,1952,98118,47.535,122.28,1270,4652,63,0,3,2110,5492
3.2e+05,2014,246,2,1.5,1110,1200,3,0,0,3,8,1110,0,2000,2000,98103,47.693,122.34,1110,1363,14,0,3.5,2220,2473
2.9e+05,2014,291,2,1,770,4800,1,0,0,3,7,770,0,1943,1943,98136,47.527,122.38,1390,4800,71,0,3,2160,5570
2.6e+05,2014,150,3,1.75,1050,5850,1,0,0,3,7,1050,0,1980,1980,98166,47.457,122.36,1220,8880,34,0,4.75,2270,9930
2.225e+06,2015,424,3,4,4200,30120,2,0,2,4,11,3600,600,1933,1933,98112,47.638,122.31,2760,12200,82,0,7,6960,16400
7.79e+05,2014,239,6,2.5,3250,12000,1,0,1,3,8,1800,1450,1966,1966,98115,47.694,122.28,3490,10320,48,0,8.5,6740,13570
6.69e+05,2014,167,4,2.75,2700,35362,2,0,0,5,8,2700,0,1976,1976,98077,47.763,122.09,2810,35915,38,0,6.75,5510,38615
2.451e+05,2014,148,3,1.75,1300,7958,1,0,0,3,7,1300,0,1996,1996,98092,47.316,122.19,1640,8698,18,0,4.75,2940,9998
4.4e+05,2015,445,2,1.5,1330,15873,1,0,0,3,7,900,430,1984,1984,98074,47.636,122.03,1610,12043,31,0,3.5,2940,13373
3.1095e+05,2014,216,4,2.5,2030,4997,2,0,0,3,8,2030,0,2004,2004,98031,47.393,122.18,2095,5500,10,0,6.5,4125,7530
5.19e+05,2014,169,3,2.75,2020,10744,1,0,0,5,7,1270,750,1954,1954,98166,47.44,122.34,2020,11069,60,0,5.75,4040,13089
6.96e+05,2014,345,6,3.25,2900,6400,2,0,0,4,8,2300,600,1977,1977,98199,47.646,122.4,2480,6400,37,0,9.25,5380,9300
1.3e+06,2014,170,5,4,3366,7800,2,0,2,3,8,2966,400,1937,1937,98199,47.647,122.39,2340,6000,77,0,9,5706,9366
4.35e+05,2015,417,2,1,990,5643,1,0,0,3,7,870,120,1947,1947,98115,47.68,122.3,1280,5700,68,0,3,2270,6690
3.25e+05,2014,129,4,1.5,1470,70800,1,0,0,3,7,1470,0,1976,1976,98010,47.346,121.95,1810,72337,38,0,5.5,3280,73807
2.57e+05,2015,393,2,1,770,11084,1,0,0,4,6,770,0,1947,1947,98155,47.748,122.32,1010,11084,68,0,3,1780,11854
8.05e+05,2015,451,3,1.75,1080,3200,1,0,0,4,7,880,200,1926,1926,98103,47.65,122.34,1780,5200,89,0,4.75,2860,6280
3.07e+05,2015,434,3,1,1020,8484,1,0,0,3,6,1020,0,1949,1949,98155,47.772,122.31,1180,9660,66,0,4,2200,10680
2.7e+05,2015,464,3,2.5,1720,8550,1,0,0,4,7,1720,0,1968,1968,98002,47.284,122.21,1460,8550,47,0,5.5,3180,10270
4.425e+05,2015,444,4,2.25,2490,8700,1,0,0,3,7,1890,600,1976,1976,98155,47.74,122.32,1470,7975,39,0,6.25,3960,10465
4.4995e+05,2014,201,4,2.5,3100,10000,2,0,0,3,9,3100,0,1978,1978,98042,47.374,122.15,1850,9438,36,0,6.5,4950,12538
4.35e+05,2015,409,5,1.5,1720,12551,1,0,0,3,7,1720,0,1967,1967,98027,47.524,122.05,1560,12960,48,0,6.5,3280,14680
3.2e+05,2014,229,4,2.5,2050,8424,2,0,0,4,8,2050,0,1993,1993,98022,47.196,122.01,1970,8448,21,0,6.5,4020,10498
8.1e+05,2014,205,3,2.5,3140,10983,2,0,0,3,10,3140,0,1991,1991,98075,47.559,122.04,3140,10983,23,0,5.5,6280,14123
7.605e+05,2015,415,4,2.25,2310,36136,2,0,0,4,9,2310,0,1977,1977,98072,47.751,122.12,3930,36136,38,0,6.25,6240,38446
3.1e+05,2015,457,2,1,750,5379,1,0,0,3,6,750,0,1919,1919,98118,47.532,122.27,1030,5511,96,0,3,1780,6261
5.75e+05,2014,356,4,1.5,1430,4163,1,0,0,3,7,1430,0,1910,1910,98199,47.661,122.4,1500,4000,104,0,5.5,2930,5430
2.15e+05,2014,222,2,1,1010,6000,1,0,0,4,6,1010,0,1944,1944,98133,47.771,122.35,1610,7313,70,0,3,2620,8323
3.475e+05,2015,463,3,1,1830,12036,1,0,0,3,7,1550,280,1977,1977,98042,47.313,122.04,1810,12036,38,0,4,3640,13866
2.8e+05,2015,432,3,2,1020,889,2,0,0,3,7,720,300,2009,2009,98126,47.543,122.38,1130,972,6,0,5,2150,1992
5.15e+05,2014,236,4,2.5,2890,15067,2,0,0,3,9,2890,0,2003,2003,98024,47.567,121.91,3090,15398,11,0,6.5,5980,18288
7.5e+05,2015,387,5,1.75,2640,13290,1,1,4,4,8,1400,1240,1954,1954,98178,47.502,122.22,2400,11942,61,0,6.75,5040,14582
4.5e+05,2014,271,3,2.5,2530,8116,2,0,0,3,8,2530,0,2001,2001,98011,47.76,122.17,2280,8791,13,0,5.5,4810,11321
5.05e+05,2014,314,3,1,1100,5400,1,0,0,3,7,1100,0,1908,1908,98199,47.66,122.4,1770,4400,106,0,4,2870,5500
2e+05,2015,452,4,1,1020,42966,1,0,0,4,6,1020,0,1922,1922,98072,47.762,122.11,2250,37680,93,0,5,3270,38700
4.425e+05,2014,208,6,2.5,2800,10490,1,0,0,3,7,1400,1400,1968,1968,98177,47.773,122.38,2290,8716,46,0,8.5,5090,11516
5.4995e+05,2014,313,3,2.5,2380,2500,3,0,3,3,9,2380,0,1988,1988,98126,47.573,122.38,2270,5000,26,0,5.5,4650,7380
3.3995e+05,2015,457,3,1.75,1330,12092,1,0,0,4,6,720,610,1981,1981,98168,47.51,122.32,1770,11770,34,0,4.75,3100,13100
6.65e+05,2015,390,6,3,2480,9720,2,0,0,3,8,2480,0,1972,1972,98007,47.613,122.14,2480,9200,43,0,9,4960,11680
1.59e+06,2015,376,4,2.25,3240,11131,1,0,0,4,9,2080,1160,1953,1953,98004,47.618,122.22,2300,12150,62,0,6.25,5540,15390
5.0845e+05,2014,245,4,1.75,1520,9600,1,0,0,4,7,1000,520,1955,1955,98006,47.576,122.15,1510,9000,59,0,5.75,3030,10520
3.89e+05,2014,283,2,1,850,3276,1,0,0,3,6,850,0,1910,1910,98103,47.674,122.35,1460,4100,104,0,3,2310,4950
5.75e+05,2014,264,3,2,2168,4000,1,0,0,3,8,2168,0,1907,1907,98105,47.656,122.33,1770,4000,107,0,5,3938,6168
4.2e+05,2014,127,2,1.5,1040,3500,1,0,0,4,6,1040,0,1904,1904,98144,47.588,122.3,1340,1213,110,0,3.5,2380,2253
6.93e+05,2014,239,4,2.5,2460,4425,2,0,0,3,8,2460,0,2006,2006,98052,47.705,122.11,2990,5659,8,0,6.5,5450,8119
6.09e+05,2014,183,3,1.75,1630,1526,3,0,0,3,8,1630,0,2014,2014,98103,47.654,122.35,1570,1274,0,0,4.75,3200,2904
9.375e+05,2015,365,5,3.75,4210,14599,2,0,3,3,10,4210,0,2004,2004,98065,47.536,121.86,3950,13591,11,0,8.75,8160,17801
4.5e+05,2015,460,2,2,1610,6160,2,0,0,4,8,1610,0,1977,1977,98052,47.664,122.13,1750,6305,38,0,4,3360,7915
4.29e+05,2014,211,4,2.5,2100,7920,1,0,0,4,6,1400,700,1916,1916,98126,47.529,122.37,1230,7920,98,0,6.5,3330,10020
5.75e+05,2014,194,4,2.25,2070,1230,3,0,0,3,9,1500,570,2013,2013,98116,47.578,122.41,1569,4802,1,0,6.25,3639,6872
2.685e+05,2014,210,4,1.75,1820,13600,1,0,0,3,7,1120,700,1959,1959,98032,47.374,122.3,1810,11970,55,0,5.75,3630,13790
3.05e+05,2014,149,2,2.25,1000,905,3,0,0,3,8,1000,0,2006,2006,98117,47.684,122.39,980,1023,8,0,4.25,1980,2023
6.55e+05,2015,479,1,1,1660,5422,1,0,0,4,7,830,830,1908,1908,98117,47.682,122.39,1100,5356,107,0,2,2760,7016
1.22e+05,2015,426,2,1,740,6840,1,0,0,3,6,740,0,1942,1942,98126,47.517,122.37,740,6840,73,0,3,1480,7580
8.0295e+05,2015,459,5,3.5,4000,9234,2,0,0,3,9,4000,0,2015,2015,98024,47.526,121.89,3690,6600,0,0,8.5,7690,10600
3.35e+05,2015,478,2,1,1410,7000,1,0,0,3,7,1410,0,1968,1968,98055,47.491,122.22,1540,6000,47,0,3,2950,7410
4.45e+05,2014,251,5,3,2930,5500,1,0,0,3,7,1750,1180,1951,1951,98118,47.557,122.28,1400,5500,63,0,8,4330,8430
3.75e+05,2014,147,3,1.5,2000,7294,1,0,0,3,7,1520,480,1965,1965,98118,47.53,122.27,2000,6000,49,0,4.5,4000,8000
2.52e+05,2014,319,3,2,1540,7210,2,0,0,4,7,1540,0,1984,1984,98023,47.313,122.35,1500,7210,30,0,5,3040,8750
3.42e+05,2014,152,2,2.5,1175,1366,2,0,0,3,8,740,435,2005,2005,98103,47.696,122.34,1710,1255,9,0,4.5,2885,2430
3.9e+05,2014,264,4,3,2860,5724,1,0,0,3,7,1730,1130,1983,1983,98108,47.543,122.3,2340,7200,31,0,7,5200,10060
2.5175e+05,2014,160,3,2,1320,7200,1,0,0,5,7,1320,0,1975,1975,98031,47.395,122.17,1540,7200,39,0,5,2860,8520
1.0965e+06,2014,311,5,3.25,4010,12110,2,0,0,3,11,4010,0,2003,2003,98059,47.523,122.15,4010,12334,11,0,8.25,8020,16344
6.898e+05,2015,457,2,1.75,1370,3125,1,0,0,3,7,1090,280,1950,1950,98199,47.649,122.39,1730,5966,65,0,3.75,3100,7336
1.045e+06,2014,351,4,3,2790,3600,2,0,0,3,8,1880,910,1905,2013,98119,47.636,122.36,1360,3600,109,1,7,4150,6390
6.6e+05,2014,166,6,1.75,1840,2774,1,0,0,3,7,1060,780,1900,1900,98122,47.604,122.31,1680,4292,114,0,7.75,3520,6132
3.19e+05,2014,265,3,1,960,8556,1,0,0,3,7,960,0,1971,1971,98034,47.724,122.22,1320,7528,43,0,4,2280,8488
1.05e+06,2014,349,3,2,2090,4077,1,0,0,4,8,1530,560,1931,1931,98112,47.643,122.3,2010,4132,83,0,5,4100,6222
2.805e+05,2015,472,4,2.75,2660,7754,1,0,0,3,8,1590,1070,1986,1986,98023,47.308,122.34,2250,7754,29,0,6.75,4910,10414
7.7489e+05,2014,280,3,2.25,2420,23507,1,0,0,4,8,2420,0,1969,1969,98027,47.511,122.03,2540,22257,45,0,5.25,4960,24677
4.055e+05,2014,195,3,1.5,1010,8108,1,0,0,5,7,1010,0,1954,1954,98155,47.736,122.31,1300,8108,60,0,4.5,2310,9118
1.78e+06,2015,479,4,3.25,3950,10912,2,0,0,3,10,3950,0,2003,2003,98004,47.588,122.2,3000,10998,12,0,7.25,6950,14948
4.5e+05,2014,133,3,2.75,1250,892,2,0,0,3,8,1040,210,2010,2010,98116,47.583,122.39,1250,1296,4,0,5.75,2500,2546
1.05e+06,2014,143,3,4,4380,42769,2,0,0,5,11,4380,0,1983,1983,98052,47.717,122.11,3630,35425,31,0,7,8010,39805
5.8e+05,2014,230,3,2.5,1590,1937,2,0,0,3,8,1590,0,2004,2004,98116,47.59,122.39,1620,2022,10,0,5.5,3210,3612
5.875e+05,2015,416,4,1.75,2500,20868,1,0,2,3,8,1600,900,1956,1956,98166,47.431,122.34,2170,15026,59,0,5.75,4670,17526
4.75e+05,2015,408,3,2.5,1920,4534,2,0,0,3,8,1920,0,1986,1986,98034,47.714,122.2,1380,5100,29,0,5.5,3300,7020
4.72e+05,2014,297,5,2,2030,9804,1,0,0,3,7,1110,920,1963,1963,98008,47.63,122.11,1930,7990,51,0,7,3960,10020
5.389e+05,2014,221,5,3,3040,6604,2,0,0,3,9,3040,0,2005,2005,98106,47.548,122.36,1650,6825,9,0,8,4690,9865
2.69e+05,2015,414,3,1.75,1530,7930,1,0,0,5,7,1530,0,1986,1986,98038,47.361,122.05,1610,7930,29,0,4.75,3140,9460
6.25e+05,2014,210,3,1.75,1600,9135,1,0,0,5,7,1600,0,1955,1955,98006,47.572,122.18,1580,9800,59,0,4.75,3180,11400
9.25e+05,2014,174,4,3,3580,35261,1,0,0,3,10,3580,0,1985,1985,98072,47.758,122.13,3540,36750,29,0,7,7120,40330
5e+05,2014,266,4,2.25,2270,8196,1,0,0,5,7,1150,1120,1963,1963,98034,47.721,122.23,1920,10122,51,0,6.25,4190,12392
3.34e+05,2015,403,1,1,670,5750,1,0,0,3,7,670,0,1942,2011,98116,47.562,122.39,1170,5750,73,1,2,1840,6420
7.69e+05,2015,479,4,2.5,2440,6733,2,0,0,3,9,2440,0,1999,1999,98074,47.637,122.06,2570,6496,16,0,6.5,5010,8936
4.22e+05,2015,464,4,2.5,2930,5973,2,0,0,3,10,2930,0,2008,2008,98030,47.385,122.19,3038,7095,7,0,6.5,5968,10025
3.35e+05,2014,262,4,2.5,2240,9701,2,0,0,3,9,2240,0,1989,1989,98023,47.309,122.39,2240,9410,25,0,6.5,4480,11650
6.15e+05,2014,260,2,1.5,1210,5000,1,0,0,5,6,1210,0,1907,1907,98117,47.679,122.4,1570,5000,107,0,3.5,2780,6210
3.25e+05,2015,402,2,1,1120,6236,1,0,0,4,6,1120,0,1954,1954,98155,47.763,122.29,1340,7784,61,0,3,2460,8904
3.14e+05,2015,373,3,2.75,1900,8200,2,0,0,4,7,1900,0,1984,1984,98031,47.402,122.18,1620,8200,31,0,5.75,3520,10100
3e+05,2015,401,4,2.25,1660,3200,2,0,0,3,7,1660,0,2011,2011,98038,47.367,122.02,1960,3558,4,0,6.25,3620,5218
6.215e+05,2015,387,5,2.5,2140,15950,1,0,2,4,8,1370,770,1968,1968,98166,47.48,122.36,2600,14273,47,0,7.5,4740,16413
4.8e+05,2014,162,3,2.5,1250,1103,3,0,2,3,8,1250,0,2005,2005,98103,47.662,122.35,1250,1188,9,0,5.5,2500,2438
5.85e+05,2015,463,3,1.5,2230,6000,1,0,1,3,8,1260,970,1968,1968,98136,47.537,122.39,2120,7200,47,0,4.5,4350,9430
4.69e+05,2014,326,3,2.25,2620,10659,1,0,0,3,7,1660,960,1976,1976,98155,47.764,122.27,1820,12071,38,0,5.25,4440,14691
2.15e+05,2014,319,3,1,1690,7700,1,0,0,4,7,1690,0,1969,1969,98003,47.344,122.3,1590,7700,45,0,4,3280,9390
4.885e+05,2015,479,3,2,1710,10959,1,0,0,4,7,1030,680,1981,1981,98033,47.697,122.2,1710,10498,34,0,5,3420,12208
5.475e+05,2015,451,3,3.25,1720,1977,2,0,0,3,8,1360,360,2007,2007,98122,47.613,122.3,1720,3420,8,0,6.25,3440,5140
4.7e+05,2014,299,4,2.5,2520,9684,2,0,0,3,8,2520,0,1994,1994,98045,47.485,121.8,2090,10133,20,0,6.5,4610,12653
4.2495e+05,2015,394,4,2.5,2480,8563,2,0,0,3,8,2480,0,1992,1992,98038,47.381,122.03,2460,8660,23,0,6.5,4940,11140
9.425e+05,2014,294,4,3.25,3570,14408,2,0,2,3,10,3570,0,2006,2006,98065,47.536,121.86,4100,14577,8,0,7.25,7670,18147
3.725e+05,2015,440,3,1.75,1680,8648,1,0,0,4,7,1680,0,1963,1963,98133,47.734,122.33,1290,8147,52,0,4.75,2970,9827
7.38e+05,2014,299,4,2.5,2830,5010,2,0,0,3,9,2170,660,2000,2000,98115,47.695,122.33,1880,5739,14,0,6.5,4710,8569
1.1375e+06,2015,467,4,3.5,3160,4200,2,0,4,3,8,2180,980,1999,1999,98144,47.596,122.29,2180,5200,16,0,7.5,5340,8360
3.95e+05,2014,259,4,1.75,2060,7900,1,0,0,4,7,1070,990,1957,1957,98008,47.603,122.12,1830,8000,57,0,5.75,3890,10060
3.365e+05,2014,347,3,2,1830,12891,1,0,0,3,7,1830,0,1994,1994,98031,47.392,122.19,2320,8709,20,0,5,4150,10539
1.835e+05,2014,188,3,1,1040,8892,1,0,0,4,6,800,240,1958,1958,98023,47.327,122.35,820,9000,56,0,4,1860,10040
8.75e+05,2014,230,3,2,2010,4000,1,0,0,5,7,1210,800,1915,1915,98103,47.664,122.33,1770,4000,99,0,5,3780,6010
3.15e+05,2015,458,4,2.5,1970,5190,2,0,0,3,7,1970,0,2002,2002,98059,47.515,122.16,1840,5564,13,0,6.5,3810,7534
5.5e+05,2014,312,3,1.75,1840,9401,1,0,0,3,8,1840,0,1971,1971,98075,47.585,122.08,2850,14323,43,0,4.75,4690,16163
1.0785e+06,2014,306,4,3.5,3740,41458,2,0,2,3,11,3740,0,2000,2000,98072,47.737,122.14,3750,38325,14,0,7.5,7490,42065
3.1e+05,2015,486,7,1.5,2660,15111,1,0,0,4,7,2660,0,1962,1962,98059,47.464,122.07,1710,15429,53,0,8.5,4370,18089
3.02e+05,2014,305,3,1,1600,1950,2,0,0,2,7,1600,0,1906,1906,98122,47.603,122.31,1310,1138,108,0,4,2910,2738
5.77e+05,2014,266,5,2.75,1940,5000,2,0,0,5,7,1940,0,1951,1951,98107,47.67,122.36,1940,4230,63,0,7.75,3880,6170
2.55e+05,2015,447,3,1.75,1590,7810,1,0,0,4,7,1590,0,1959,1959,98002,47.293,122.22,1470,7810,56,0,4.75,3060,9400
4.08e+05,2014,258,3,1,1380,7015,1,0,0,4,7,1380,0,1925,1925,98117,47.699,122.36,1160,6700,89,0,4,2540,8080
4.1e+05,2014,229,3,2.5,1509,1418,3,0,0,3,8,1509,0,2014,2014,98133,47.705,122.34,1509,1991,0,0,5.5,3018,3500
2.925e+05,2015,369,3,2.25,1690,7320,2,0,0,3,7,1690,0,1987,1987,98198,47.389,122.32,1520,7450,28,0,5.25,3210,9140
1.11e+06,2015,415,4,2.75,3090,6600,1,0,2,3,9,1800,1290,1956,1956,98199,47.634,122.4,2380,5000,59,0,6.75,5470,8090
5.8e+05,2015,478,3,2.75,2660,32757,1,0,0,4,8,2660,0,1975,1975,98077,47.765,122.1,2720,35191,40,0,5.75,5380,37851
3.5495e+05,2014,232,3,1.75,1780,9689,1,0,0,3,7,1130,650,1976,1976,98072,47.763,122.16,1660,9786,38,0,4.75,3440,11566
6.95e+05,2014,283,4,2.5,2790,6540,2,0,0,3,9,2790,0,1999,1999,98074,47.609,122.02,2790,6270,15,0,6.5,5580,9060
3.6e+05,2014,141,3,2.5,1530,1131,3,0,0,3,8,1530,0,2009,2009,98103,47.699,122.35,1530,1509,5,0,5.5,3060,3039
1.4e+05,2015,417,3,1,1240,8000,1,0,0,4,6,1040,200,1954,1954,98198,47.42,122.32,1240,8000,61,0,4,2480,9240
1.3e+06,2015,457,3,2.75,4120,16365,1,0,2,3,12,4120,0,1999,1999,98059,47.526,122.15,4020,14110,16,0,5.75,8140,18230
4.35e+05,2014,182,3,2.5,1900,7984,2,0,0,3,8,1900,0,1993,1993,98011,47.743,122.19,2650,9352,21,0,5.5,4550,11252
3.6e+05,2014,266,2,1.75,1230,1107,2,0,0,3,8,1230,0,2006,2006,98029,47.547,122,1380,1107,8,0,3.75,2610,2337
7.05e+05,2014,332,2,2.5,2300,6400,1,0,0,3,8,2300,0,2007,2007,98053,47.72,122.02,2300,6400,7,0,4.5,4600,8700
3.35e+05,2014,314,3,2.5,1090,1139,2,0,0,3,8,960,130,2009,2009,98126,47.566,122.37,1400,1348,5,0,5.5,2490,2438
3.8999e+05,2014,259,4,2.5,2245,4330,2,0,0,3,8,2245,0,2014,2014,98038,47.356,122.06,2530,4478,0,0,6.5,4775,6723
1.5495e+05,2014,189,4,1,1600,10183,1,0,0,4,6,1600,0,1966,1966,98002,47.277,122.21,1410,10416,48,0,5,3010,12016
7.575e+05,2015,374,5,2.25,3160,8065,2,0,0,3,8,3160,0,1977,1977,98027,47.568,122.09,2540,7917,38,0,7.25,5700,11077
7.51e+05,2015,446,3,2.5,2840,6854,2,0,0,3,9,2840,0,2002,2002,98075,47.601,121.98,2840,7398,13,0,5.5,5680,10238
2.065e+06,2014,180,4,3.75,4350,7965,2,0,0,3,10,4350,0,2013,2013,98004,47.629,122.2,2190,8557,1,0,7.75,6540,12907
3.05e+05,2014,148,3,1,1160,11776,1,0,0,3,7,1160,0,1968,1968,98077,47.743,122.07,1160,10050,46,0,4,2320,11210
3.75e+05,2015,460,3,1.75,1590,14766,1,0,0,3,8,1590,0,1963,1963,98007,47.59,122.15,2040,10190,52,0,4.75,3630,11780
2.335e+05,2014,173,3,2.25,1650,2958,2,0,0,3,7,1650,0,1985,1985,98031,47.392,122.17,1510,3788,29,0,5.25,3160,5438
3.5e+05,2015,480,3,1.5,1090,5003,1,0,0,3,7,1090,0,1962,1962,98125,47.703,122.32,1540,5279,53,0,4.5,2630,6369
6.1e+05,2014,190,4,2.75,2600,36583,1,0,0,5,8,1580,1020,1976,1976,98075,47.593,122.05,2300,27820,38,0,6.75,4900,30420
6.1e+05,2015,394,3,1,1800,5750,1,0,0,3,7,1040,760,1947,1947,98117,47.686,122.39,1320,5625,68,0,4,3120,7425
4.26e+05,2014,229,3,1,1130,9147,1,0,0,5,7,1130,0,1952,1952,98033,47.701,122.2,1930,9906,62,0,4,3060,11036
4.55e+05,2015,446,4,1.5,1880,11400,1,0,0,3,7,1280,600,1955,1955,98177,47.772,122.38,1880,11400,60,0,5.5,3760,13280
3.8315e+05,2015,403,3,2,2210,6387,1,0,0,3,8,2210,0,2003,2003,98003,47.265,122.3,2570,6497,12,0,5,4780,8707
4.35e+05,2014,180,4,2,1880,3840,1,0,0,3,7,970,910,1904,1904,98144,47.593,122.3,1670,1820,110,0,6,3550,3700
5.5e+05,2014,248,4,3,2360,6678,1,0,0,3,8,1760,600,1949,1949,98115,47.692,122.31,1640,6380,65,0,7,4000,8740
5.4e+05,2014,205,2,1,1120,7500,1,0,2,4,7,1120,0,1971,1971,98008,47.619,122.1,3040,16940,43,0,3,4160,18060
2.38e+05,2014,231,3,1,1470,32670,1,0,0,3,7,1020,450,1958,1958,98042,47.381,122.14,2640,24100,56,0,4,4110,25570
4.35e+05,2015,372,4,2.5,2060,10125,2,0,0,4,7,1560,500,1979,1979,98028,47.764,122.26,1760,9876,36,0,6.5,3820,11936
2.36e+05,2014,148,4,2.25,1830,9485,1,0,0,4,7,1200,630,1989,1989,98023,47.3,122.39,1730,10109,25,0,6.25,3560,11939
3.9e+05,2014,183,4,2,1900,76877,1,0,0,3,8,1900,0,2004,2004,98042,47.349,122.11,1740,34848,10,0,6,3640,36748
5.715e+05,2014,277,4,2.75,2180,5799,2,0,0,4,8,2180,0,1993,1993,98029,47.57,122,2060,6061,21,0,6.75,4240,8241
5e+05,2014,154,5,3,2920,11440,2,0,0,3,8,2920,0,2003,2003,98133,47.761,122.35,1720,9348,11,0,8,4640,12268
8.99e+05,2014,173,3,1,1480,6978,2,0,0,4,8,1480,0,1949,1985,98004,47.65,122.22,2660,13062,65,1,4,4140,14542
3.7e+05,2014,235,4,3,2130,4838,1,0,0,4,7,2130,0,1930,1930,98055,47.487,122.2,1070,4838,84,0,7,3200,6968
5.15e+05,2015,473,4,2.5,1910,8947,1,0,0,4,8,1160,750,1970,1970,98011,47.737,122.18,1920,7350,45,0,6.5,3830,9260
1.22e+06,2015,485,3,3.25,3960,6132,2,0,3,3,10,2600,1360,1933,1933,98199,47.64,122.41,2730,5221,82,0,6.25,6690,9181
1.75e+05,2014,265,2,1,740,3434,1,0,0,5,6,740,0,1920,1920,98022,47.209,121.99,1160,6000,94,0,3,1900,6740
4.3e+05,2014,173,3,1.75,1300,12731,1,0,0,3,8,1300,0,1981,1981,98074,47.624,122.04,1700,13556,33,0,4.75,3000,14856
5e+05,2015,374,4,2.5,1940,7607,2,0,0,3,8,1940,0,1995,1995,98052,47.685,122.16,2250,7600,20,0,6.5,4190,9540
1.83e+05,2015,494,3,1,1170,7320,1,0,0,3,7,1170,0,1962,1962,98188,47.468,122.28,2040,7320,53,0,4,3210,8490
4.18e+05,2015,390,3,1.75,1670,12075,1,0,0,3,7,1370,300,1958,1958,98155,47.768,122.31,1800,12123,57,0,4.75,3470,13793
7.85e+05,2014,136,3,2,2180,5440,1,0,0,5,7,1100,1080,1904,1904,98103,47.657,122.34,1470,4109,110,0,5,3650,6289
5.175e+05,2015,414,3,1.5,1430,5200,1,0,3,4,7,1250,180,1940,1940,98117,47.699,122.39,2210,6240,75,0,4.5,3640,7670
3.785e+05,2014,229,2,1,880,6171,1,0,0,4,7,880,0,1949,1949,98125,47.726,122.28,2260,12769,65,0,3,3140,13649
3.88e+05,2015,368,4,2.5,2560,5800,2,0,0,3,9,2560,0,2005,2005,98038,47.347,122.03,3040,5800,10,0,6.5,5600,8360
4.61e+05,2015,409,3,2.5,1690,3026,2,0,0,3,7,1690,0,2002,2002,98053,47.688,122.04,1650,3161,13,0,5.5,3340,4851
6.98e+05,2014,122,4,2.25,2200,11250,1,0,0,5,7,1300,900,1920,1920,98033,47.684,122.2,2320,10814,94,0,6.25,4520,13014
8.08e+05,2014,251,4,2.25,2190,4104,2,0,0,5,8,1410,780,1928,1928,98112,47.642,122.31,1990,3860,86,0,6.25,4180,6050
4.25e+05,2015,406,2,1.5,830,1241,2,0,0,3,7,830,0,2005,2005,98119,47.636,122.37,1610,2666,10,0,3.5,2440,3496
2.19e+05,2014,256,2,2,1310,2550,2,0,0,3,6,1310,0,2004,2004,98038,47.35,122.02,1310,2550,10,0,4,2620,3860
3.35e+05,2014,194,4,2.5,1830,4500,2,0,0,3,7,1830,0,2004,2004,98038,47.35,122,2080,5100,10,0,6.5,3910,6930
2.08e+05,2015,409,3,1,1050,6240,1,0,0,5,5,1050,0,1948,1948,98146,47.493,122.34,1410,6240,67,0,4,2460,7290
8.25e+05,2014,348,3,3.5,2670,3000,2,0,0,3,9,1870,800,2014,2014,98117,47.681,122.37,1750,5000,0,0,6.5,4420,7670
5.485e+05,2015,453,3,1,1740,4400,1,0,0,3,7,1740,0,1924,1924,98122,47.606,122.3,1720,4400,91,0,4,3460,6140
7.2e+05,2014,258,5,3.5,4140,7642,2,0,0,3,8,4140,0,2003,2003,98075,47.591,122.01,3330,6953,11,0,8.5,7470,11093
4.7e+05,2015,452,2,1.75,1520,4220,1,0,0,4,7,840,680,1910,1910,98117,47.688,122.37,1120,5700,105,0,3.75,2640,7220
7.5e+05,2014,245,5,2.25,3060,13630,2,0,0,3,10,3060,0,1989,1989,98006,47.559,122.12,3430,10700,25,0,7.25,6490,13760
1.6e+06,2015,436,5,3.5,4050,20925,2,0,3,3,10,3020,1030,1973,2005,98040,47.535,122.24,3880,18321,42,1,8.5,7930,22371
3.0195e+05,2014,198,3,1.75,1370,9288,1,0,0,4,7,1370,0,1988,1988,98059,47.482,122.15,1500,9864,26,0,4.75,2870,11234
3.3376e+05,2015,473,3,1,1300,5880,1,0,0,3,7,1300,0,1968,1968,98052,47.694,122.11,1300,7700,47,0,4,2600,9000
1.58e+06,2015,447,4,2.5,2900,10500,1,0,3,5,8,1450,1450,1963,1963,98040,47.584,122.25,2900,9201,52,0,6.5,5800,12101
1.125e+06,2014,341,4,2.5,2520,2600,2,0,0,5,8,1670,850,1925,1925,98119,47.643,122.36,2290,3600,89,0,6.5,4810,6120
2.05e+05,2014,313,3,1,1130,7014,1,0,0,3,7,1130,0,1954,1954,98168,47.474,122.27,1440,9350,60,0,4,2570,10480
1.9e+06,2014,286,4,2.75,4280,12668,2,0,0,3,9,3900,380,1947,2008,98004,47.618,122.22,3590,12670,67,1,6.75,7870,16950
4.4e+05,2014,255,3,2.5,2230,5800,2,0,0,3,7,2230,0,2004,2004,98065,47.531,121.85,2230,6088,10,0,5.5,4460,8318
7.56e+05,2015,401,3,2.5,3560,8297,1,0,2,4,8,1650,1910,1948,1948,98199,47.647,122.41,2760,8297,67,0,5.5,6320,11857
2.095e+05,2015,456,3,1.5,970,5488,1,0,0,3,7,970,0,1976,1976,98106,47.537,122.36,1040,5488,39,0,4.5,2010,6458
7.25e+05,2014,163,5,2.5,3210,12000,1,0,0,4,8,1830,1380,1968,1968,98007,47.62,122.15,2450,12000,46,0,7.5,5660,15210
2.475e+06,2014,167,3,3.25,4340,4947,2,0,3,3,11,3060,1280,1993,1993,98107,47.671,122.41,1680,5250,21,0,6.25,6020,9590
3.94e+05,2014,288,5,3.25,3620,4650,2,0,0,3,8,2790,830,2004,2004,98038,47.355,122.03,2850,4650,10,0,8.25,6470,8270
2.65e+05,2014,303,3,1,800,5760,1,0,0,3,6,700,100,1949,1949,98155,47.751,122.32,1060,6628,65,0,4,1860,7428
4.08e+05,2015,414,3,2.5,2620,8403,2,0,0,3,8,2620,0,1991,1991,98038,47.367,122.04,2190,7842,24,0,5.5,4810,10462
2.56e+05,2014,203,3,1,880,5375,1,0,0,4,5,880,0,1924,1924,98055,47.486,122.2,980,4838,90,0,4,1860,5718
4.8e+05,2014,142,4,2.25,3250,34293,2,0,0,4,9,3250,0,1983,1983,98042,47.35,122.09,3110,35982,31,0,6.25,6360,39232
2.32e+05,2014,335,3,2,1280,13356,1,0,0,3,7,1280,0,1994,1994,98042,47.371,122.07,1590,8071,20,0,5,2870,9351
5.25e+05,2014,258,4,1.75,1650,8560,1,0,0,3,8,1650,0,1970,1970,98052,47.665,122.15,1700,8560,44,0,5.75,3350,10210
3.05e+05,2015,480,2,1,960,8276,1,0,0,3,5,960,0,1939,1939,98027,47.532,122.03,1620,6000,76,0,3,2580,6960
3.031e+05,2014,292,3,1.5,1640,5650,1,0,0,3,8,1640,0,1952,1952,98178,47.509,122.25,1640,5650,62,0,4.5,3280,7290
2.5e+05,2014,346,3,1,1660,7650,1,0,0,3,7,1350,310,1910,1910,98118,47.558,122.28,1750,5760,104,0,4,3410,7420
2.75e+05,2014,286,4,2,1960,30480,1,0,2,4,7,1060,900,1972,1972,98022,47.192,121.99,1460,8914,42,0,6,3420,10874
5.85e+05,2015,479,2,1.75,1280,7110,1,0,0,4,7,1000,280,1955,1955,98118,47.557,122.27,1550,6835,60,0,3.75,2830,8115
4.7e+05,2014,122,5,2.5,2210,9655,1,0,0,3,8,1460,750,1976,1976,98011,47.77,122.22,2080,8633,38,0,7.5,4290,10843
4e+05,2014,297,3,1.5,1330,9900,1,0,0,3,7,1330,0,1956,1956,98034,47.717,122.23,1940,9900,58,0,4.5,3270,11230
7.33e+05,2015,425,4,2.5,2210,5002,1,0,0,3,7,1370,840,1977,1977,98199,47.664,122.4,1970,4920,38,0,6.5,4180,7130
2.49e+05,2014,188,2,1.5,1090,2686,2,0,0,3,7,1090,0,1982,1982,98034,47.717,122.19,1160,2158,32,0,3.5,2250,3248
8.25e+05,2014,303,3,2.25,2520,7975,2,0,0,4,9,1550,970,1990,1990,98033,47.67,122.18,2520,9900,24,0,5.25,5040,12420
6.75e+05,2015,389,5,2,2420,21000,1,0,0,3,8,2420,0,1966,1966,98033,47.677,122.17,1940,8085,49,0,7,4360,10505
4.05e+05,2014,167,3,1.5,1880,7400,1,0,0,3,8,1480,400,1968,1968,98155,47.774,122.27,1820,8660,46,0,4.5,3700,10540
5.7e+05,2014,248,3,1.75,2580,40392,1,0,0,3,9,1390,1190,1986,1986,98072,47.764,122.13,2460,46173,28,0,4.75,5040,48753
3.15e+05,2014,297,3,1.75,1170,4000,1,0,0,3,6,720,450,1943,2013,98106,47.531,122.35,1130,4000,71,1,4.75,2300,5170
4.15e+05,2014,356,5,1.75,3700,9140,1,0,0,3,8,1850,1850,1957,1957,98178,47.509,122.26,2190,6720,57,0,6.75,5890,10420
2.72e+05,2014,258,4,1.75,1390,10660,1,0,0,4,7,1030,360,1960,1960,98198,47.413,122.32,1800,11960,54,0,5.75,3190,13350
7.92e+05,2014,229,4,2.75,3100,10245,2,0,0,3,10,3100,0,1999,1999,98052,47.686,122.11,3140,9028,15,0,6.75,6240,12128
5.525e+05,2015,491,3,2.5,2450,3582,2,0,0,3,9,2450,0,2008,2008,98072,47.775,122.16,2490,5449,7,0,5.5,4940,7899
2.05e+05,2015,492,3,1.5,1420,5000,1,0,0,3,7,920,500,1987,1987,98198,47.419,122.33,1400,7500,28,0,4.5,2820,8920
4.2e+05,2015,437,3,1.5,1540,7506,1,0,0,5,7,1540,0,1961,1961,98155,47.757,122.33,2180,7653,54,0,4.5,3720,9193
5.03e+05,2015,441,3,2,1260,2500,1,0,0,4,7,750,510,1987,1987,98107,47.675,122.37,1710,5000,28,0,5,2970,6260
5.5e+05,2015,471,3,3.75,1580,1303,2,0,0,3,8,1340,240,2010,2010,98144,47.587,122.31,1560,1294,5,0,6.75,3140,2874
4.725e+05,2015,438,4,1.75,1440,8536,1,0,0,4,7,1440,0,1961,1961,98033,47.678,122.18,1720,9748,54,0,5.75,3160,11188
3.27e+05,2015,410,4,2.25,1620,1.0672e+05,1,0,0,3,8,1200,420,1980,1980,98042,47.339,122.09,1620,38400,35,0,6.25,3240,40020
3.1e+05,2014,256,4,1,1030,5750,1,0,0,3,7,1030,0,1971,1971,98126,47.553,122.37,1250,5750,43,0,5,2280,6780
8.872e+05,2015,457,3,1,1400,5100,1,0,0,3,7,1400,0,1900,1900,98103,47.668,122.33,1740,3060,115,0,4,3140,4460
2.315e+05,2014,223,4,2.25,2080,7526,1,0,0,4,7,1280,800,1985,1985,98030,47.376,122.18,1200,7500,29,0,6.25,3280,9580
7e+05,2015,450,3,2.5,2060,10650,1,0,0,5,8,1050,1010,1976,1976,98006,47.563,122.14,2690,8850,39,0,5.5,4750,10910
4.299e+05,2014,346,3,2,1490,1286,3,0,0,3,8,1490,0,2014,2014,98144,47.57,122.29,1420,1230,0,0,5,2910,2720
9.1e+05,2014,235,3,2.25,2180,9865,1,0,0,4,8,1660,520,1966,1966,98040,47.536,122.23,2600,10034,48,0,5.25,4780,12214
4e+05,2014,272,3,1,900,4084,1,0,0,3,7,900,0,1910,1910,98117,47.684,122.39,1280,4080,104,0,4,2180,4980
4.25e+05,2014,216,4,2.5,2390,5021,2,0,0,3,7,2390,0,2002,2002,98065,47.535,121.88,2520,5333,12,0,6.5,4910,7723
3.975e+05,2015,426,4,3,2350,9952,1,0,0,3,9,1650,700,1989,1989,98031,47.419,122.21,2440,9100,26,0,7,4790,11450
7.5e+05,2015,466,4,2.25,2420,11120,1,0,2,4,8,1620,800,1952,1952,98146,47.495,122.37,2210,8497,63,0,6.25,4630,10917
2.625e+05,2014,320,2,1.5,1140,14373,1,0,0,3,7,1140,0,1949,1996,98011,47.735,122.22,2140,9860,65,1,3.5,3280,11000
3.73e+05,2014,139,3,2.5,1670,3565,2,0,0,3,7,1670,0,1999,1999,98072,47.762,122.16,1510,3770,15,0,5.5,3180,5440
1.0588e+06,2015,481,6,2.75,2980,20000,1,0,4,3,8,2130,850,1965,1965,98177,47.76,122.38,2730,20000,50,0,8.75,5710,22980
1.81e+06,2015,464,3,2.25,2910,15626,1,0,0,4,9,2510,400,1923,1923,98199,47.653,122.41,2370,6519,92,0,5.25,5280,9429
8.47e+05,2014,153,5,1,2550,4623,2,0,0,4,9,2550,0,1905,1905,98122,47.609,122.29,1570,3875,109,0,6,4120,6425
5.75e+05,2015,367,4,2,1810,4400,2,0,0,3,8,1700,110,1909,1909,98122,47.613,122.29,1470,4400,106,0,6,3280,6210
1.67e+06,2015,470,5,3.5,4320,40816,2,0,0,4,11,4320,0,1997,1997,98004,47.644,122.19,4320,44584,18,0,8.5,8640,48904
1.91e+05,2014,126,3,1.5,800,8850,1,0,0,4,6,800,0,1959,1959,98023,47.327,122.35,820,8775,55,0,4.5,1620,9575
1.651e+06,2015,458,4,3.25,3640,13530,1,0,0,3,9,2570,1070,1924,2000,98039,47.629,122.24,2760,15000,91,1,7.25,6400,18640
4.75e+05,2014,133,4,2.5,3740,8700,1,0,0,3,10,2260,1480,2004,2004,98058,47.459,122.12,2650,6333,10,0,6.5,6390,10073
4.05e+05,2014,338,2,1,800,6016,1,0,0,3,6,800,0,1942,1942,98117,47.691,122.37,1470,3734,72,0,3,2270,4534
4.375e+05,2015,408,3,2.25,1790,7700,1,0,0,4,7,1340,450,1976,1976,98034,47.721,122.17,1610,7350,39,0,5.25,3400,9140
4.25e+05,2015,373,2,1,750,4000,1,0,0,2,6,750,0,1933,1933,98108,47.54,122.32,1160,4000,82,0,3,1910,4750
3.0993e+05,2015,479,3,1.75,1820,78408,1,0,0,3,6,1220,600,1950,1950,98042,47.336,122.13,1340,78408,65,0,4.75,3160,80228
1.285e+06,2015,390,3,2.25,2440,9200,1,0,1,4,8,2440,0,1950,1950,98105,47.663,122.27,2750,6211,65,0,5.25,5190,8651
1.984e+05,2014,291,3,1,1040,8645,1,0,0,4,7,1040,0,1962,1962,98042,47.363,122.12,1290,8645,52,0,4,2330,9685
6.85e+05,2014,204,5,2.5,2670,14455,2,0,0,5,9,2670,0,1958,1958,98155,47.757,122.28,1810,14455,56,0,7.5,4480,17125
2.345e+05,2014,256,4,2.5,1960,7875,1,0,0,3,7,1220,740,1978,1978,98001,47.343,122.27,2030,7650,36,0,6.5,3990,9610
4.64e+05,2015,416,3,2.5,1770,5146,2,0,0,3,8,1770,0,1992,1992,98029,47.57,122,1870,5146,23,0,5.5,3640,6916
4.35e+05,2014,333,4,2.25,1990,8548,2,0,0,3,8,1990,0,1973,1973,98033,47.667,122.18,2320,8926,41,0,6.25,4310,10916
5.6e+05,2015,383,4,2.5,2940,6000,2,0,0,3,8,2940,0,2000,2000,98011,47.753,122.2,2510,6600,15,0,6.5,5450,9540
2.7e+05,2015,481,3,2.5,1540,7739,2,0,0,4,7,1540,0,1986,1986,98030,47.351,122.17,1720,7200,29,0,5.5,3260,8740
3.65e+05,2015,412,3,2.25,1310,915,2,0,0,3,7,1060,250,2007,2007,98144,47.574,122.29,1500,1215,8,0,5.25,2810,2525
7.47e+05,2014,273,3,1.75,2560,4800,1,0,0,3,7,1280,1280,1911,1911,98112,47.621,122.3,1620,4800,103,0,4.75,4180,7360
8.5e+05,2014,284,5,3.5,4200,5400,2,0,0,3,9,3140,1060,2012,2012,98052,47.708,122.12,3300,5564,2,0,8.5,7500,9764
6.6e+05,2014,173,3,3.25,1980,2850,3,0,0,3,7,1980,0,1987,1987,98103,47.66,122.33,1630,4560,27,0,6.25,3610,6540
2.9e+05,2015,487,3,2.25,1620,7772,2,0,0,4,8,1620,0,1988,1988,98003,47.352,122.3,1710,6455,27,0,5.25,3330,8075
3.25e+05,2014,324,4,1,2410,6975,1,0,0,3,7,1510,900,1957,1957,98108,47.569,122.3,1880,6255,57,0,5,4290,8665
5.75e+05,2015,485,3,2,940,5000,1,0,0,3,7,880,60,1941,1941,98117,47.677,122.4,1420,5000,74,0,5,2360,5940
2.95e+05,2014,126,3,2.25,1980,8000,1,0,0,4,9,1560,420,1974,1974,98023,47.315,122.38,2360,8000,40,0,5.25,4340,9980
4.7e+05,2014,230,3,3.25,1710,2381,2,0,0,3,8,1360,350,2003,2003,98029,47.548,122,1420,1163,11,0,6.25,3130,2873
3.3e+05,2015,479,2,1,790,9784,1,0,0,3,6,790,0,1932,1932,98155,47.763,122.28,2350,10102,83,0,3,3140,10892
3.2495e+05,2014,202,4,2.5,2229,5723,2,0,0,3,7,2229,0,2012,2012,98032,47.369,122.29,2738,5742,2,0,6.5,4967,7971
2.9e+05,2014,140,3,1.75,1280,10716,1,0,0,4,7,1280,0,1969,1969,98059,47.475,122.14,1440,9870,45,0,4.75,2720,11150
4.2e+05,2014,331,3,1,1240,7300,1,0,0,3,7,1240,0,1968,1968,98033,47.678,122.17,1240,8260,46,0,4,2480,9500
6.355e+05,2014,314,3,2,1660,3600,1,0,0,3,7,1000,660,1939,2006,98103,47.679,122.35,1700,4356,75,1,5,3360,6016
8.435e+05,2014,151,4,2,2630,16475,2,0,0,4,8,2630,0,1953,1953,98004,47.639,122.22,2670,15001,61,0,6,5300,17631
5.05e+05,2014,231,3,2,1500,2500,2,0,0,3,8,1500,0,2002,2002,98107,47.675,122.39,1550,5000,12,0,5,3050,6500
2.535e+05,2015,452,3,1.5,1440,12040,1,0,0,4,7,1440,0,1959,1959,98042,47.371,122.16,1720,12040,56,0,4.5,3160,13480
1.0143e+06,2014,181,3,1,1640,12855,1,0,0,5,6,1500,140,1920,1920,98004,47.617,122.21,2190,11262,94,0,4,3830,12902
4.3e+05,2014,153,3,2,1360,5120,1,0,0,4,6,910,450,1924,1924,98116,47.559,122.39,1440,5120,90,0,5,2800,6480
3.75e+05,2015,381,4,2.75,1890,5240,1,0,0,3,7,980,910,1981,1981,98106,47.553,122.36,1600,5240,34,0,6.75,3490,7130
5.399e+05,2014,221,3,1.75,1650,10150,1,0,0,3,8,1230,420,1976,1976,98033,47.696,122.17,1930,8958,38,0,4.75,3580,10608
5.65e+05,2014,129,4,2.25,2470,7447,2,0,0,3,8,2470,0,1984,1984,98155,47.751,122.29,2270,7400,30,0,6.25,4740,9870
6.025e+05,2014,149,4,2.5,2760,6850,2,0,0,3,9,2760,0,1999,1999,98056,47.535,122.19,2640,9803,15,0,6.5,5400,12563
3.7895e+05,2014,216,4,2.5,1867,15314,2,0,0,3,9,1867,0,2013,2013,98030,47.352,122.2,2616,8048,1,0,6.5,4483,9915
2.0895e+05,2014,283,3,1,960,5700,1,0,0,4,5,960,0,1956,1956,98056,47.498,122.17,960,5700,58,0,4,1920,6660
1.275e+06,2014,187,3,2.5,3870,46609,2,0,3,3,9,3870,0,1997,1997,98008,47.597,122.11,4030,17880,17,0,5.5,7900,21750
1.4e+06,2015,458,3,2.75,3130,19530,1,1,4,3,8,1690,1440,1947,1984,98008,47.59,122.11,2980,18782,68,1,5.75,6110,21912
5.95e+05,2014,189,4,3.25,3730,4560,2,0,0,3,9,2760,970,2015,2015,98103,47.672,122.33,1800,4560,-1,0,7.25,5530,8290
2.8995e+05,2014,300,2,1,760,6000,1,0,0,4,6,760,0,1950,1950,98133,47.717,122.34,950,6000,64,0,3,1710,6760
4.1e+05,2014,205,2,2,1350,3926,1,0,0,3,8,1350,0,2007,2007,98053,47.719,122.02,1440,3926,7,0,4,2790,5276
2.75e+05,2014,291,3,1.5,1410,9000,1,0,0,3,7,1410,0,1953,1953,98133,47.764,122.35,1910,7214,61,0,4.5,3320,8624
4.32e+05,2015,473,4,1.75,1970,5160,1,0,0,3,7,1970,0,1942,1942,98126,47.534,122.37,1230,4920,73,0,5.75,3200,6890
4e+05,2015,459,4,2,2060,3060,2,0,0,3,7,2060,0,1968,1968,98118,47.563,122.28,1630,3766,47,0,6,3690,5826
3.76e+05,2015,436,2,1,880,2400,1,0,0,3,6,760,120,1918,1918,98118,47.564,122.28,1180,6300,97,0,3,2060,7180
3.1e+05,2015,408,2,2.5,1090,923,2,0,0,3,7,1090,0,2004,2004,98027,47.535,122.07,1410,1326,11,0,4.5,2500,2416
2.1e+05,2014,318,3,1.5,1400,9600,1,0,0,4,7,1400,0,1964,1964,98003,47.288,122.3,2210,15000,50,0,4.5,3610,16400
5.28e+05,2014,218,4,2.75,2050,7171,1,0,0,3,8,1540,510,1988,1988,98074,47.619,122.04,1960,7110,26,0,6.75,4010,9160
6.2e+05,2015,457,3,2.5,1776,1248,3,0,0,3,8,1604,172,2006,2006,98103,47.654,122.35,1780,1248,9,0,5.5,3556,3024
1.6e+06,2015,453,4,2.25,2940,5735,1,0,0,3,9,1470,1470,1957,1957,98112,47.638,122.3,2230,5659,58,0,6.25,5170,8599
2.99e+05,2015,433,5,2.5,1940,9389,1,0,0,4,7,1290,650,1960,1960,98155,47.744,122.33,1810,9390,55,0,7.5,3750,11330
3.5e+05,2014,276,3,1.75,1320,10500,1,0,0,3,7,1320,0,1966,1966,98034,47.727,122.23,1310,10500,48,0,4.75,2630,11820
6.25e+05,2015,456,4,2.25,3230,9935,2,0,0,3,8,3230,0,1986,1986,98028,47.769,122.26,2820,9722,29,0,6.25,6050,12952
4.8e+05,2014,172,2,2.25,1490,6770,1,0,0,3,8,1490,0,1926,1926,98108,47.558,122.3,1820,7875,88,0,4.25,3310,9365
6.2e+05,2014,204,4,2.75,2290,3060,1,0,0,5,7,1550,740,1928,1928,98115,47.679,122.32,1460,3060,86,0,6.75,3750,5350
3.72e+05,2014,273,3,2.5,2430,5000,2,0,0,3,8,2430,0,2001,2001,98042,47.379,122.13,2910,5620,13,0,5.5,5340,8050
3.55e+05,2014,244,3,2.25,1445,1087,2,0,0,3,7,1300,145,2005,2005,98027,47.534,122.07,1410,1336,9,0,5.25,2855,2781
3.55e+05,2014,306,4,2.5,2570,6466,2,0,0,3,9,2570,0,1999,1999,98092,47.332,122.17,2520,6667,15,0,6.5,5090,9237
2.43e+05,2014,151,3,1.75,1790,12000,1,0,0,3,7,1040,750,1960,1960,98198,47.395,122.31,1840,12000,54,0,4.75,3630,13790
4.25e+05,2015,466,2,1,620,4455,1,0,0,3,6,620,0,1927,1927,98117,47.688,122.39,1180,5000,88,0,3,1800,5620
8e+05,2014,190,3,2.75,2220,4000,2,0,0,3,8,1700,520,1914,2000,98122,47.617,122.29,1800,4000,100,1,5.75,4020,6220
7.3e+05,2015,473,3,3.5,2440,3502,2,0,0,3,7,1970,470,2000,2000,98005,47.589,122.17,2440,3417,15,0,6.5,4880,5857
2.925e+05,2015,445,3,2.5,2095,3438,2,0,0,3,7,2095,0,2008,2008,98002,47.352,122.21,1805,3402,7,0,5.5,3900,5497
4.1e+05,2014,177,3,2,1400,45738,2,0,0,4,8,1400,0,1981,1981,98070,47.362,122.45,2390,56628,33,0,5,3790,58028
5.6e+05,2015,453,3,2.75,1370,1193,3,0,0,3,8,1370,0,2003,2003,98107,47.67,122.39,1320,1180,12,0,5.75,2690,2550
1.745e+05,2014,136,2,1,1010,5200,1,0,0,3,7,1010,0,1955,1955,98198,47.417,122.32,1580,7500,59,0,3,2590,8510
6.5375e+05,2014,203,4,2.5,2460,4166,2,0,0,3,9,2460,0,2003,2003,98034,47.707,122.23,2460,4964,11,0,6.5,4920,7424
1.69e+06,2014,140,3,1.75,3400,8965,1,0,2,5,9,1820,1580,1957,1957,98105,47.657,122.27,3200,8500,57,0,4.75,6600,11900
5.1e+05,2015,472,1,1,680,6600,1,0,0,3,5,480,200,1916,1916,98199,47.657,122.39,1170,5500,99,0,2,1850,6180
3.43e+05,2015,465,3,1.75,2210,7920,1,0,0,3,7,1400,810,1966,1966,98178,47.497,122.24,2220,7920,49,0,4.75,4430,10130
2.1e+05,2014,293,3,1.5,1160,5200,1,0,0,5,7,1160,0,1970,1970,98042,47.364,122.09,1170,5200,44,0,4.5,2330,6360
2.45e+05,2014,276,3,1.5,2100,10000,1,0,0,4,7,2100,0,1954,1954,98198,47.422,122.33,1300,7500,60,0,4.5,3400,9600
5.25e+05,2014,160,5,2.75,2880,8364,2,0,0,3,9,2880,0,2006,2006,98059,47.489,122.15,3010,8296,8,0,7.75,5890,11176
1.14e+06,2014,203,4,3.25,3740,11467,2,0,0,3,10,3740,0,2014,2014,98029,47.581,122.02,2510,27520,0,0,7.25,6250,31260
4.1e+05,2014,188,4,2.5,2560,4020,2,0,0,3,9,2560,0,2006,2006,98038,47.353,122.03,3010,4916,8,0,6.5,5570,7476
8.75e+05,2014,130,4,2,2520,6000,1,0,0,3,8,1400,1120,1921,2007,98103,47.677,122.35,1580,3720,93,1,6,4100,6240
5.6e+05,2015,472,3,2.5,1390,1411,3,0,0,3,8,1390,0,2008,2008,98103,47.648,122.33,1350,1266,7,0,5.5,2740,2656
2.49e+05,2015,415,3,1.75,1520,7500,1,0,0,3,8,1520,0,1985,1985,98092,47.265,122.22,2180,7506,30,0,4.75,3700,9026
5.36e+05,2015,382,5,2.25,2650,9140,1,0,1,3,8,1350,1300,1965,1965,98177,47.777,122.39,2700,7800,50,0,7.25,5350,10450
3.16e+05,2014,266,3,1,1010,7838,1,0,0,4,6,1010,0,1977,1977,98019,47.742,121.98,1380,8128,37,0,4,2390,9138
4.3e+05,2014,215,3,1.5,1690,9708,1,0,0,5,7,1690,0,1954,1954,98006,47.573,122.14,1570,9858,60,0,4.5,3260,11548
3.5e+05,2014,206,3,3.25,1210,941,2,0,0,3,8,1000,210,2002,2002,98133,47.711,122.36,1650,1493,12,0,6.25,2860,2703
7.19e+05,2014,256,5,2,3110,6131,1,0,0,5,7,1560,1550,1940,1940,98118,47.562,122.28,1720,6600,74,0,7,4830,9710
6e+05,2015,463,5,2.5,2380,8204,1,0,0,3,8,1540,840,1957,1957,98115,47.7,122.29,2270,8204,58,0,7.5,4650,10584
1.32e+06,2014,350,4,3,2120,3600,2,0,3,4,8,1830,290,1908,1996,98119,47.634,122.37,2120,3600,106,1,7,4240,5720
3.7e+05,2015,438,4,2,1640,7200,1,0,0,3,7,1640,0,1963,1963,98155,47.747,122.32,1500,9000,52,0,6,3140,10640
3.17e+05,2014,205,3,2,1790,8228,1,0,0,3,7,1390,400,1980,1980,98058,47.466,122.17,1880,8228,34,0,5,3670,10018
4.53e+05,2015,376,3,2.5,1820,16300,1,0,0,4,7,1220,600,1955,1955,98166,47.458,122.36,1870,16300,60,0,5.5,3690,18120
4.38e+05,2015,471,5,1,1950,6250,1,0,0,4,7,1450,500,1917,1917,98136,47.551,122.39,1950,6250,98,0,6,3900,8200
2.75e+05,2014,231,5,1.75,2180,9178,1,0,0,3,7,1140,1040,1963,1963,98188,47.436,122.28,2140,9261,51,0,6.75,4320,11441
2.32e+05,2014,352,3,1.5,1390,11340,1,0,0,4,7,1390,0,1963,1963,98031,47.398,122.19,1740,11340,51,0,4.5,3130,12730
1.5631e+06,2015,423,5,3.5,3630,8100,2,0,0,3,10,3630,0,2008,2008,98004,47.595,122.2,1730,8246,7,0,8.5,5360,11876
5.499e+05,2014,130,5,2.75,3060,7015,1,0,0,5,8,1600,1460,1979,1979,98146,47.505,122.37,2190,7600,35,0,7.75,5250,10660
5.3e+05,2015,472,3,2.5,1410,1250,2,0,0,3,8,1140,270,2010,2010,98119,47.651,122.38,1720,2825,5,0,5.5,3130,4235
8.05e+05,2014,320,5,3,2350,6480,2,0,3,4,7,1650,700,1924,1962,98118,47.558,122.27,1840,7200,90,1,8,4190,9550
5.21e+05,2015,423,3,1.75,1720,37363,1,0,0,4,8,1350,370,1974,1974,98053,47.661,122.03,2740,40635,41,0,4.75,4460,42355
4.6e+05,2015,410,3,1,1130,7000,1,0,0,3,6,830,300,1944,1944,98125,47.713,122.28,1050,7000,71,0,4,2180,8130
4.45e+05,2014,284,3,1.75,1850,7056,2,0,0,4,8,1850,0,1979,1979,98052,47.66,122.13,1970,7056,35,0,4.75,3820,8906
4e+05,2014,243,3,2.25,1180,14258,2,0,0,3,7,1180,0,1987,1987,98034,47.711,122.24,1860,10390,27,0,5.25,3040,11570
3.5e+05,2014,259,4,2.5,1530,2248,1,0,0,3,7,1530,0,1914,1914,98144,47.577,122.31,1340,3700,100,0,6.5,2870,5230
3.395e+06,2015,423,4,3.5,4730,47870,1,1,4,3,10,2940,1790,1954,1954,98033,47.697,122.22,3250,49346,61,0,7.5,7980,54076
3.56e+05,2014,313,3,1.5,1140,7500,1,0,0,3,7,1140,0,1976,1976,98074,47.619,122.06,1380,7500,38,0,4.5,2520,8640
4e+05,2014,239,4,2.5,2398,5988,2,0,0,3,8,2398,0,2008,2008,98055,47.452,122.2,2370,5988,6,0,6.5,4768,8386
1.312e+06,2015,381,3,3.25,4030,6300,2,0,0,3,10,3630,400,2006,2006,98105,47.666,122.28,1660,6300,9,0,6.25,5690,10330
4.238e+05,2014,211,3,2.5,1940,7415,2,0,0,3,8,1940,0,1965,1965,98006,47.542,122.18,1940,8425,49,0,5.5,3880,10365
1.1275e+06,2015,445,6,3.25,3870,24700,2,0,0,3,10,2520,1350,1989,1989,98028,47.752,122.23,2360,30030,26,0,9.25,6230,33900
7.38e+05,2014,177,3,3,2630,4896,2,0,0,3,9,2630,0,2006,2006,98052,47.693,122.13,2880,4972,8,0,6,5510,7602
2.35e+05,2014,122,2,1,1210,9400,1,0,0,2,6,1210,0,1949,1949,98106,47.534,122.36,1580,6026,65,0,3,2790,7236
4.455e+05,2015,394,4,1.5,2210,10497,1,0,0,4,8,1650,560,1953,1953,98166,47.432,122.35,1840,12697,62,0,5.5,4050,14907
3.674e+05,2014,214,4,1.5,1280,7400,1,0,0,3,7,1280,0,1958,1958,98008,47.602,122.12,1310,7400,56,0,5.5,2590,8680
4.32e+05,2014,353,3,1.75,2410,51763,1,0,0,4,8,1410,1000,1981,1981,98077,47.743,122.06,2410,49207,33,0,4.75,4820,51617
5.575e+05,2014,175,3,1.75,1900,11165,1,0,0,4,7,1900,0,1959,1959,98008,47.579,122.12,2030,11165,55,0,4.75,3930,13065
5.6995e+05,2014,236,4,2.5,3230,5899,2,0,0,3,8,3230,0,2012,2012,98065,47.515,121.87,2720,5899,2,0,6.5,5950,9129
3.85e+05,2014,163,4,2.5,2050,5276,2,0,0,3,7,2050,0,2006,2006,98059,47.491,122.15,2480,5447,8,0,6.5,4530,7497
1.75e+05,2015,445,3,1.75,1430,4920,1,0,0,2,6,1430,0,1957,1957,98118,47.539,122.28,1550,5646,58,0,4.75,2980,7076
5.38e+05,2014,189,3,2.5,3010,7014,2,0,0,3,8,3010,0,2009,2009,98059,47.495,122.15,3030,6180,5,0,5.5,6040,9190
4.75e+05,2015,446,4,2.25,1800,7200,1,0,0,3,7,1230,570,1979,1979,98177,47.772,122.38,2260,7498,36,0,6.25,4060,9298
3.15e+05,2015,424,5,3,2110,10766,2,0,0,3,7,2110,0,2005,2005,98030,47.36,122.18,1460,10400,10,0,8,3570,12510
2.72e+05,2015,457,3,2.5,1528,7616,2,0,0,3,7,1528,0,2011,2011,98030,47.377,122.19,1850,7340,4,0,5.5,3378,8868
8.7e+05,2014,221,5,2.25,2910,9525,2,0,0,4,9,2910,0,1968,1968,98040,47.563,122.22,2740,9525,46,0,7.25,5650,12435
5.7e+05,2014,324,4,2.5,2890,5801,2,0,0,3,9,2890,0,2005,2005,98028,47.735,122.24,2890,6286,9,0,6.5,5780,9176
5.5e+05,2014,216,4,2.75,2230,9460,1,0,0,5,7,1480,750,1960,1960,98027,47.525,122.04,1760,10878,54,0,6.75,3990,13108
8.5e+05,2015,453,4,3,3070,7150,2,0,0,3,9,3070,0,2007,2007,98052,47.708,122.11,3200,6984,8,0,7,6270,10054
8.95e+05,2015,393,3,2.5,2750,10000,1,0,3,3,8,1650,1100,1967,1967,98006,47.564,122.15,2490,10000,48,0,5.5,5240,12750
4.2995e+05,2014,191,4,1,1760,7216,1,0,0,3,7,1090,670,1947,1947,98133,47.704,122.36,1180,3844,67,0,5,2940,5604
5.527e+05,2015,437,2,1,1100,2800,1,0,0,3,7,1100,0,1925,1925,98119,47.636,122.37,1110,1673,90,0,3,2210,2773
3.02e+05,2014,306,2,1,890,5000,1,0,0,4,6,890,0,1947,1947,98118,47.553,122.29,1160,5000,67,0,3,2050,5890
3.83e+05,2015,424,4,2.5,2050,4953,2,0,0,3,9,2050,0,2014,2014,98038,47.345,122.02,2340,6175,1,0,6.5,4390,8225
3.15e+05,2015,382,4,1,1300,8400,1,0,0,4,7,1300,0,1953,1953,98133,47.761,122.33,1330,8400,62,0,5,2630,9700
3.9e+05,2014,250,2,1.75,1150,2723,1,0,0,4,7,770,380,1923,1923,98102,47.636,122.32,1440,4000,91,0,3.75,2590,5150
6.2995e+05,2015,425,3,2.5,1680,1683,2,0,0,3,9,1120,560,2014,2014,98119,47.642,122.37,1610,1618,1,0,5.5,3290,3298
6.65e+05,2014,198,2,2.5,2600,5000,1,0,0,5,8,1300,1300,1926,1926,98126,47.581,122.38,2260,5000,88,0,4.5,4860,7600
4.0395e+05,2014,245,4,2.5,2120,13780,2,0,0,3,8,2120,0,1993,1993,98146,47.499,122.36,1880,12000,21,0,6.5,4000,14120
6.3623e+05,2014,238,4,2.5,2840,6284,2,0,0,3,9,2840,0,2013,2013,98056,47.514,122.17,2790,7168,1,0,6.5,5630,10008
4.289e+05,2014,264,4,2.5,2598,5553,2,0,0,3,9,2598,0,2014,2014,98092,47.341,122.18,2502,4900,0,0,6.5,5100,7498
5.97e+05,2014,235,4,2,2120,4000,1,0,0,4,7,1720,400,1927,1927,98117,47.688,122.38,1760,4000,87,0,6,3880,6120
2.965e+05,2014,139,3,2.75,2170,7900,1,0,0,4,8,1380,790,1978,1978,98032,47.362,122.28,2170,7700,36,0,5.75,4340,9870
8e+05,2014,161,4,3.75,2690,4000,2,0,3,4,9,2120,570,1909,1989,98119,47.642,122.37,2830,4000,105,1,7.75,5520,6690
8.3e+05,2015,388,5,3.5,3490,21780,2,0,0,3,8,3490,0,1996,1996,98052,47.671,122.14,3070,7829,19,0,8.5,6560,11319
5.55e+05,2015,408,4,2.25,3330,21785,2,0,0,3,9,3330,0,1994,1994,98059,47.472,122.14,3330,21796,21,0,6.25,6660,25126
2.76e+05,2014,340,3,2.5,2495,4400,2,0,0,3,8,2495,0,2007,2007,98001,47.288,122.28,2434,4400,7,0,5.5,4929,6895
6.4e+05,2014,155,3,1.75,2340,4206,1,0,0,5,7,1170,1170,1917,1917,98144,47.576,122.29,1360,4725,97,0,4.75,3700,7065
2.75e+05,2015,433,3,2.25,1420,8549,2,0,0,4,7,1420,0,1989,1989,98038,47.358,122.04,1560,7471,26,0,5.25,2980,8891
4.345e+05,2015,451,3,1.75,1650,7965,1,0,0,4,7,1650,0,1967,1967,98034,47.733,122.19,1560,7350,48,0,4.75,3210,9000
3.76e+05,2014,140,2,1,1150,4000,1,0,0,3,7,1150,0,1947,1947,98199,47.657,122.39,1150,4288,67,0,3,2300,5438
4.3995e+05,2015,477,5,1.75,2190,7500,1,0,0,3,7,1290,900,1979,1979,98133,47.777,122.36,1790,8820,36,0,6.75,3980,11010
7.6075e+05,2014,276,3,2.5,3190,49137,2,0,0,3,9,3190,0,1988,1988,98074,47.603,122.04,3240,53143,26,0,5.5,6430,56333
4.635e+05,2014,270,1,1,1090,8750,1,0,0,4,6,1090,0,1924,1924,98118,47.54,122.27,1830,5000,90,0,2,2920,6090
3.595e+05,2015,447,3,2.5,2070,4689,2,0,0,3,8,2070,0,2013,2013,98038,47.355,122.06,1880,4593,2,0,5.5,3950,6663
2.7995e+05,2014,230,3,1.5,1520,7200,1,0,0,4,7,1160,360,1990,1990,98198,47.386,122.3,1460,7200,24,0,4.5,2980,8720
6.09e+05,2014,361,6,3,2470,9267,2,0,0,3,8,2470,0,1982,1982,98007,47.602,122.15,2470,9151,32,0,9,4940,11621
5.45e+05,2014,182,3,2,1340,7200,1,0,0,4,7,1340,0,1923,1923,98118,47.56,122.27,1630,5760,91,0,5,2970,7100
4.7e+05,2015,408,4,2.5,2320,12042,1,0,0,4,7,1320,1000,1975,1975,98072,47.763,122.16,2160,7054,40,0,6.5,4480,9374
3.6481e+05,2015,433,3,1.75,2320,7875,1,0,0,3,8,1620,700,1967,1967,98058,47.452,122.15,1990,9720,48,0,4.75,4310,12040
4.535e+05,2014,242,3,1.75,1550,7270,1,0,0,5,7,1550,0,1953,1953,98125,47.72,122.32,1050,7210,61,0,4.75,2600,8760
2e+05,2014,175,3,2,1190,6833,1,0,0,3,7,1190,0,1995,1995,98092,47.319,122.18,1540,8000,19,0,5,2730,9190
5.42e+05,2014,188,3,1.75,1070,8030,1,0,0,3,7,1070,0,1966,2014,98052,47.67,122.16,1540,7875,48,1,4.75,2610,8945
3.715e+05,2014,188,3,1,1650,6400,1,0,0,4,7,980,670,1954,1954,98106,47.52,122.36,1230,6400,60,0,4,2880,8050
7.7e+05,2014,142,4,2.5,2350,8001,2,0,0,4,8,2350,0,1987,1987,98006,47.548,122.15,2460,8001,27,0,6.5,4810,10351
2.18e+05,2014,320,3,2.25,1610,7084,1,0,0,4,8,1280,330,1968,1968,98023,47.315,122.38,2170,8505,46,0,5.25,3780,10115
5.45e+05,2014,153,3,1.75,1810,3000,1,0,0,4,7,1810,0,1903,1903,98107,47.66,122.36,1140,3000,111,0,4.75,2950,4810
1.8e+05,2014,168,3,2.25,1990,6350,2,0,0,3,7,1990,0,1967,1967,98198,47.382,122.32,1220,6250,47,0,5.25,3210,8240
7.12e+05,2015,471,4,2.5,2730,4385,2,0,0,3,8,2730,0,2001,2001,98075,47.597,122.04,2670,4644,14,0,6.5,5400,7374
4.5e+05,2014,298,4,2.75,1540,4840,1,0,2,4,7,850,690,1929,1929,98126,47.549,122.38,1180,4840,85,0,6.75,2720,6380
2.825e+05,2014,195,2,1.75,1440,11210,1,0,0,4,6,1130,310,1935,1935,98146,47.498,122.35,1250,9381,79,0,3.75,2690,10821
3.36e+05,2014,188,4,2.5,2530,8169,2,0,0,3,8,2530,0,1993,1993,98003,47.263,122.31,2220,8013,21,0,6.5,4750,10543
2.995e+05,2014,335,3,1,1280,6726,1,0,0,3,6,1280,0,1958,1958,98144,47.572,122.3,1630,5000,56,0,4,2910,6280
3.3e+05,2015,473,4,2.25,2000,10679,1,0,0,3,7,1350,650,1960,1960,98148,47.424,122.33,1650,8875,55,0,6.25,3650,10875
3.9e+05,2014,348,3,1.5,1600,10440,1,0,0,3,7,1600,0,1954,1954,98125,47.711,122.31,1600,8816,60,0,4.5,3200,10416
4.37e+05,2014,211,3,2.25,1130,1221,2,0,0,3,8,1030,100,2004,2004,98117,47.68,122.38,1300,5000,10,0,5.25,2430,6130
6.28e+05,2014,124,4,2,2280,6010,1,0,0,3,7,1140,1140,1900,1900,98122,47.603,122.29,2240,6200,114,0,6,4520,8480
5.25e+05,2015,430,3,3.5,1370,1764,2,0,0,3,8,1180,190,2000,2000,98119,47.651,122.37,1400,1398,15,0,6.5,2770,2768
5.79e+05,2014,201,3,2.5,1990,4040,1,0,0,5,8,1390,600,1926,1926,98103,47.687,122.35,1180,3030,88,0,5.5,3170,5020
4.95e+05,2014,153,5,2.75,2670,3800,2,0,0,3,8,2670,0,2014,2014,98059,47.478,122.12,2670,3800,0,0,7.75,5340,6470
4.39e+05,2014,244,3,2.25,2230,4551,1,0,2,5,8,1450,780,1928,1928,98178,47.508,122.24,2060,7200,86,0,5.25,4290,9430
4.05e+05,2015,399,3,1.75,1670,6720,1,0,0,3,7,1140,530,1980,1980,98034,47.72,122.19,1670,7320,35,0,4.75,3340,8990
8.24e+05,2014,310,2,1,1210,8400,1,0,0,3,8,780,430,2000,2000,98199,47.65,122.39,1860,6000,14,0,3,3070,7210
2.4e+05,2014,298,3,2.25,1500,15334,2,0,0,4,7,1500,0,1992,1992,98042,47.372,122.09,1530,8102,22,0,5.25,3030,9602
5.09e+05,2014,252,3,3,2130,5000,1,0,0,3,7,1570,560,1913,1913,98118,47.545,122.28,1638,4500,101,0,6,3768,6630
4.8e+05,2014,299,3,2.5,2450,28185,2,0,0,3,9,2450,0,1990,1990,98058,47.467,122.12,2440,33541,24,0,5.5,4890,35991
3.45e+05,2014,205,4,2.5,1983,6002,2,0,0,3,9,1983,0,2012,2012,98092,47.328,122.16,2502,4750,2,0,6.5,4485,6733
5.83e+05,2014,232,3,1.75,1930,10183,1,0,0,4,8,1480,450,1975,1975,98006,47.562,122.14,2320,10000,39,0,4.75,4250,11930
5.675e+05,2015,463,3,2.5,2080,4556,2,0,0,3,8,2080,0,1999,1999,98074,47.604,122.01,1530,5606,16,0,5.5,3610,7686
4.14e+05,2015,485,4,2.5,2120,6497,2,0,0,3,7,2120,0,2003,2003,98019,47.724,121.96,2230,6300,12,0,6.5,4350,8420
3.045e+05,2015,439,4,2,1350,942,3,0,0,3,7,1350,0,2008,2008,98027,47.539,122.03,1390,942,7,0,6,2740,2292
5.65e+05,2014,237,4,2.5,2280,4602,2,0,0,3,8,2280,0,2003,2003,98075,47.59,122.02,2280,4193,11,0,6.5,4560,6473
3.15e+05,2015,409,3,2.75,1780,15114,1,0,0,3,7,1080,700,1980,1980,98003,47.258,122.31,1792,10155,35,0,5.75,3572,11935
1.35e+05,2014,297,2,1,1220,7250,1,0,0,4,6,1220,0,1914,1914,98010,47.358,121.97,1350,20250,100,0,3,2570,21470
3.5e+05,2014,331,3,1,1010,7680,1,0,0,4,7,1010,0,1967,1967,98034,47.732,122.23,1320,7373,47,0,4,2330,8383
2.5e+05,2014,356,6,2.5,2590,10890,1,0,0,4,7,1340,1250,1970,1970,98042,47.413,122.17,2474,10454,44,0,8.5,5064,13044
3.275e+05,2014,222,2,1,830,8183,1,0,0,5,6,830,0,1950,1950,98155,47.737,122.3,1180,8184,64,0,3,2010,9014
2.9e+05,2014,277,3,1.75,2060,7251,1,0,0,3,7,1350,710,1987,1987,98030,47.357,122.17,1520,7582,27,0,4.75,3580,9642
7.35e+05,2014,164,4,2.75,2450,4187,2,0,2,3,8,2450,0,2010,2010,98027,47.547,122.02,2320,4187,4,0,6.75,4770,6637
2.38e+05,2014,359,3,1.5,1360,7488,1,0,0,4,7,1050,310,1975,1975,98001,47.331,122.28,1580,7508,39,0,4.5,2940,8868
7.05e+05,2014,264,3,2.5,2820,7200,1,0,3,3,9,1780,1040,1979,1979,98177,47.769,122.39,2300,7200,35,0,5.5,5120,10020
3.375e+05,2014,352,2,1,1300,6731,1,0,0,3,7,1300,0,1950,1950,98116,47.57,122.39,1240,6731,64,0,3,2540,8031
6.15e+05,2014,266,3,1.75,1900,3783,1,0,0,5,7,1110,790,1927,1927,98144,47.574,122.31,1530,5098,87,0,4.75,3430,6998
6.34e+05,2015,400,3,1.75,2570,13000,2,0,0,4,7,2570,0,1962,1962,98177,47.77,122.37,2570,8521,53,0,4.75,5140,11091
2.5995e+05,2015,380,4,2,1610,6650,1,0,0,3,7,1610,0,1989,1989,98023,47.309,122.36,1960,6650,26,0,6,3570,8260
3.25e+05,2014,262,4,1,1530,5684,1,0,0,3,7,1130,400,1957,1957,98108,47.551,122.3,1540,6095,57,0,5,3070,7625
3.59e+05,2015,476,3,2.25,1950,1968,2,0,0,4,7,1160,790,1979,1979,98056,47.518,122.19,1950,1968,36,0,5.25,3900,3918
7.3e+05,2014,258,5,3.5,3760,4857,2,0,3,3,9,2820,940,2004,2004,98072,47.74,122.17,3000,5693,10,0,8.5,6760,9453
3.65e+05,2015,432,4,2.5,1570,9600,1,0,0,3,7,800,770,1972,1972,98155,47.776,122.3,1340,9110,43,0,6.5,2910,10680
2.65e+05,2014,210,3,2,1380,8536,2,0,0,4,7,1380,0,1955,1955,98148,47.437,122.33,1260,8750,59,0,5,2640,10130
1.94e+05,2014,209,3,1,1070,6440,1,0,0,4,7,1070,0,1971,1971,98023,47.319,122.37,1190,6532,43,0,4,2260,7602
5.75e+05,2014,280,3,2.75,1710,3600,1,0,0,3,7,1590,120,1909,1909,98119,47.642,122.36,1710,3600,105,0,5.75,3420,5310
8.9e+05,2014,262,4,2.75,2610,4400,1,0,0,5,8,1260,1350,1920,1920,98122,47.616,122.29,1770,4400,94,0,6.75,4380,7010
2.6995e+05,2014,202,3,2,1660,8641,2,0,0,4,8,1660,0,1987,1987,98042,47.366,122.09,1490,8641,27,0,5,3150,10301
3.675e+05,2015,369,3,1,1270,8792,1,0,0,5,7,1270,0,1969,1969,98056,47.535,122.17,1780,8792,46,0,4,3050,10062
6.0615e+05,2014,244,4,1.75,1770,9848,1,0,0,3,8,1370,400,1967,1967,98008,47.621,122.1,2040,9587,47,0,5.75,3810,11357
4.26e+05,2015,470,3,1.5,1380,7200,1,0,0,3,7,1080,300,1948,1948,98106,47.529,122.35,1220,7200,67,0,4.5,2600,8580
2.965e+05,2015,388,3,2.5,1770,6033,2,0,0,4,7,1770,0,1987,1987,98042,47.376,122.12,1590,6510,28,0,5.5,3360,8280
1.15e+06,2014,188,3,2.5,3830,48743,2,0,0,3,11,3830,0,1991,1991,98006,47.566,122.13,2950,8299,23,0,5.5,6780,12129
2.4e+05,2014,176,4,1,1200,2171,1,0,0,3,7,1200,0,1933,1933,98133,47.708,122.34,1130,1598,81,0,5,2330,2798
4.25e+05,2015,453,3,1.5,1660,5665,1,0,0,5,7,920,740,1918,1918,98118,47.539,122.27,1530,5665,97,0,4.5,3190,7325
3.3e+05,2014,270,3,1.5,1430,8000,1,0,0,5,7,1430,0,1948,1948,98155,47.772,122.32,1410,9820,66,0,4.5,2840,11250
4.6995e+05,2014,219,3,3.25,1760,1778,3,0,0,3,8,1760,0,2008,2008,98125,47.72,122.3,1520,1615,6,0,6.25,3280,3375
6.35e+05,2014,191,4,3.25,3420,6752,2,0,2,3,9,3030,390,2012,2012,98065,47.517,121.88,3010,5172,2,0,7.25,6430,8592
3e+05,2014,174,3,1,2150,7007,1,0,0,3,6,2150,0,1954,1954,98177,47.761,122.36,1720,9000,60,0,4,3870,11150
5.5e+05,2015,452,3,1.75,1570,6500,1,0,0,3,7,920,650,1948,1948,98116,47.565,122.4,1570,5750,67,0,4.75,3140,7320
5.5e+05,2014,122,3,1.75,2910,35200,1,0,0,3,8,2910,0,1979,1979,98075,47.575,122.03,2590,37500,35,0,4.75,5500,40410
6.15e+05,2014,194,3,1.75,1950,8480,1,0,0,4,8,1250,700,1962,1962,98007,47.589,122.15,1740,8480,52,0,4.75,3690,10430
2.8e+05,2015,461,5,2.5,1630,20750,1,0,0,4,7,1100,530,1975,1975,98042,47.366,122.11,1630,8640,40,0,7.5,3260,10270
3.42e+05,2015,472,4,1,1390,9023,1,0,0,3,7,1390,0,1955,1955,98155,47.775,122.3,1760,9023,60,0,5,3150,10413
5.1e+05,2014,335,2,2.25,1470,1101,2,0,0,3,8,1340,130,2005,2005,98115,47.677,122.3,1470,1582,9,0,4.25,2940,3052
2.8251e+05,2015,383,4,1,1450,32234,1,0,0,4,6,1450,0,1932,1932,98030,47.382,122.21,1530,10125,83,0,5,2980,11575
3.05e+05,2014,235,4,2.5,2280,3800,2,0,0,3,7,2280,0,2006,2006,98038,47.359,122.04,2630,4045,8,0,6.5,4910,6325
9.03e+05,2014,331,2,1.5,1140,7800,1,0,0,4,6,1140,0,1947,1947,98004,47.614,122.21,2020,7800,67,0,3.5,3160,8940
2.022e+05,2014,264,2,1.75,1330,2159,1,0,0,4,8,1330,0,1979,1979,98198,47.382,122.32,1220,3679,35,0,3.75,2550,5009
3.5995e+05,2014,201,3,2.75,2540,8604,2,0,0,3,8,2540,0,1991,1991,98092,47.321,122.19,2260,7438,23,0,5.75,4800,9978
8.8299e+05,2014,273,4,3.5,3560,6562,2,0,0,3,10,3560,0,2014,2014,98075,47.593,121.97,3710,6562,0,0,7.5,7270,10122
6.4e+05,2015,395,4,3.5,3220,5741,2,0,0,3,9,3220,0,2013,2013,98065,47.517,121.89,2960,6534,2,0,7.5,6180,9754
4.15e+05,2014,342,3,1.5,1490,7275,1,0,0,3,7,1090,400,1974,1974,98034,47.715,122.21,1420,7330,40,0,4.5,2910,8820
8.83e+05,2014,242,4,2.25,2410,4000,2,0,0,5,8,1650,760,1910,1910,98115,47.673,122.32,1820,4000,104,0,6.25,4230,6410
3.6e+05,2015,494,4,2.5,2020,7289,2,0,0,3,7,2020,0,1994,1994,98031,47.401,122.17,2090,7259,21,0,6.5,4110,9279
4.795e+05,2015,485,2,1,930,5760,1,0,0,3,6,730,200,1917,1917,98118,47.56,122.27,1970,5760,98,0,3,2900,6690
3.1e+05,2014,273,2,1,1050,8220,1,0,0,4,6,780,270,1947,1947,98155,47.76,122.32,1340,7651,67,0,3,2390,8701
3.349e+05,2014,322,2,2.5,980,1013,3,0,0,3,8,980,0,2008,2008,98117,47.684,122.39,980,1023,6,0,4.5,1960,2003
2.995e+05,2014,304,3,1.75,1880,11700,1,0,0,4,7,1880,0,1968,1968,98092,47.321,122.19,2230,35200,46,0,4.75,4110,37080
4.399e+05,2014,152,2,2,1410,12282,1,0,0,5,8,1410,0,1909,1988,98024,47.524,121.93,1410,8931,105,1,4,2820,10341
3.2e+05,2014,307,4,2.5,2190,7125,2,0,0,5,8,2190,0,1978,1978,98032,47.371,122.28,2190,8075,36,0,6.5,4380,10265
7.1653e+05,2015,484,3,1.5,1750,5400,1,0,0,4,7,1050,700,1952,1952,98115,47.68,122.28,1750,5400,63,0,4.5,3500,7150
3.35e+05,2015,472,4,2.25,2100,7305,1,0,0,4,7,1050,1050,1963,1963,98188,47.468,122.3,1760,7308,52,0,6.25,3860,9408
3.35e+05,2014,263,3,1,2130,3825,1,0,0,3,7,2130,0,1917,1917,98118,47.551,122.28,1780,5150,97,0,4,3910,7280
1.22e+05,2015,470,2,1,730,6728,1,0,0,3,6,730,0,1953,1953,98148,47.428,122.32,1170,7034,62,0,3,1900,7764
5.85e+05,2014,235,3,1.5,1670,5000,1,0,0,4,7,1670,0,1912,1912,98117,47.678,122.36,1750,5000,102,0,4.5,3420,6670
3.85e+05,2015,388,3,2.5,1740,4145,2,0,0,3,7,1740,0,2010,2010,98053,47.688,122.02,1740,4045,5,0,5.5,3480,5785
5.78e+05,2014,162,4,2.5,3140,9225,1,0,2,5,9,1770,1370,1966,1966,98055,47.49,122.23,2460,9600,48,0,6.5,5600,12740
3.475e+05,2014,250,3,2.5,2540,4760,2,0,0,3,8,2540,0,2010,2010,98038,47.345,122.02,2540,4571,4,0,5.5,5080,7111
9.7e+05,2015,446,4,2.75,4430,74358,2,0,0,3,10,4430,0,1990,1990,98053,47.639,121.99,3820,80875,25,0,6.75,8250,85305
3.953e+05,2014,135,3,1.5,1120,7000,1,0,0,3,7,1120,0,1955,1955,98007,47.599,122.15,1470,7950,59,0,4.5,2590,9070
4.4e+05,2015,478,4,2.5,2730,4526,2,0,0,3,7,2730,0,2009,2009,98059,47.491,122.15,2190,4572,6,0,6.5,4920,7302
2.6e+05,2014,231,3,1,1480,7469,1,0,0,3,6,1120,360,1940,1940,98168,47.505,122.3,1460,7379,74,0,4,2940,8859
2.65e+05,2015,387,3,2.25,2540,7216,2,0,0,3,8,2540,0,1991,1991,98023,47.291,122.35,2140,7531,24,0,5.25,4680,10071
5.9716e+05,2014,262,7,4,2690,10880,1,0,0,4,8,2690,0,1960,1960,98033,47.679,122.17,1840,10836,54,0,11,4530,13526
2.77e+05,2014,290,3,2.25,1610,11920,1,0,0,4,7,1110,500,1968,1968,98032,47.368,122.28,1690,11839,46,0,5.25,3300,13449
6.49e+05,2014,263,4,2.75,3130,9711,2,0,0,3,9,3130,0,2014,2014,98059,47.482,122.12,1570,10500,0,0,6.75,4700,13630
3.33e+05,2014,285,4,2,2750,9001,1,0,0,3,8,2750,0,2008,2008,98055,47.457,122.19,1340,11050,6,0,6,4090,13800
6.5e+05,2015,471,4,2.75,3260,5335,2,0,0,3,9,3260,0,2003,2003,98065,47.541,121.86,3180,5438,12,0,6.75,6440,8698
4.35e+05,2014,188,4,2.75,2230,9640,1,0,0,3,8,1320,910,1998,1998,98125,47.727,122.33,2100,9600,16,0,6.75,4330,11830
5.6e+05,2015,376,4,3,3080,9601,2,0,1,3,10,3080,0,1990,1990,98003,47.334,122.33,3200,9375,25,0,7,6280,12455
5.21e+05,2015,491,2,1,1050,7500,1,0,3,4,6,1050,0,1910,1910,98116,47.558,122.4,2540,13680,105,0,3,3590,14730
2.3e+06,2015,390,4,2.5,3370,8402,1,0,0,5,10,2240,1130,1962,1962,98112,47.635,122.29,3190,8700,53,0,6.5,6560,12070
7.52e+05,2015,429,4,2.5,2570,8178,1,0,2,3,8,1710,860,1961,1961,98118,47.548,122.26,2050,7500,54,0,6.5,4620,10070
6.35e+05,2014,141,4,2.25,2750,6180,1,0,0,4,8,1500,1250,1948,1948,98118,47.569,122.28,1740,6180,66,0,6.25,4490,8930
3.9995e+05,2014,290,2,2.25,1140,1184,2,0,0,3,8,1010,130,1999,1999,98103,47.659,122.35,1140,1339,15,0,4.25,2280,2479
1.2065e+06,2015,452,3,2.75,3150,5520,1,0,0,4,8,2130,1020,1925,1925,98112,47.635,122.3,3160,6200,90,0,5.75,6310,9350
2.8e+05,2015,478,3,2.5,1970,8426,2,0,0,3,8,1970,0,1992,1992,98003,47.267,122.31,1970,9197,23,0,5.5,3940,11167
2.525e+05,2014,217,2,1,900,7500,1,0,0,4,6,900,0,1961,1961,98014,47.648,121.92,1190,10000,53,0,3,2090,10900
2.199e+05,2014,142,3,1,910,6000,1,0,0,2,6,910,0,1956,1956,98146,47.507,122.34,1090,6957,58,0,4,2000,7867
4.03e+05,2015,453,3,1,1500,10730,1,0,0,3,7,1000,500,1977,1977,98053,47.639,121.97,1570,12210,38,0,4,3070,13710
2.9e+05,2014,312,4,2.5,2423,7292,2,0,0,3,8,2423,0,2005,2005,98023,47.323,122.37,2495,7489,9,0,6.5,4918,9912
9.6e+05,2014,147,5,4,3720,15200,2,0,0,3,10,3720,0,2005,2005,98075,47.596,122.03,4100,19036,9,0,9,7820,22756
1.9995e+05,2014,305,3,1,1340,7260,1,0,0,3,6,1340,0,1944,1944,98178,47.493,122.24,1210,7260,70,0,4,2550,8600
4.71e+05,2014,346,3,2.5,2010,4059,2,0,0,3,8,2010,0,1998,1998,98034,47.732,122.2,2010,5779,16,0,5.5,4020,7789
2.05e+05,2014,195,2,1,1060,8000,1,0,0,3,6,1060,0,1941,1941,98168,47.509,122.33,1390,8000,73,0,3,2450,9060
7.77e+05,2014,133,3,3.25,3610,59677,2,0,0,3,10,2440,1170,2003,2003,98027,47.546,122.09,3130,65775,11,0,6.25,6740,69385
5.8e+05,2014,272,4,3,3280,11060,2,0,0,3,8,2270,1010,1986,1986,98056,47.54,122.18,2320,11004,28,0,7,5600,14284
3.15e+05,2015,417,3,2,1500,7828,1,0,0,4,7,1500,0,1967,1967,98058,47.448,122.16,1500,7700,48,0,5,3000,9200
3.2436e+05,2014,307,3,2.5,2000,9669,2,0,0,4,8,2000,0,1992,1992,98022,47.196,122.01,1930,9202,22,0,5.5,3930,11202
2.2e+05,2014,176,3,1.5,1660,15600,2,0,0,3,7,1660,0,1981,1981,98001,47.259,122.28,1660,14400,33,0,4.5,3320,16060
2.42e+05,2015,424,3,1.75,1300,9856,1,0,0,4,7,1300,0,1962,1962,98003,47.345,122.3,1400,9600,53,0,4.75,2700,10900
1.95e+05,2014,325,2,1,720,9520,1,0,0,4,6,720,0,1947,1947,98155,47.768,122.32,1450,8612,67,0,3,2170,9332
7.23e+05,2014,218,4,3.5,3510,9263,2,0,0,3,10,3510,0,2001,2001,98065,47.541,121.88,3690,10417,13,0,7.5,7200,13927
5.7e+05,2015,424,3,1.75,1260,3328,1,0,0,5,6,700,560,1905,1905,98103,47.682,122.35,1380,3536,110,0,4.75,2640,4796
6.195e+05,2014,140,3,2.5,1700,4105,2,0,0,3,8,1700,0,1992,1992,98122,47.608,122.29,1880,3665,22,0,5.5,3580,5365
4.85e+05,2015,477,2,1,1080,4080,1,0,0,3,8,1080,0,1948,1948,98115,47.69,122.32,1890,4080,67,0,3,2970,5160
3.485e+05,2014,174,3,1.5,1360,10726,1,0,0,4,7,1360,0,1966,1966,98059,47.495,122.13,1650,10726,48,0,4.5,3010,12086
4.92e+05,2015,484,2,1.75,1300,22239,1,0,0,4,7,1300,0,1945,1986,98059,47.48,122.09,1300,14810,70,1,3.75,2600,16110
4.8e+05,2014,354,2,2,1140,12000,1,0,0,3,6,1140,0,1943,1943,98027,47.528,122.03,1880,6125,71,0,4,3020,7265
5.3e+05,2014,321,3,2.75,2100,20150,1,0,0,4,7,2100,0,1955,1955,98034,47.721,122.25,2100,15500,59,0,5.75,4200,17600
7.25e+05,2014,269,4,3,2420,12000,1,0,0,3,9,2420,0,1984,1984,98077,47.727,122.06,3100,13020,30,0,7,5520,15440
7.6e+05,2015,457,3,2,1810,4500,1,0,0,4,7,980,830,1906,1906,98117,47.681,122.36,1800,4500,109,0,5,3610,6310
3.575e+05,2015,413,3,1.5,1540,11858,1,0,0,4,7,1540,0,1966,1966,98059,47.475,122.16,1550,11473,49,0,4.5,3090,13013
1.065e+06,2015,436,3,2.75,2290,5002,2,0,0,4,9,1950,340,1995,1995,98033,47.681,122.21,2290,5100,20,0,5.75,4580,7390
9.1e+05,2014,142,4,3.25,3340,10890,1,0,0,3,9,2240,1100,1963,2000,98052,47.668,122.14,2880,9794,51,1,7.25,6220,13134
6e+05,2015,400,4,2.75,2950,5803,2,0,0,3,9,2950,0,2007,2007,98028,47.737,122.23,2940,5803,8,0,6.75,5890,8753
2.88e+05,2015,478,3,2.25,1560,9706,1,0,0,4,7,1560,0,1963,1963,98002,47.319,122.21,1510,9706,52,0,5.25,3070,11266
3.4e+05,2014,292,4,2.5,2550,7555,2,0,0,3,8,2550,0,2001,2001,98001,47.261,122.29,2550,6800,13,0,6.5,5100,9350
2e+05,2014,209,3,2,1290,5757,1,0,0,3,7,1290,0,1994,1994,98092,47.318,122.17,1580,6798,20,0,5,2870,8088
5.88e+05,2014,299,3,1.75,2310,7620,2,0,0,3,8,2310,0,1942,1988,98177,47.727,122.36,2200,7672,72,1,4.75,4510,9982
1.031e+06,2014,269,3,2.5,4110,35741,2,0,0,3,7,4110,0,1976,1976,98033,47.664,122.17,2710,8865,38,0,5.5,6820,12975
6.2e+05,2015,453,3,2.5,2440,10363,2,0,0,3,9,2440,0,1988,1988,98029,47.563,122.02,2500,10728,27,0,5.5,4940,13168
1.64e+05,2014,293,4,1,1530,4875,2,0,0,3,7,1530,0,1977,1977,98042,47.364,122.09,1470,4875,37,0,5,3000,6405
5.38e+05,2014,163,3,1,1460,7200,1,0,0,3,7,1260,200,1906,1906,98103,47.688,122.34,1430,4650,108,0,4,2890,6110
4.25e+05,2014,153,2,2.5,1140,1182,3,0,0,3,8,1140,0,2007,2007,98107,47.671,122.38,1290,1189,7,0,4.5,2430,2329
4.5e+05,2015,474,3,2.5,1800,4357,2,0,0,3,8,1800,0,2013,2013,98065,47.534,121.84,1800,3663,2,0,5.5,3600,5463
4.73e+05,2015,447,4,3.5,4370,37193,2,0,3,3,8,2780,1590,1996,1996,98022,47.241,121.98,2860,39356,19,0,7.5,7230,43726
3.325e+05,2015,362,3,2,1600,7995,1,0,0,3,7,1600,0,1950,1984,98118,47.518,122.26,2440,6900,65,1,5,4040,8500
1.6e+06,2015,407,4,3.5,3890,3600,2,0,0,3,9,2860,1030,2005,2005,98112,47.634,122.28,2460,6050,10,0,7.5,6350,9940
3.5e+05,2015,479,4,1.75,2140,4959,1,0,0,3,7,1080,1060,1965,1965,98118,47.517,122.27,1590,5250,50,0,5.75,3730,7390
7.35e+05,2014,348,4,2.5,3270,45537,2,0,0,3,9,3270,0,1993,1993,98053,47.63,121.98,2670,38827,21,0,6.5,5940,42097
4.9e+05,2014,148,4,2.5,2360,4367,2,0,0,3,8,2360,0,2003,2003,98011,47.773,122.17,2360,4868,11,0,6.5,4720,7228
3.2e+05,2014,335,2,1,1070,32633,1,0,0,4,6,1070,0,1930,1930,98059,47.472,122.08,1360,32156,84,0,3,2430,33226
3.15e+05,2014,209,2,1,1010,7338,2,0,0,4,7,1010,0,1981,1981,98056,47.512,122.19,1220,7719,33,0,3,2230,8729
3.928e+05,2014,277,2,1,740,4275,1,0,0,5,6,740,0,1924,1924,98115,47.688,122.31,1900,4275,90,0,3,2640,5015
2.92e+05,2014,334,4,2.5,2060,5950,2,0,0,3,8,2060,0,2000,2000,98030,47.363,122.19,2242,6406,14,0,6.5,4302,8466
4.53e+05,2015,459,2,1.5,1680,17400,1,0,0,3,7,1680,0,1991,1991,98038,47.384,122.01,1610,27600,24,0,3.5,3290,29280
3.9995e+05,2015,491,3,2.5,1510,7300,1,0,0,3,7,1040,470,1974,1974,98034,47.715,122.21,1360,7300,41,0,5.5,2870,8810
3.42e+05,2015,472,4,2.25,1964,3541,2,0,0,3,9,1964,0,2013,2013,98030,47.359,122.2,1757,3547,2,0,6.25,3721,5511
2.29e+05,2014,128,3,2.5,1190,3000,2,0,0,3,7,1190,0,2002,2002,98178,47.493,122.28,1190,3000,12,0,5.5,2380,4190
2.65e+05,2014,190,3,2.5,1530,6000,2,0,0,4,7,1530,0,1991,1991,98038,47.349,122.04,1360,6000,23,0,5.5,2890,7530
4.4e+05,2015,466,6,3,2510,5310,1,0,0,4,7,1460,1050,1944,1944,98108,47.553,122.3,1390,5407,71,0,9,3900,7917
4.815e+05,2014,306,3,1.75,2140,6000,1,0,0,3,7,1070,1070,1948,1948,98117,47.691,122.37,1240,4650,66,0,4.75,3380,6790
3.85e+05,2014,134,4,1.75,1620,4980,1,0,0,4,7,860,760,1947,1947,98133,47.703,122.34,1400,4980,67,0,5.75,3020,6600
2.219e+05,2014,283,3,1,1180,5650,1,0,0,3,7,1180,0,1955,1955,98178,47.511,122.26,1340,5650,59,0,4,2520,6830
3.83e+05,2014,285,4,1.75,2580,19607,1,0,2,4,8,1290,1290,1958,1958,98056,47.507,122.2,1970,9569,56,0,5.75,4550,12149
6.99e+05,2015,474,2,1.5,1400,4050,1,0,0,4,8,1400,0,1954,1954,98115,47.677,122.27,1900,5940,61,0,3.5,3300,7340
4.51e+05,2014,167,4,2.5,1670,3315,2,0,0,3,7,1670,0,2005,2005,98029,47.553,122,1650,2051,9,0,6.5,3320,3721
4.69e+05,2014,196,3,1.75,1680,2400,1,0,0,3,7,1170,510,1929,1929,98117,47.685,122.37,1080,4560,85,0,4.75,2760,6240
4.4e+05,2014,307,2,1.5,1080,6760,1,0,2,3,6,1080,0,1923,1923,98117,47.701,122.39,2080,5800,91,0,3.5,3160,6880
2.9e+05,2014,152,3,2.5,2080,4828,2,0,0,3,8,2080,0,2002,2002,98042,47.374,122.13,2190,4620,12,0,5.5,4270,6700
8.199e+05,2014,133,5,2.75,3150,7119,2,0,0,3,9,3150,0,2013,2013,98052,47.676,122.15,1560,8384,1,0,7.75,4710,11534
5.25e+05,2014,149,5,2.5,2630,9216,2,0,0,3,8,2630,0,2003,2003,98019,47.738,121.97,2020,4980,11,0,7.5,4650,7610
4.815e+05,2014,299,3,2.25,1840,10500,2,0,0,3,7,1840,0,1993,1993,98034,47.733,122.23,1840,7374,21,0,5.25,3680,9214
1.4375e+06,2014,242,4,3.75,4410,9231,3,0,3,3,11,4410,0,2001,2001,98118,47.543,122.27,2160,6600,13,0,7.75,6570,11010
1.3e+06,2014,205,4,1.75,4060,5500,2,0,0,5,9,2660,1400,1924,1924,98102,47.644,122.32,3320,5500,90,0,5.75,7380,9560
8.05e+05,2014,197,2,1.75,1550,6000,1,0,1,3,7,1550,0,1920,1920,98199,47.671,122.41,2360,6000,94,0,3.75,3910,7550
9.4299e+05,2014,345,4,2.5,3570,6218,2,0,0,3,9,3570,0,2014,2014,98052,47.705,122.12,3230,5972,0,0,6.5,6800,9542
5.8e+05,2014,209,4,2.75,2330,6703,1,0,0,3,7,1710,620,1983,1983,98177,47.707,122.36,2060,7500,31,0,6.75,4390,9830
6.3e+05,2014,168,4,2.5,2807,9430,2,0,0,3,8,2807,0,1996,1996,98028,47.745,122.22,2028,11056,18,0,6.5,4835,13863
1.95e+05,2014,310,3,2,1230,8235,1,0,0,3,6,1230,0,1959,1959,98168,47.485,122.3,1080,10281,55,0,5,2310,11511
3.57e+05,2015,402,3,1.5,1010,1546,2,0,0,3,8,1010,0,1971,2014,98144,47.6,122.31,1010,1517,44,1,4.5,2020,2527
3.1e+05,2015,480,3,1.5,1060,6954,1,0,0,4,6,1060,0,1983,1983,98106,47.55,122.36,1560,6372,32,0,4.5,2620,7432
6.65e+05,2015,450,3,3.5,3580,95832,1,0,0,3,9,3580,0,2005,2005,98038,47.424,122.02,2880,60548,10,0,6.5,6460,64128
4.6e+05,2014,215,3,1.75,1370,8467,1,0,0,4,7,970,400,1972,1972,98052,47.664,122.14,1650,8472,42,0,4.75,3020,9842
2.55e+05,2014,183,2,1.5,920,1598,2,0,0,3,7,920,0,1995,1995,98133,47.708,122.34,1110,1598,19,0,3.5,2030,2518
4.833e+05,2014,160,4,2,1210,11100,1,0,0,4,7,1210,0,1955,1955,98006,47.575,122.14,1280,11100,59,0,6,2490,12310
6.39e+05,2014,276,4,2,1940,5000,1,0,0,4,7,980,960,1910,1910,98107,47.672,122.37,1940,5000,104,0,6,3880,6940
5e+05,2015,493,3,2.5,2300,4307,2,0,0,3,8,2300,0,1998,1998,98034,47.733,122.2,2010,4307,17,0,5.5,4310,6607
5.5263e+05,2014,237,4,2,2560,9390,1,0,0,5,8,1280,1280,1957,1957,98133,47.717,122.33,1830,8169,57,0,6,4390,10729
4.899e+05,2014,191,4,2.5,2090,4196,2,0,0,3,8,2090,0,2006,2006,98011,47.745,122.19,2640,4503,8,0,6.5,4730,6593
5.15e+05,2015,367,3,2.5,1820,5280,1,0,0,4,7,910,910,1949,1949,98117,47.689,122.38,1600,4820,66,0,5.5,3420,6640
8.25e+05,2014,237,2,1,1150,12775,1,1,4,4,6,1150,0,1908,1908,98178,47.502,122.22,2440,11852,106,0,3,3590,13002
2.3e+05,2014,228,4,3,1680,6003,1,0,0,3,7,1150,530,1997,1997,98002,47.288,122.22,1820,6207,17,0,7,3500,7887
4.37e+05,2014,128,3,1.75,1310,9282,1,0,0,4,7,1310,0,1976,1976,98052,47.684,122.11,1310,8748,38,0,4.75,2620,10058
1.248e+06,2014,278,2,2.5,2310,3313,2,0,0,3,9,2310,0,2006,2006,98119,47.632,122.36,2700,5670,8,0,4.5,5010,7980
2.545e+05,2014,142,4,2.75,2570,7264,2,0,0,3,8,1720,850,1998,1998,98092,47.258,122.21,2420,7911,16,0,6.75,4990,10481
1.85e+05,2014,215,3,1.75,1080,9262,1,0,0,3,7,1080,0,1968,1968,98178,47.488,122.25,1090,9262,46,0,4.75,2170,10342
3.539e+05,2014,277,3,1.75,1560,5760,1,0,0,5,6,780,780,1927,1927,98106,47.527,122.36,1320,7680,87,0,4.75,2880,9240
2.82e+05,2015,480,3,2.25,1552,3600,2,0,0,3,7,1552,0,2012,2012,98092,47.32,122.18,1677,3600,3,0,5.25,3229,5152
7.8595e+05,2014,243,4,3,2530,4560,1,0,0,3,7,1540,990,1925,2014,98112,47.629,122.3,1640,4560,89,1,7,4170,7090
2e+05,2014,216,2,1,1000,6227,1,0,0,3,6,1000,0,1949,1949,98168,47.513,122.33,1240,6250,65,0,3,2240,7250
4.2e+05,2015,440,4,2.75,2400,20000,1,0,0,3,8,1170,1230,1961,2015,98058,47.456,122.09,1690,20000,54,1,6.75,4090,22400
6e+05,2015,477,2,1.75,1560,3200,1,0,0,5,7,880,680,1946,1946,98199,47.642,122.39,2060,4940,69,0,3.75,3620,6500
3.3e+05,2014,142,4,3.5,3150,6202,2,0,0,3,7,3150,0,2005,2005,98042,47.399,122.16,2950,5940,9,0,7.5,6100,9090
3.61e+05,2015,484,3,2.25,2470,5650,1,0,2,3,7,1550,920,1973,1973,98178,47.507,122.25,1660,5650,42,0,5.25,4130,8120
3.15e+05,2015,388,4,2.5,2780,3969,2,0,0,3,7,2780,0,2005,2005,98042,47.399,122.16,2260,4160,10,0,6.5,5040,6940
2.4e+05,2014,263,3,2.5,1520,9864,1,0,0,3,7,1160,360,1993,1993,98092,47.319,122.17,1580,7425,21,0,5.5,3100,8945
1.6375e+06,2014,331,3,3.5,4660,21164,2,1,4,3,12,4660,0,1975,1990,98166,47.442,122.35,3140,24274,39,1,6.5,7800,28934
9.2e+05,2015,457,4,3,3130,12381,2,0,0,3,9,3130,0,1995,1995,98006,47.56,122.12,3250,10049,20,0,7,6380,13179
9.88e+05,2015,367,3,1.75,2190,3800,1,0,2,4,8,2190,0,1923,1923,98109,47.643,122.36,2190,3880,92,0,4.75,4380,6070
7.25e+05,2015,388,4,2,2110,4140,2,0,0,3,9,1710,400,1925,2003,98116,47.584,122.39,1440,4420,90,1,6,3550,6530
4.54e+05,2014,314,3,2,1700,10000,2,0,0,3,8,1700,0,1992,1992,98011,47.766,122.2,1460,9621,22,0,5,3160,11321
4e+05,2014,342,3,1.75,1510,8385,1,0,0,3,7,1510,0,1968,1968,98034,47.728,122.19,1570,7480,46,0,4.75,3080,8990
9.75e+05,2014,249,4,2.5,2720,11049,2,0,0,3,10,2720,0,1989,1989,98004,47.581,122.19,2750,11049,25,0,6.5,5470,13769
4.2e+05,2014,284,3,2.5,2370,15375,2,0,2,3,9,2370,0,1993,1993,98042,47.38,122.15,2450,9800,21,0,5.5,4820,12170
3.9e+05,2015,472,2,1,980,3800,1,0,0,3,7,980,0,1926,1926,98103,47.69,122.34,1520,5010,89,0,3,2500,5990
3.96e+05,2014,195,4,1.75,1970,12409,1,0,0,4,7,1220,750,1968,1968,98028,47.749,122.24,1690,10720,46,0,5.75,3660,12690
7.19e+05,2014,216,3,3,1833,1706,3,0,0,3,9,1833,0,1998,1998,98115,47.683,122.33,1466,1455,16,0,6,3299,3288
1.01e+06,2014,298,4,2.75,2940,5400,1,0,2,5,8,1940,1000,1910,1910,98119,47.637,122.37,1970,2008,104,0,6.75,4910,4948
4.2e+05,2014,174,3,2.5,2140,3821,2,0,0,3,8,2140,0,2005,2005,98029,47.554,122,2860,3841,9,0,5.5,5000,5981
8.15e+05,2015,470,3,2.5,2790,53143,2,0,0,4,9,2790,0,1991,1991,98077,47.769,122.04,2740,47916,24,0,5.5,5530,50706
6.8e+05,2014,160,3,1.75,1760,8400,1,0,0,4,8,1460,300,1960,1960,98136,47.535,122.39,1980,8400,54,0,4.75,3740,10160
3.07e+05,2014,190,4,2.5,1714,3080,2,0,0,3,8,1714,0,2009,2009,98055,47.429,122.19,1714,3250,5,0,6.5,3428,4964
4.2055e+05,2015,438,4,2,1370,8100,1,0,0,2,7,1370,0,1947,1947,98155,47.749,122.31,1280,8100,68,0,6,2650,9470
3.55e+05,2015,445,3,1.75,1460,7203,1,0,0,3,7,1460,0,1990,1990,98056,47.505,122.19,1570,7203,25,0,4.75,3030,8663
7.1e+05,2014,319,4,1.75,2000,6000,1,0,3,5,7,1000,1000,1956,1956,98109,47.643,122.35,2610,4377,58,0,5.75,4610,6377
4.595e+05,2014,181,2,1,1250,3825,1,0,0,3,7,850,400,1929,1929,98117,47.681,122.38,1370,4998,85,0,3,2620,6248
5.355e+05,2015,413,3,2.5,2050,4976,2,0,0,3,8,2050,0,1994,1994,98029,47.569,122,2050,5153,21,0,5.5,4100,7203
3.83e+05,2014,353,3,1.5,1400,14850,1,0,0,4,7,1400,0,1910,1910,98070,47.447,122.46,1350,14850,104,0,4.5,2750,16250
5.47e+05,2014,170,5,2.5,2200,4080,1,0,0,5,7,1420,780,1916,1916,98103,47.687,122.35,1300,4080,98,0,7.5,3500,6280
8.48e+05,2015,396,3,2.75,2170,2738,1,0,0,4,9,1550,620,1930,1930,98109,47.639,122.35,1170,1062,85,0,5.75,3340,3232
2.7e+05,2014,154,3,2.25,2080,4252,1,0,0,3,7,1550,530,2003,2003,98042,47.42,122.16,2080,2275,11,0,5.25,4160,4355
6.3e+05,2014,127,2,2.25,2550,5663,1,0,0,3,10,1720,830,2011,2011,98056,47.53,122.2,2560,3828,3,0,4.25,5110,6378
3.35e+05,2014,143,4,2.5,1750,8476,1,0,0,4,7,1240,510,1983,1983,98058,47.445,122.14,1660,7875,31,0,6.5,3410,9625
5.99e+05,2014,127,3,1.75,1960,4788,1,0,0,4,7,1090,870,1920,1920,98115,47.675,122.31,1960,3960,94,0,4.75,3920,5920
3.8e+05,2014,191,2,1,1470,81021,1,0,0,4,6,1470,0,1949,1949,98027,47.477,122.03,2600,69696,65,0,3,4070,71166
5.7745e+05,2014,283,3,3,1730,1755,3,0,0,3,8,1730,0,2014,2014,98117,47.694,122.38,1830,1804,0,0,6,3560,3534
6.93e+05,2014,345,3,2.25,2120,13644,2,0,1,4,9,1420,700,1973,1973,98040,47.557,122.21,2950,17060,41,0,5.25,5070,19180
3.925e+05,2014,319,3,1.75,1540,8925,1,0,0,4,7,1540,0,1957,1957,98133,47.776,122.34,1620,10397,57,0,4.75,3160,11937
6.278e+05,2015,437,4,1.75,2010,12044,1,0,0,3,9,2010,0,1982,1982,98074,47.645,122.07,2200,11144,33,0,5.75,4210,13154
4.5445e+05,2015,477,4,3,2810,6000,2,0,0,3,9,2810,0,2007,2007,98038,47.369,122.06,2790,6000,8,0,7,5600,8810
2.1825e+05,2015,368,3,1,1270,7344,1,0,0,3,7,970,300,1967,1967,98023,47.305,122.37,1290,7300,48,0,4,2560,8570
6.7e+05,2014,162,3,2.5,2050,6420,1,0,3,3,8,1730,320,1956,1956,98116,47.571,122.41,2370,7620,58,0,5.5,4420,9670
5.4e+05,2014,194,2,1.75,1460,4800,1,0,0,5,7,850,610,1950,1950,98103,47.693,122.34,2050,5592,64,0,3.75,3510,7052
5e+05,2014,218,4,2.5,2590,9354,2,0,0,4,9,2590,0,1993,1993,98011,47.77,122.19,2730,9264,21,0,6.5,5320,11854
5.05e+05,2015,443,3,2.5,2100,17882,2,0,0,4,8,2100,0,1985,1985,98059,47.475,122.12,2080,16686,30,0,5.5,4180,18786
5e+05,2014,236,2,2.25,1570,1269,2,0,0,3,9,1280,290,2015,2015,98199,47.651,122.39,1570,6000,-1,0,4.25,3140,7570
4.3e+05,2014,173,2,1.5,950,4625,1,0,0,4,7,950,0,1949,1949,98103,47.691,122.34,1440,4625,65,0,3.5,2390,5575
6.99e+05,2014,237,3,2.5,2680,5497,2,0,0,3,9,2680,0,2001,2001,98052,47.704,122.13,2780,5497,13,0,5.5,5460,8177
5.45e+05,2014,166,3,2.5,1940,9775,1,0,2,3,8,1440,500,1975,1975,98034,47.714,122.22,2830,9775,39,0,5.5,4770,11715
3e+05,2015,443,3,1.75,1450,7620,1,0,0,4,7,1050,400,1955,1955,98166,47.457,122.35,1380,7620,60,0,4.75,2830,9070
3.6e+05,2014,283,2,1,930,6098,1,0,0,4,6,930,0,1919,1919,98027,47.529,122.03,1730,9000,95,0,3,2660,9930
3.4e+05,2014,360,3,2,1570,14992,1,0,0,3,8,1570,0,2001,2001,98014,47.697,121.92,1640,15000,13,0,5,3210,16570
3.3068e+05,2014,176,4,3,1930,3031,1,0,0,3,7,1200,730,2006,2006,98019,47.746,121.98,1930,2611,8,0,7,3860,4541
5.9487e+05,2014,273,3,3,2780,6000,2,0,0,3,9,2780,0,2013,2013,98065,47.518,121.89,2850,6000,1,0,6,5630,8780
3.82e+05,2015,456,2,2,1350,2560,1,0,0,4,8,1350,0,1974,1974,98052,47.634,122.11,1800,2560,41,0,4,3150,3910
6.95e+05,2014,245,3,3.25,3080,12100,2,0,0,3,8,2080,1000,1984,1984,98117,47.695,122.4,2100,6581,30,0,6.25,5180,9661
3.928e+05,2015,388,3,2,1080,11856,1,0,0,5,7,1080,0,1986,1986,98033,47.696,122.17,1220,9247,29,0,5,2300,10327
8.25e+05,2015,362,3,1.75,1930,8442,1,0,0,4,7,1930,0,1953,1953,98004,47.631,122.2,1790,8442,62,0,4.75,3720,10372
6.04e+05,2014,122,3,2.5,3240,33151,2,0,2,3,10,3240,0,1995,1995,98023,47.326,122.38,4050,24967,19,0,5.5,7290,28207
2.998e+05,2014,201,4,1.5,1530,9000,1,0,0,4,6,1530,0,1976,1976,98014,47.649,121.91,1520,8500,38,0,5.5,3050,10030
8.75e+05,2015,447,5,3.25,4230,21455,2,0,0,3,10,2720,1510,1990,1990,98074,47.638,122.02,3280,22393,25,0,8.25,7510,26623
6.92e+05,2015,447,4,2.5,2350,9779,1,0,0,3,10,2350,0,1987,1987,98074,47.641,122.06,2700,10441,28,0,6.5,5050,12791
2.12e+05,2014,236,4,1.75,1250,12705,1,0,0,4,7,1250,0,1971,1971,98023,47.302,122.38,1390,8550,43,0,5.75,2640,9800
3e+05,2015,451,6,2.5,2590,11250,1,0,0,4,8,1390,1200,1978,1978,98055,47.461,122.2,2270,8360,37,0,8.5,4860,10950
7.15e+05,2015,375,6,2.75,3400,5000,2,0,2,3,8,2860,540,1977,1977,98107,47.673,122.36,1800,5000,38,0,8.75,5200,8400
3.555e+05,2015,444,3,1,1120,10032,1,0,0,3,7,1120,0,1962,1962,98034,47.718,122.19,1210,9918,53,0,4,2330,11038
2.18e+05,2014,141,3,1,1020,7874,1,0,0,3,7,1020,0,1956,1956,98106,47.517,122.35,1290,7320,58,0,4,2310,8340
9.3e+05,2015,417,3,1.75,2460,4240,1,0,0,4,7,1230,1230,1925,1925,98103,47.659,122.34,1700,4240,90,0,4.75,4160,6700
9.65e+05,2014,280,4,3.25,5010,49222,2,0,0,5,9,3710,1300,1978,1978,98027,47.549,122.09,3140,54014,36,0,7.25,8150,59024
4.905e+05,2014,266,3,2,3000,21883,2,0,0,3,7,1970,1030,1998,1998,98011,47.76,122.21,2280,14025,16,0,5,5280,17025
5.0925e+05,2014,284,2,1.5,1480,3120,1,0,0,3,7,930,550,1914,2007,98105,47.668,122.32,1000,3780,100,1,3.5,2480,5260
4.542e+05,2015,460,4,2.5,2630,5379,2,0,0,3,8,2630,0,2004,2004,98059,47.498,122.16,2630,5379,11,0,6.5,5260,8009
3.3e+05,2014,133,3,2.5,1450,5008,1,0,0,3,7,840,610,2007,2007,98106,47.544,122.36,2120,5019,7,0,5.5,3570,6469
4.4e+05,2014,251,4,2.5,2990,7928,2,0,0,3,9,2990,0,2011,2011,98010,47.314,122.02,2810,7401,3,0,6.5,5800,10391
5.8e+05,2014,169,4,2.25,2160,9593,1,0,0,3,8,2160,0,1969,1969,98008,47.588,122.11,2820,9628,45,0,6.25,4980,11788
6e+05,2014,232,2,1.75,1550,7764,1,1,4,4,8,1550,0,1965,1986,98070,47.358,122.45,1690,11620,49,1,3.75,3240,13170
6.5e+05,2015,445,4,2.5,2630,28298,2,0,0,3,8,2630,0,1996,1996,98053,47.631,121.97,2840,26071,19,0,6.5,5470,28701
3.75e+05,2014,171,2,1,1230,1820,2,0,0,4,7,830,400,1948,1948,98107,47.668,122.4,1660,3056,66,0,3,2890,4286
1.9995e+05,2014,356,2,1,1010,10057,1,0,0,3,6,1010,0,1961,1961,98023,47.329,122.34,1040,8591,53,0,3,2050,9601
4.9995e+05,2014,163,3,1,1830,3000,1,0,0,3,7,1430,400,1926,1926,98103,47.662,122.35,1510,2500,88,0,4,3340,4330
3.475e+05,2014,280,4,2.5,1970,7098,2,0,0,3,7,1970,0,2007,2007,98038,47.358,122.06,1970,5361,7,0,6.5,3940,7331
2.65e+05,2014,202,3,1.75,2200,7200,1,0,0,3,8,1270,930,1962,1962,98032,47.374,122.28,1800,8000,52,0,4.75,4000,10200
3.78e+05,2014,313,3,1.5,1000,6914,1,0,0,3,7,1000,0,1947,1947,98125,47.714,122.32,1000,6947,67,0,4.5,2000,7947
5.28e+05,2015,480,3,2,1560,6300,1,0,0,3,7,1560,0,1924,1924,98126,47.541,122.38,1620,6300,91,0,5,3180,7860
4.99e+05,2014,128,2,1.5,1110,957,2,0,0,3,8,930,180,2005,2005,98119,47.632,122.36,1680,1104,9,0,3.5,2790,2214
6.36e+05,2014,128,2,1.75,1230,3600,1,0,0,5,7,1230,0,1925,1925,98119,47.642,122.36,1210,4500,89,0,3.75,2440,5730
4.5995e+05,2015,464,4,2,2760,21465,1,0,0,4,9,2120,640,1979,1979,98042,47.382,122.17,2550,13144,36,0,6,5310,15904
7e+05,2014,313,4,2.5,2580,15031,2,0,0,3,9,2580,0,1999,1999,98052,47.69,122.09,3030,10361,15,0,6.5,5610,12941
5.295e+05,2015,424,3,2.25,1410,905,3,0,0,3,9,1410,0,2014,2014,98116,47.582,122.4,1510,1352,1,0,5.25,2920,2762
5.59e+05,2014,251,3,2.5,2010,5200,2,0,0,3,8,2010,0,1989,1989,98034,47.714,122.2,1860,4400,25,0,5.5,3870,6410
3.9995e+05,2014,359,3,1,1040,9600,1,0,0,3,7,1040,0,1978,1978,98053,47.674,122.06,1370,10889,36,0,4,2410,11929
6.35e+05,2014,180,3,2.5,3350,4007,2,0,0,3,8,2550,800,2005,2005,98034,47.728,122.21,2340,4167,9,0,5.5,5690,7517
3.55e+05,2014,298,2,1,2020,6720,1,0,0,3,7,1010,1010,1948,1948,98118,47.547,122.29,1720,6720,66,0,3,3740,8740
4.4e+05,2014,191,3,1.75,1450,6829,1,0,0,3,8,1450,0,1983,1983,98052,47.722,122.11,1950,7622,31,0,4.75,3400,9072
4.39e+05,2014,271,2,1,800,5100,1,0,0,3,7,800,0,1945,1945,98117,47.678,122.39,1330,5100,69,0,3,2130,5900
7.1e+05,2014,206,4,1.75,2700,7625,1,0,0,4,8,1450,1250,1937,1937,98115,47.684,122.32,1760,3300,77,0,5.75,4460,6000
2.55e+05,2015,375,3,1,1440,11330,1,0,0,3,7,1440,0,1965,1965,98168,47.474,122.27,1580,10100,50,0,4,3020,11540
8.35e+05,2014,224,3,2.25,2520,6690,2,0,2,5,8,1700,820,1944,1990,98126,47.571,122.38,1990,5792,70,1,5.25,4510,8312
9.5e+05,2015,464,4,3,2420,4800,1,0,0,3,7,1520,900,1919,1919,98119,47.645,122.36,1090,3800,96,0,7,3510,6220
2.3e+06,2014,218,7,4.75,5310,8816,2,0,0,3,10,3650,1660,2013,2013,98004,47.622,122.21,2920,10610,1,0,11.75,8230,15920
3.505e+05,2014,221,3,2.25,1870,7200,1,0,0,3,7,1390,480,1975,1975,98072,47.734,122.17,1830,7876,39,0,5.25,3700,9746
5.45e+05,2015,423,4,3.25,4386,12275,1,0,0,3,10,2356,2030,2006,2006,98092,47.333,122.2,3060,10925,9,0,7.25,7446,15311
3.75e+05,2014,271,4,2.5,2250,5306,2,0,0,3,8,2250,0,2012,2012,98038,47.356,122.06,2250,5306,2,0,6.5,4500,7556
4.025e+05,2015,480,3,2.25,2160,9540,2,0,0,3,8,2160,0,1979,1979,98028,47.767,122.24,1720,12593,36,0,5.25,3880,14753
5.39e+05,2014,249,3,1.75,1790,9860,1,0,0,4,7,1410,380,1978,1978,98052,47.699,122.12,1820,9555,36,0,4.75,3610,11345
1.8e+05,2014,142,3,1,870,5330,1,0,0,3,6,870,0,1969,2014,98042,47.369,122.08,840,5200,45,1,4,1710,6070
4.521e+05,2015,478,4,2.5,3160,6540,1,0,3,3,8,1580,1580,1959,1959,98178,47.504,122.24,1990,7090,56,0,6.5,5150,10250
2.5e+05,2014,154,4,2,2120,8701,1,0,0,4,7,2120,0,1960,1960,98198,47.372,122.31,1720,8527,54,0,6,3840,10647
4.77e+05,2014,170,3,1.75,1780,8085,1,0,0,3,7,1210,570,1976,1976,98011,47.736,122.2,1780,8085,38,0,4.75,3560,9865
5.9e+05,2014,202,3,2.25,2300,12430,1,0,2,4,8,1580,720,1960,1960,98166,47.435,122.35,2500,12430,54,0,5.25,4800,14730
4.01e+05,2014,266,3,1,1120,8321,1,0,0,4,6,1120,0,1941,1987,98027,47.563,122.09,1980,8671,73,1,4,3100,9791
1.898e+06,2015,437,3,2.5,2830,4334,3,1,4,3,10,2830,0,2006,2006,98074,47.632,122.07,2830,38211,9,0,5.5,5660,41041
4.9e+05,2014,231,3,2.25,1280,1520,2,0,0,3,8,1080,200,2008,2008,98107,47.665,122.37,1280,1681,6,0,5.25,2560,2961
3.4e+05,2015,460,3,1.75,1740,46580,1,0,0,4,7,1740,0,1980,1980,98010,47.358,121.93,1576,54685,35,0,4.75,3316,56425
6.085e+05,2015,482,4,3.5,2850,5577,2,0,0,3,8,1950,900,2014,2014,98056,47.525,122.19,2850,5708,1,0,7.5,5700,8558
5e+05,2014,201,3,2.5,2410,34848,1,0,0,3,8,2410,0,1976,1976,98006,47.569,122.12,2420,16424,38,0,5.5,4830,18834
4.1e+05,2015,389,3,2.5,2350,4456,2,0,0,3,7,2350,0,2004,2004,98065,47.531,121.85,2350,4456,11,0,5.5,4700,6806
4.85e+05,2015,413,3,2.25,1570,8111,2,0,0,3,8,1570,0,1984,1984,98074,47.632,122.03,1990,7875,31,0,5.25,3560,9445
2.25e+05,2014,237,3,2,1320,5665,1,0,0,3,7,1320,0,1986,1986,98023,47.31,122.36,1336,7080,28,0,5,2656,8400
2.5e+05,2014,252,4,2.5,2040,5770,2,0,0,3,7,2040,0,1994,1994,98038,47.352,122.06,1570,6753,20,0,6.5,3610,8793
1.195e+06,2015,436,3,2.25,3070,9645,2,0,0,3,10,2110,960,1987,1987,98006,47.552,122.14,3130,9450,28,0,5.25,6200,12520
5.9e+05,2014,211,3,2.75,2550,54014,2,0,0,4,8,1980,570,1967,1967,98072,47.76,122.12,2180,21600,47,0,5.75,4730,24150
5.05e+05,2014,175,3,1.75,1640,10695,1,0,2,3,8,1640,0,1975,1975,98034,47.715,122.22,2790,9775,39,0,4.75,4430,11415
5.5e+05,2015,436,3,1.75,1440,8957,1,0,0,4,7,1440,0,1957,1957,98008,47.601,122.12,1340,8780,58,0,4.75,2780,10220
5.9e+05,2015,467,2,2.5,1450,1281,2,0,0,3,8,1220,230,2006,2006,98105,47.665,122.28,1440,1281,9,0,4.5,2890,2731
3.8e+05,2014,228,3,2,1840,8580,1,0,0,3,8,1840,0,1990,1990,98058,47.463,122.13,2190,8580,24,0,5,4030,10420
2.8879e+05,2014,317,4,2,1390,745,3,0,0,3,7,1390,0,2008,2008,98027,47.54,122.03,1390,942,6,0,6,2780,2332
3.4178e+05,2015,416,4,2.75,2260,4440,2,0,0,3,7,2260,0,2014,2014,98001,47.351,122.29,2260,4563,1,0,6.75,4520,6823
5.115e+05,2014,170,4,1,1360,6000,1,0,0,3,7,1360,0,1917,1917,98115,47.685,122.29,1710,6000,97,0,5,3070,7360
3.3e+05,2015,390,4,1.5,1890,7540,1,0,0,4,7,1890,0,1967,1967,98155,47.753,122.32,1890,8515,48,0,5.5,3780,10405
3.999e+05,2014,181,4,2.5,2701,4500,2,0,0,3,9,2701,0,2014,2014,98092,47.259,122.19,2570,4800,0,0,6.5,5271,7501
1.095e+06,2014,238,3,2.5,2550,5100,2,0,0,3,9,2550,0,2014,2014,98115,47.676,122.33,1250,4080,0,0,5.5,3800,6630
6e+05,2014,310,2,1,1110,3500,1,0,0,3,6,970,140,1912,1912,98102,47.645,122.33,1884,1778,102,0,3,2994,2888
8.31e+05,2014,125,4,3,2170,4000,2,0,0,4,9,1610,560,1982,2011,98112,47.62,122.29,1670,4000,32,1,7,3840,6170
7.25e+05,2015,445,4,2.5,3270,6055,2,0,0,3,9,3270,0,2007,2007,98056,47.537,122.19,2740,7367,8,0,6.5,6010,10637
4.75e+05,2014,338,3,1,1470,9750,1,0,0,3,7,1470,0,1963,1963,98034,47.715,122.19,1300,9750,51,0,4,2770,11220
3.47e+05,2015,457,3,1.75,1330,7848,1,0,0,3,8,1330,0,1978,1978,98058,47.446,122.13,2110,8497,37,0,4.75,3440,9827
2.645e+05,2014,183,4,2.25,2060,11385,1,0,0,4,7,1200,860,1962,1962,98023,47.314,122.36,2110,11385,52,0,6.25,4170,13445
4.15e+05,2014,278,3,1,1510,6083,1,0,0,4,6,860,650,1940,1940,98115,47.697,122.32,1510,5712,74,0,4,3020,7222
2.805e+05,2015,408,3,2.25,1620,7566,2,0,0,3,7,1620,0,1990,1990,98038,47.357,122.04,1470,7566,25,0,5.25,3090,9186
3.85e+05,2015,429,3,1.75,1200,7360,1,0,0,4,7,1200,0,1978,1978,98052,47.698,122.13,1200,7500,37,0,4.75,2400,8700
5.5e+05,2014,352,4,2,1540,5000,1,0,0,4,7,1540,0,1913,1913,98105,47.671,122.3,1790,4000,101,0,6,3330,5540
3.28e+05,2015,403,5,2.25,2240,9652,2,0,0,3,7,2240,0,1990,1990,98055,47.425,122.21,2180,11644,25,0,7.25,4420,13884
4.35e+05,2015,478,2,1,790,11234,1,0,0,4,6,790,0,1942,1942,98166,47.441,122.35,1930,11871,73,0,3,2720,12661
2.245e+05,2014,307,3,1.75,1300,7735,1,0,0,4,7,1300,0,1980,1980,98022,47.198,122,1300,8941,34,0,4.75,2600,10241
4.199e+05,2014,209,4,2.5,2750,5767,2,0,0,3,9,2750,0,2005,2005,98038,47.359,122.04,2800,5376,9,0,6.5,5550,8126
7.28e+05,2014,233,4,2.5,2650,13684,2,0,0,3,9,2650,0,1994,1994,98052,47.628,122.11,2650,12032,20,0,6.5,5300,14682
1.57e+05,2014,318,1,1,870,26326,1,0,0,3,6,870,0,1939,1939,98198,47.415,122.3,1250,10608,75,0,2,2120,11478
4.35e+05,2015,409,3,1,940,7590,1,0,0,4,6,940,0,1959,1959,98008,47.623,122.12,1250,7590,56,0,4,2190,8530
5.175e+05,2015,485,3,2.5,1800,3933,2,0,0,3,8,1800,0,1989,1989,98029,47.575,122.01,1800,4659,26,0,5.5,3600,6459
1.995e+05,2014,334,3,1.75,1160,5200,1,0,0,4,7,1160,0,1977,1977,98042,47.364,122.09,1470,5200,37,0,4.75,2630,6360
2.66e+05,2014,134,3,2.5,1780,7214,1,0,0,4,7,1400,380,1986,1986,98030,47.367,122.18,1520,7228,28,0,5.5,3300,9008
4.12e+05,2014,231,2,1,910,6282,1,0,0,4,7,910,0,1939,1939,98103,47.697,122.35,970,6281,75,0,3,1880,7191
5.97e+05,2014,243,2,1.75,2470,4600,1,0,3,4,7,1140,1330,1916,1916,98126,47.56,122.38,1790,5175,98,0,3.75,4260,7645
5.5e+05,2014,152,3,2.5,1840,3035,1,0,0,3,7,920,920,1926,1926,98105,47.656,122.33,1780,4000,88,0,5.5,3620,5840
5.575e+05,2015,445,3,2,2510,35255,1,0,2,3,9,2510,0,1994,1994,98038,47.401,122.03,3140,36450,21,0,5,5650,38960
2.45e+05,2015,429,3,1.75,1670,24650,1,0,0,4,7,1670,0,1974,1974,98022,47.176,122.03,1810,19465,41,0,4.75,3480,21135
6.2e+05,2015,381,4,2.25,2210,8101,2,0,0,3,9,2210,0,1985,1985,98074,47.648,122.07,2330,8842,30,0,6.25,4540,11052
3.09e+05,2014,189,3,2.25,1980,8755,1,0,0,4,7,1300,680,1963,1963,98198,47.392,122.32,2030,8671,51,0,5.25,4010,10651
6.7e+05,2014,173,3,2.5,3310,5300,2,0,2,3,8,2440,870,2008,2008,98136,47.518,122.39,2140,7500,6,0,5.5,5450,10810
1.086e+06,2015,399,3,3,2830,6041,2,0,3,3,8,1840,990,1915,1915,98118,47.569,122.28,3420,6360,100,0,6,6250,9190
1.225e+06,2014,298,4,2.5,3120,49456,2,1,4,4,9,2590,530,1974,1989,98198,47.353,122.32,2030,32181,40,1,6.5,5150,35301
2.84e+05,2015,426,4,3,2040,7145,1,0,0,3,8,1490,550,1994,1994,98092,47.328,122.17,1940,7145,21,0,7,3980,9185
1.99e+05,2015,407,2,1,1140,15120,1,0,0,4,6,990,150,1932,1932,98055,47.452,122.2,2320,11250,83,0,3,3460,12390
4.34e+05,2014,202,3,2.75,1830,3200,2,0,0,3,8,1830,0,1991,1991,98034,47.715,122.22,2030,3331,23,0,5.75,3860,5161
3.465e+05,2014,291,3,3.25,1570,2048,2,0,0,3,8,1290,280,2006,2006,98126,47.548,122.38,1570,2006,8,0,6.25,3140,3576
2.1e+05,2014,215,2,2,1190,7570,1,0,0,3,6,1190,0,1939,1939,98146,47.511,122.34,1190,7635,75,0,4,2380,8825
7.8e+05,2015,484,3,2.75,2910,3094,2,0,2,5,7,2010,900,1939,1939,98125,47.707,122.28,2400,7530,76,0,5.75,5310,10440
1.5576e+06,2015,457,4,2.5,2700,17853,2,0,0,4,9,2700,0,1960,1960,98004,47.646,122.22,3790,16672,55,0,6.5,6490,19372
4.5e+05,2014,189,3,2.5,1460,7573,2,0,0,3,8,1460,0,1983,1983,98007,47.601,122.14,1910,7668,31,0,5.5,3370,9128
6.3e+05,2014,270,4,2.5,2540,11100,1,0,0,5,7,2540,0,1957,1957,98008,47.632,122.12,1560,11100,57,0,6.5,4100,13640
3.61e+05,2014,142,3,1,1100,4046,1,0,4,4,6,1100,0,1922,1922,98198,47.344,122.33,2550,7847,92,0,4,3650,8947
3.45e+05,2014,306,4,2.5,2020,3600,2,0,0,3,7,2020,0,2012,2012,98038,47.353,122.02,2210,3800,2,0,6.5,4230,5820
6.155e+05,2015,389,3,1.5,1810,5080,1,0,0,3,7,1030,780,1958,1958,98115,47.682,122.29,1780,7620,57,0,4.5,3590,9430
3.58e+05,2014,326,5,2.5,2390,8775,1,0,0,4,7,1270,1120,1980,1980,98058,47.464,122.17,1800,8000,34,0,7.5,4190,10390
1.165e+06,2014,196,3,2.5,2670,5000,2,0,3,5,9,2000,670,1942,1995,98144,47.586,122.29,2320,5000,72,1,5.5,4990,7670
4.67e+05,2014,191,2,2.5,1140,1181,3,0,0,3,8,1140,0,2007,2007,98107,47.671,122.38,1220,1189,7,0,4.5,2360,2329
6.8468e+05,2014,158,4,2.25,2370,9360,2,0,0,4,8,2370,0,1979,1979,98052,47.652,122.12,2370,9720,35,0,6.25,4740,12090
2.32e+05,2014,266,3,1.75,1290,6604,1,0,0,3,7,1290,0,1984,1984,98023,47.323,122.35,1440,6682,30,0,4.75,2730,7972
6.95e+05,2014,160,3,2.5,2550,45254,2,0,0,3,9,2550,0,2001,2001,98053,47.65,121.96,2190,49222,13,0,5.5,4740,51772
9.98e+05,2014,346,4,2.25,2910,10189,2,0,0,3,9,2910,0,1988,1988,98006,47.547,122.16,2780,10125,26,0,6.25,5690,13035
4.22e+05,2015,482,4,2.5,3200,6691,2,0,0,3,7,3200,0,2002,2002,98038,47.367,122.03,2610,6510,13,0,6.5,5810,9710
3.25e+05,2015,477,2,1.5,940,1222,2,0,0,3,7,860,80,2004,2004,98125,47.718,122.32,1302,1840,11,0,3.5,2242,2780
3.2e+05,2014,153,3,2,1880,10758,1,0,0,5,6,940,940,1952,1952,98059,47.509,122.14,2060,21000,62,0,5,3940,22880
3.9e+05,2015,439,2,1,1140,8147,1,0,0,3,7,1140,0,1958,1958,98125,47.728,122.29,1260,8148,57,0,3,2400,9288
3.475e+05,2015,416,5,3,2230,6551,1,0,0,3,7,1330,900,2014,2014,98168,47.487,122.32,2230,9476,1,0,8,4460,11706
3.71e+05,2014,291,3,2.5,2150,8361,2,0,0,3,8,2150,0,1991,1991,98058,47.463,122.13,2150,9368,23,0,5.5,4300,11518
3.649e+05,2014,159,3,3,2500,8304,2,0,0,3,8,2500,0,1997,1997,98031,47.402,122.17,2290,7855,17,0,6,4790,10355
1.255e+06,2015,459,4,2.5,3510,13100,2,0,0,4,10,3510,0,1966,1966,98040,47.531,122.23,3230,12745,49,0,6.5,6740,16255
9.2e+05,2014,359,4,2.5,3550,10233,2,0,0,3,9,3550,0,1996,1996,98027,47.55,122.1,3310,9157,18,0,6.5,6860,12707
4.93e+05,2014,312,3,2.25,1790,11393,1,0,0,3,8,1790,0,1978,1978,98052,47.63,122.1,2290,11894,36,0,5.25,4080,13684
5.5225e+05,2014,198,4,2.5,2580,5823,2,0,0,3,8,2580,0,2002,2002,98065,47.537,121.88,2380,5823,12,0,6.5,4960,8403
9.5e+05,2014,321,4,2.5,3700,7051,2,0,0,3,11,3700,0,2006,2006,98029,47.543,122,3580,6175,8,0,6.5,7280,9875
6.525e+05,2014,165,4,2.5,2700,9122,2,0,0,3,9,2700,0,1990,1990,98029,47.577,121.99,2500,9122,24,0,6.5,5200,11822
4.45e+05,2015,424,2,1,910,7200,1,0,1,4,7,830,80,1936,1936,98136,47.514,122.39,1700,7200,79,0,3,2610,8110
3.825e+05,2014,270,4,2.5,2980,8786,2,0,0,3,8,2980,0,2003,2003,98038,47.378,122.03,2980,6718,11,0,6.5,5960,9698
9.899e+05,2014,338,5,2.25,3320,11350,1,0,0,5,8,1660,1660,1963,1963,98040,47.575,122.21,3320,11085,51,0,7.25,6640,14405
7.3499e+05,2014,169,4,2.5,2650,6884,2,0,0,3,8,2650,0,2012,2012,98053,47.69,122.02,2520,5866,2,0,6.5,5170,8516
3.3989e+05,2014,344,3,1,1040,7490,1,0,0,3,7,1040,0,1969,1969,98034,47.714,122.21,1520,7410,45,0,4,2560,8450
6.98e+05,2015,459,3,1.75,1220,7447,1,0,0,4,7,1220,0,1964,1964,98033,47.689,122.21,1340,7200,51,0,4.75,2560,8420
4.2995e+05,2015,467,3,2.25,2060,10160,1,0,0,4,8,1340,720,1967,1967,98155,47.771,122.28,2320,11186,48,0,5.25,4380,13246
6.5995e+05,2014,342,5,3,3010,7357,2,0,0,3,9,3010,0,2008,2008,98133,47.723,122.33,2370,8050,6,0,8,5380,11060
5.35e+05,2014,190,5,3.25,2850,4551,2,0,0,3,8,2370,480,2006,2006,98059,47.492,122.14,2850,4849,8,0,8.25,5700,7699
4.458e+05,2014,284,3,2,1320,6500,1,0,0,3,7,1320,0,1947,1947,98125,47.712,122.32,1110,6592,67,0,5,2430,7912
5.6695e+05,2014,250,3,3,1730,1902,3,0,0,3,8,1730,0,2014,2014,98117,47.694,122.38,1830,1804,0,0,6,3560,3534
2.9e+05,2015,486,3,2.5,1600,6848,2,0,0,3,7,1600,0,2000,2000,98001,47.33,122.27,1700,7210,15,0,5.5,3300,8810
5.9589e+05,2014,175,3,1.75,1870,9000,1,0,0,5,9,1870,0,1958,1958,98177,47.72,122.36,2030,8160,56,0,4.75,3900,10030
5.2e+05,2015,410,4,2.5,3060,7161,2,0,0,3,8,2860,200,2005,2005,98065,47.538,121.88,2950,6822,10,0,6.5,6010,9882
2.49e+05,2015,432,3,1.5,1700,8247,1,0,0,3,7,1010,690,1970,1970,98031,47.422,122.17,1440,8400,45,0,4.5,3140,10100
4.2e+05,2014,326,5,2.75,2540,27007,1,0,0,3,8,1520,1020,1980,2014,98058,47.433,122.16,1800,26572,34,1,7.75,4340,29112
5.7212e+05,2014,311,4,3.25,3230,4838,2,0,0,3,9,3230,0,2014,2014,98038,47.356,122.02,2980,5094,0,0,7.25,6210,8324
3.399e+05,2014,178,3,1,1200,9087,1,0,0,5,7,1200,0,1969,1969,98056,47.523,122.18,1250,11826,45,0,4,2450,13026
2.8695e+05,2015,426,4,2.5,2080,9846,1,0,0,3,7,1240,840,1984,1984,98001,47.334,122.27,1890,7977,31,0,6.5,3970,10057
4.55e+05,2014,263,4,2.5,2440,5001,2,0,0,3,8,2440,0,2005,2005,98056,47.511,122.19,2260,5001,9,0,6.5,4700,7441
2.1e+05,2015,486,3,2.5,1610,6732,2,0,0,3,7,1610,0,1994,1994,98030,47.366,122.17,1680,7414,21,0,5.5,3290,9024
3.46e+05,2014,309,3,1.75,1590,9636,1,0,0,4,6,1590,0,1953,1953,98155,47.754,122.32,1800,9975,61,0,4.75,3390,11565
2.1e+05,2014,139,3,1,1080,21043,1,0,0,3,6,1080,0,1942,1942,98106,47.551,122.36,1380,7620,72,0,4,2460,8700
5.92e+05,2014,190,5,3.5,3340,5000,2,0,0,3,8,2580,760,2012,2012,98065,47.517,121.87,3420,5000,2,0,8.5,6760,8340
3.45e+05,2015,437,4,1.5,1540,7168,1,0,0,3,7,1160,380,1964,1964,98055,47.455,122.2,1540,7176,51,0,5.5,3080,8716
1.95e+05,2014,306,3,1.75,1190,14777,1,0,0,4,7,1190,0,1965,1965,98023,47.293,122.38,2240,8325,49,0,4.75,3430,9515
2.785e+05,2015,432,3,1.75,1390,8980,1,0,0,4,8,1390,0,1985,1985,98022,47.202,122,1770,9085,30,0,4.75,3160,10475
4.49e+05,2014,292,4,2.25,2230,8440,2,0,0,4,8,2230,0,1968,1968,98011,47.756,122.22,2160,9412,46,0,6.25,4390,11642
4.2e+05,2014,243,2,1,930,5368,1,0,0,4,7,930,0,1953,1953,98115,47.695,122.28,1770,6000,61,0,3,2700,6930
3.3e+05,2014,278,2,1,880,1753,2,0,0,4,7,880,0,1945,1945,98199,47.648,122.4,1010,1748,69,0,3,1890,2628
5.7855e+05,2015,443,3,2.5,2120,6602,2,0,0,4,8,2120,0,1989,1989,98029,47.567,122.01,2330,7795,26,0,5.5,4450,9915
7.2e+05,2015,383,4,4,3200,7708,2,0,0,3,10,3200,0,2004,2004,98075,47.582,121.97,3480,7944,11,0,8,6680,11144
2.175e+05,2014,181,3,1.75,1400,9546,1,0,0,4,7,1400,0,1984,1984,98003,47.318,122.33,1660,8550,30,0,4.75,3060,9950
9.75e+05,2014,153,4,2.25,2290,5350,2,0,0,4,9,2120,170,1958,1958,98199,47.643,122.41,2910,5350,56,0,6.25,5200,7640
4.04e+05,2015,422,3,1,1420,8160,1,0,0,3,7,970,450,1947,1947,98125,47.716,122.31,1340,8160,68,0,4,2760,9580
3.135e+05,2015,474,2,1.5,1270,1282,2,0,0,3,8,1000,270,2006,2006,98106,47.558,122.36,1270,1325,9,0,3.5,2540,2595
4.56e+05,2014,155,4,1.75,1670,9886,1,0,0,5,7,1670,0,1947,1947,98125,47.725,122.29,2590,9997,67,0,5.75,4260,11667
6.165e+05,2015,487,3,2,2080,4549,1,0,0,5,7,1040,1040,1954,1954,98115,47.689,122.31,1620,4549,61,0,5,3700,6629
5.8e+05,2014,194,3,2.5,3200,18750,1,0,0,2,9,2660,540,1967,1996,98027,47.572,122.12,3200,22475,47,1,5.5,6400,25675
1.17e+06,2015,452,5,2.75,3090,12031,1,0,0,5,9,1600,1490,1968,1968,98040,47.534,122.23,2280,10800,47,0,7.75,5370,13890
4.6e+05,2014,312,4,2.5,2080,17532,2,0,0,3,9,2080,0,1996,1996,98059,47.483,122.14,2550,12560,18,0,6.5,4630,14640
4.1995e+05,2014,217,4,2.5,2260,5164,2,0,0,3,8,2260,0,1996,1996,98056,47.509,122.17,2260,5866,18,0,6.5,4520,8126
3.6e+05,2014,238,3,1.75,1830,10000,2,0,0,4,7,1830,0,1913,1964,98019,47.741,121.98,1480,10000,101,1,4.75,3310,11830
2.75e+05,2015,478,5,2,2260,11970,1,0,0,4,7,1250,1010,1962,1962,98031,47.39,122.22,1950,11970,53,0,7,4210,14230
8.05e+05,2015,386,5,3,2240,18265,2,0,0,4,8,2240,0,1963,1963,98027,47.517,122.03,1990,18265,52,0,8,4230,20505
5.88e+05,2015,414,3,1,1910,8167,1,0,0,4,8,1270,640,1951,1951,98117,47.7,122.37,1500,6816,64,0,4,3410,8726
3.815e+05,2014,175,2,1,900,2910,1,0,0,5,7,900,0,1924,1924,98115,47.686,122.32,1320,2910,90,0,3,2220,3810
4.8e+05,2014,339,5,3,2240,15435,1,0,1,5,7,1390,850,1952,1952,98155,47.743,122.29,2240,10750,62,0,8,4480,12990
3.33e+05,2014,266,4,2.5,2100,7366,2,0,0,3,8,2100,0,1997,1997,98042,47.37,122.11,2060,7324,17,0,6.5,4160,9424
3.5e+05,2014,173,7,3,2800,9569,1,0,2,3,7,1400,1400,1963,1963,98056,47.51,122.18,2150,7333,51,0,10,4950,10133
9.89e+05,2014,189,5,4.5,4030,13474,2,0,0,3,11,4030,0,2000,2000,98075,47.581,122,3860,12438,14,0,9.5,7890,16468
8.35e+05,2014,203,4,3,4480,42717,2,0,0,3,9,4480,0,1987,1987,98077,47.771,122.09,3140,41632,27,0,7,7620,46112
6e+05,2015,387,2,1,1290,4636,1,0,0,3,7,1290,0,1924,1924,98112,47.639,122.3,1940,4635,91,0,3,3230,5925
3.85e+05,2014,210,3,3.5,1900,4805,2,0,0,3,8,1560,340,1999,1999,98108,47.569,122.31,1360,4800,15,0,6.5,3260,6700
3.25e+05,2014,354,2,1,960,4800,1,0,0,2,6,960,0,1912,1912,98116,47.575,122.41,1440,4800,102,0,3,2400,5760
9.6e+05,2014,148,4,2.25,2410,4560,2,0,2,5,9,1800,610,1929,1929,98117,47.68,122.4,2150,5100,85,0,6.25,4560,7510
5.411e+05,2015,436,4,2.25,2510,9800,2,0,0,3,9,2510,0,1978,1978,98072,47.753,122.14,2440,11000,37,0,6.25,4950,13510
5.8e+05,2014,215,5,3.25,3030,7410,2,0,0,3,8,2150,880,2014,2014,98106,47.553,122.35,2020,7410,0,0,8.25,5050,10440
9.955e+05,2014,215,5,4.5,4280,8465,2,0,0,3,10,4280,0,2014,2014,98034,47.733,122.17,2990,11067,0,0,9.5,7270,15347
4.7e+05,2014,236,4,2.75,2150,9820,1,0,0,4,8,1220,930,1979,1979,98011,47.776,122.2,2060,9830,35,0,6.75,4210,11980
3.2e+05,2014,257,3,2.5,1680,4584,2,0,0,3,7,1680,0,2003,2003,98056,47.479,122.18,2160,4621,11,0,5.5,3840,6301
5.5e+05,2014,248,3,2.75,2230,14400,1,0,0,4,8,1460,770,1977,1977,98075,47.579,122.05,2200,13280,37,0,5.75,4430,15510
3.7e+05,2014,162,2,1,1220,17172,1,0,0,4,6,1220,0,1947,1947,98033,47.693,122.16,1510,12915,67,0,3,2730,14135
3.78e+05,2015,485,4,1,1300,6075,1,0,0,5,7,1300,0,1954,1954,98133,47.773,122.35,1450,7320,61,0,5,2750,8620
7.3e+05,2014,202,4,2.5,3550,35689,2,0,0,4,9,3550,0,1991,1991,98077,47.75,122.07,3350,35711,23,0,6.5,6900,39261
4.9e+05,2015,412,2,1,1760,5250,1,0,2,4,7,1000,760,1951,1951,98126,47.558,122.38,1760,5400,64,0,3,3520,7160
4.05e+05,2015,479,3,1.5,1240,9975,1,0,0,3,6,1240,0,1977,1977,98024,47.567,121.91,1390,10735,38,0,4.5,2630,11975
2.7e+05,2014,129,3,1.5,1500,6337,1,0,0,5,7,1500,0,1953,1953,98125,47.728,122.31,1420,6337,61,0,4.5,2920,7837
2.95e+05,2014,317,4,2.5,1810,4871,2,0,0,3,8,1810,0,1999,1999,98031,47.409,122.19,1850,5003,15,0,6.5,3660,6813
9.5975e+05,2014,310,4,3,3060,50002,1,0,2,4,8,2460,600,1957,1957,98008,47.62,122.1,2740,16181,57,0,7,5800,19241
1.615e+05,2014,342,3,1,1220,6000,1,0,0,5,7,1220,0,1961,1961,98002,47.281,122.21,1420,13137,53,0,4,2640,14357
2.15e+05,2014,202,4,1.75,1610,9652,1,0,0,5,7,1610,0,1969,1969,98042,47.328,122.14,1220,9800,45,0,5.75,2830,11410
2.15e+05,2014,163,2,1,710,7200,1,0,0,3,6,710,0,1943,1943,98178,47.49,122.25,960,7200,71,0,3,1670,7910
2.05e+05,2014,334,3,1.75,1420,6980,1,0,0,5,7,820,600,1980,1980,98023,47.287,122.37,1470,7319,34,0,4.75,2890,8739
6.55e+05,2014,216,4,1.75,2540,7620,1,0,3,3,8,1320,1220,1948,1948,98116,47.571,122.41,2540,8613,66,0,5.75,5080,11153
3.25e+05,2015,432,4,1.75,1670,9500,1,0,0,3,7,1670,0,1976,1976,98125,47.725,122.31,1620,9500,39,0,5.75,3290,11170
2.8995e+05,2015,382,4,3,2040,5050,1,0,0,3,8,1490,550,1993,1993,98092,47.327,122.17,2020,6118,22,0,7,4060,8158
9.4e+05,2014,142,4,2.75,2080,4000,1,0,0,3,8,2080,0,1912,2000,98107,47.674,122.36,1730,5000,102,1,6.75,3810,7080
4.6e+05,2014,143,3,1,1670,4005,1,0,0,4,7,1170,500,1939,1939,98117,47.688,122.38,1240,4005,75,0,4,2910,5675
3.2495e+05,2014,154,3,1,1210,7440,1,0,0,3,7,1210,0,1949,1949,98155,47.74,122.32,1120,7440,65,0,4,2330,8650
7.29e+05,2015,474,3,1.5,1770,30689,1,0,4,3,9,1770,0,1953,1953,98177,47.765,122.37,2650,30280,62,0,4.5,4420,32050
2.2e+05,2014,342,5,2.5,1760,10200,1,0,0,3,6,1760,0,1925,1925,98106,47.527,122.35,1370,7620,89,0,7.5,3130,9380
7.04e+05,2014,265,4,2.75,2510,12500,1,0,0,5,8,2050,460,1976,1976,98052,47.628,122.11,2200,12088,38,0,6.75,4710,14598
3.06e+05,2014,189,3,1,1450,7200,1,0,0,3,7,1010,440,1969,1969,98034,47.731,122.2,1500,6767,45,0,4,2950,8217
9.6e+05,2014,153,4,3,4590,9150,2,0,0,3,10,3490,1100,1981,1981,98177,47.723,122.37,2910,12348,33,0,7,7500,16938
1.9e+05,2014,360,3,1.5,760,40039,1,0,0,3,6,760,0,1906,1906,98065,47.529,121.83,980,6000,108,0,4.5,1740,6760
6e+05,2014,287,4,2.5,2310,3866,2,0,0,3,8,2310,0,2005,2005,98029,47.55,122,1950,4023,9,0,6.5,4260,6333
2.8995e+05,2014,291,3,1,1090,8280,1,0,0,3,6,1090,0,1947,2006,98155,47.756,122.32,1060,7609,67,1,4,2150,8699
5.3e+05,2014,276,2,1.5,1390,5000,1,0,0,4,8,970,420,1954,1954,98116,47.567,122.4,1610,5000,60,0,3.5,3000,6390
3.55e+05,2015,445,4,1,1410,7693,1,0,0,4,7,1410,0,1953,1953,98133,47.76,122.33,1330,8395,62,0,5,2740,9805
5.49e+05,2014,270,3,2.25,1230,1380,3,0,0,3,8,1230,0,2013,2013,98199,47.652,122.4,1760,5664,1,0,5.25,2990,6894
6.1e+05,2014,292,3,1,1180,3400,1,0,0,3,8,1180,0,1907,1907,98109,47.638,122.35,1440,3400,107,0,4,2620,4580
2.895e+05,2015,410,3,2.25,2120,3400,2,0,0,3,7,2120,0,2002,2002,98092,47.336,122.17,2420,3400,13,0,5.25,4540,5520
5.8e+05,2014,248,2,1.5,1990,6000,1,0,0,3,6,1430,560,1944,1944,98199,47.652,122.4,1350,6000,70,0,3.5,3340,7990
4.5e+05,2014,318,2,1,1180,6000,1,0,0,3,7,1180,0,1910,1910,98119,47.653,122.37,1600,6000,104,0,3,2780,7180
6e+05,2014,182,5,2,2190,9072,1,0,0,5,7,1110,1080,1965,1965,98052,47.67,122.15,1660,8327,49,0,7,3850,10517
6.4836e+05,2014,142,4,1.75,2260,7005,1,0,1,4,7,1130,1130,1947,1947,98033,47.69,122.21,2330,9180,67,0,5.75,4590,11440
2.7e+05,2015,408,4,2.5,2350,5835,2,0,0,3,8,2350,0,2003,2003,98042,47.349,122.15,3010,5772,12,0,6.5,5360,8122
5.4e+05,2015,467,4,2.75,2830,7334,2,0,0,3,8,2830,0,2005,2005,98059,47.487,122.14,2830,7378,10,0,6.75,5660,10208
5.6e+05,2014,331,3,2.5,2020,11935,1,0,0,4,9,2020,0,1976,1976,98052,47.632,122.09,2410,12350,38,0,5.5,4430,14370
5.75e+05,2014,305,3,2.5,2270,9600,2,0,0,3,9,2270,0,1990,1990,98011,47.739,122.21,2580,9617,24,0,5.5,4850,11887
4.7523e+05,2014,237,3,2.5,2120,4512,2,0,0,3,8,2120,0,1988,1988,98011,47.75,122.18,2000,4553,26,0,5.5,4120,6673
2.4e+05,2014,266,3,2,1220,17652,1,0,0,4,7,1220,0,1980,1980,98059,47.471,122.1,1990,17652,34,0,5,3210,18872
6.119e+05,2014,319,1,2.25,1220,2100,2,0,2,4,8,1220,0,1946,1979,98033,47.67,122.2,3150,6000,68,1,3.25,4370,7220
4.9995e+05,2015,439,4,2.5,2910,20067,2,0,0,3,9,2910,0,2001,2001,98168,47.471,122.27,1730,21420,14,0,6.5,4640,24330
1.6495e+05,2014,176,3,1.75,1570,15330,1,0,0,3,7,1080,490,1956,1956,98166,47.461,122.34,1250,13330,58,0,4.75,2820,14900
2.94e+05,2014,299,5,2.75,1790,5000,1,0,0,4,7,1060,730,1915,1915,98106,47.566,122.36,1400,5000,99,0,7.75,3190,6790
2.56e+05,2014,182,4,2.5,2050,5787,2,0,0,3,7,2050,0,2002,2002,98198,47.353,122.31,2030,6615,12,0,6.5,4080,8665
8.2e+05,2014,148,3,2.5,2510,5503,2,0,2,3,9,2510,0,1995,1995,98136,47.542,122.38,1790,6099,19,0,5.5,4300,8609
2.72e+05,2014,249,5,1.5,2550,6300,1,0,0,4,7,1560,990,1959,1959,98056,47.501,122.17,1380,6300,55,0,6.5,3930,8850
9.48e+05,2015,471,3,2.5,3510,9824,2,0,0,3,9,3510,0,2002,2002,98075,47.563,122.03,3510,10588,13,0,5.5,7020,14098
7.9e+05,2014,229,4,2.5,2690,8036,2,0,0,4,9,2690,0,1987,1987,98007,47.66,122.14,2420,8087,27,0,6.5,5110,10777
3.45e+05,2014,209,3,2.5,1360,1489,2,0,0,3,8,1360,0,2007,2007,98126,47.549,122.37,1360,1688,7,0,5.5,2720,3048
3.52e+05,2015,438,4,1.5,1440,8680,1,0,0,3,7,1440,0,1922,1922,98178,47.502,122.23,1440,9000,93,0,5.5,2880,10440
4.8e+05,2015,447,5,3.5,3480,12821,2,0,2,3,10,2890,590,2004,2004,98092,47.264,122.22,3400,9870,11,0,8.5,6880,13350
3.95e+05,2014,300,3,2.5,2510,5320,2,0,0,3,8,2510,0,2005,2005,98106,47.537,122.36,1820,5736,9,0,5.5,4330,8246
4.02e+05,2014,128,3,2.5,1960,8000,1,0,0,4,7,1290,670,1977,1977,98034,47.725,122.18,1960,8000,37,0,5.5,3920,9960
6.75e+05,2015,471,4,1.75,1900,8800,1,0,0,3,8,1140,760,1975,1975,98033,47.658,122.2,2280,8800,40,0,5.75,4180,10700
7.57e+05,2014,325,3,2.75,2610,11290,1,0,0,3,7,1630,980,1985,1985,98033,47.663,122.2,2570,9125,29,0,5.75,5180,11735
2.241e+05,2014,278,3,1.5,1420,8580,1,0,0,3,6,1420,0,1962,1962,98023,47.308,122.36,1200,8580,52,0,4.5,2620,10000
5.35e+05,2014,152,3,2.5,1690,9626,2,0,0,3,8,1690,0,1984,1984,98027,47.565,122.09,1860,8958,30,0,5.5,3550,10648
6.13e+05,2014,153,3,2.5,1350,3068,2,0,0,3,7,1350,0,1991,1991,98122,47.61,122.29,1900,4000,23,0,5.5,3250,5350
2.25e+05,2014,133,3,1,1660,7210,1,0,0,3,7,1100,560,1963,1963,98001,47.339,122.28,1660,7245,51,0,4,3320,8905
2.555e+05,2014,198,2,1,1440,43560,1,0,0,4,7,1150,290,1965,1965,98027,47.492,122.08,1870,56628,49,0,3,3310,58068
8.15e+05,2014,141,4,2.75,3488,9614,2,0,0,3,10,3488,0,1998,1998,98074,47.605,122.01,3600,10891,16,0,6.75,7088,14379
5.07e+05,2014,168,4,1.75,1770,9375,1,0,0,4,7,1170,600,1968,1968,98052,47.694,122.11,1540,9375,46,0,5.75,3310,11145
2.535e+06,2014,198,5,3.25,3730,10626,1,0,4,4,10,3730,0,1963,1963,98004,47.624,122.22,4180,19110,51,0,8.25,7910,22840
6.75e+05,2015,467,3,2,1510,3817,1,0,0,3,8,1510,0,1905,1994,98122,47.609,122.29,1510,3817,110,1,5,3020,5327
7.6e+05,2015,381,4,3.5,3720,13591,2,0,3,3,10,3720,0,2004,2004,98065,47.536,121.86,4210,14282,11,0,7.5,7930,18002
2.67e+05,2015,401,3,2.5,1690,10336,2,0,0,4,7,1690,0,1989,1989,98010,47.311,122,1580,7700,26,0,5.5,3270,9390
5.55e+05,2015,396,4,2.5,2920,24074,2,0,0,3,9,2920,0,1997,1997,98038,47.381,122.06,2760,26023,18,0,6.5,5680,28943
4.24e+05,2014,208,3,2.5,2200,34680,2,0,0,3,9,2200,0,1985,1985,98092,47.314,122.12,2560,35840,29,0,5.5,4760,38040
1.475e+05,2014,334,3,1.75,1010,6552,1,0,0,3,7,1010,0,1969,1969,98042,47.375,122.12,1010,6552,45,0,4.75,2020,7562
2.67e+05,2015,464,3,2,1300,9644,1,0,0,3,7,1300,0,1994,1994,98010,47.313,122,1430,9656,21,0,5,2730,10956
3.25e+05,2014,345,3,1,1600,7500,1,0,0,3,7,1600,0,1966,1966,98034,47.72,122.18,2050,7200,48,0,4,3650,8800
1.6e+05,2014,306,2,1,830,4500,1,0,0,3,6,830,0,1920,1920,98118,47.525,122.27,1092,5350,94,0,3,1922,6180
6.02e+05,2014,139,5,1.75,3290,11900,1,0,0,3,8,3290,0,1973,1973,98052,47.663,122.14,2210,8549,41,0,6.75,5500,11839
6e+05,2014,297,4,2.25,2090,45738,2,0,0,3,8,2090,0,1987,1987,98053,47.688,122.05,3420,45738,27,0,6.25,5510,47828
4.92e+05,2014,298,3,2.5,1690,1479,3,0,0,3,8,1420,270,2005,2005,98122,47.602,122.31,1280,1253,9,0,5.5,2970,2943
4.1e+05,2015,488,4,2.5,3320,5034,2,0,0,4,7,3320,0,2006,2006,98042,47.401,122.16,2580,4950,9,0,6.5,5900,8270
4.3e+05,2014,280,3,1.75,1720,15225,1,0,0,4,7,1020,700,1970,1970,98075,47.579,122.05,1860,13588,44,0,4.75,3580,15308
7.32e+05,2014,147,3,2.5,2330,1987,2,0,4,3,9,1410,920,2004,2004,98107,47.673,122.41,2640,5250,10,0,5.5,4970,7580
6.5e+05,2015,386,4,1.5,2480,6383,1,0,0,3,7,1380,1100,1946,1946,98119,47.645,122.37,1440,6000,69,0,5.5,3920,8480
2.22e+05,2014,238,2,2,1360,3300,2,0,0,3,6,1360,0,2004,2004,98038,47.349,122.02,1310,3300,10,0,4,2670,4660
2.07e+05,2014,326,2,1,1130,8160,1,0,0,4,6,1130,0,1952,1952,98168,47.5,122.32,1060,6120,62,0,3,2190,7250
5.8e+05,2015,383,3,1.75,1460,2800,2,0,0,3,7,1460,0,1928,1928,98117,47.678,122.37,1220,4062,87,0,4.75,2680,5522
8.515e+05,2014,338,3,2,3200,18184,1,0,0,5,8,2000,1200,1977,1977,98005,47.603,122.17,1670,7416,37,0,5,4870,10616
2.76e+05,2014,313,3,2,1450,8928,1,0,0,3,7,1450,0,1998,1998,98042,47.364,122.08,2050,8523,16,0,5,3500,9973
4.4995e+05,2014,230,3,2.25,1610,5159,2,0,0,3,7,1610,0,1985,1985,98029,47.568,122.02,1610,5210,29,0,5.25,3220,6820
3.58e+05,2015,408,3,2.25,1610,6655,2,0,0,4,7,1610,0,1985,1985,98058,47.43,122.16,1780,7529,30,0,5.25,3390,9139
3.37e+05,2014,339,3,1.75,1400,6000,1,0,0,4,7,700,700,1919,1919,98108,47.528,122.32,1030,6000,95,0,4.75,2430,7400
4.94e+05,2014,128,3,2.5,2310,4729,2,0,0,3,8,2310,0,2011,2011,98028,47.773,122.24,2440,4711,3,0,5.5,4750,7021
6.19e+05,2014,136,3,2.5,2720,6439,2,0,0,3,9,2720,0,2005,2005,98065,47.542,121.86,3180,7320,9,0,5.5,5900,10040
3.3e+05,2014,300,3,1.75,2020,11050,1,0,0,4,8,1320,700,1969,1969,98059,47.471,122.12,1940,11050,45,0,4.75,3960,13070
3.25e+05,2014,335,3,2.5,2550,4240,2,0,0,3,7,2550,0,2006,2006,98031,47.399,122.17,2550,4240,8,0,5.5,5100,6790
4.61e+05,2014,180,3,1.75,3600,8666,2,0,0,4,6,2400,1200,1948,1948,98033,47.689,122.17,2290,8200,66,0,4.75,5890,11800
8.5083e+05,2014,161,3,2.5,2070,13241,1,0,0,5,9,1270,800,1910,1910,98102,47.642,122.31,2200,4500,104,0,5.5,4270,6570
6e+05,2014,141,3,2.25,2230,9053,2,0,0,4,9,2230,0,1987,1987,98007,47.659,122.14,2390,8038,27,0,5.25,4620,10268
5.23e+05,2014,133,3,1.5,1240,7735,1,0,0,4,7,1240,0,1957,1957,98008,47.601,122.12,1260,7500,57,0,4.5,2500,8740
2.6495e+05,2014,149,4,2.25,1720,9753,1,0,0,4,7,1120,600,1978,1978,98023,47.292,122.37,1510,9753,36,0,6.25,3230,11473
5.275e+05,2014,208,2,1,1170,3000,1,0,0,3,7,1170,0,1910,1910,98103,47.67,122.34,1530,4000,104,0,3,2700,5170
3.6e+05,2014,340,4,2.5,2000,5500,2,0,0,3,8,2000,0,2003,2003,98038,47.355,122.01,2000,5512,11,0,6.5,4000,7512
3.9e+05,2014,335,3,3,1550,1608,2,0,0,3,8,1280,270,2001,2001,98122,47.604,122.3,1940,1883,13,0,6,3490,3433
7.25e+05,2014,280,5,3.75,3360,6000,2,0,0,3,8,2640,720,1963,1999,98118,47.558,122.28,1930,6000,51,1,8.75,5290,9360
2.499e+05,2014,273,4,2,1500,7854,1,0,0,3,7,1500,0,1983,1983,98023,47.313,122.35,1500,7334,31,0,6,3000,8834
1.75e+05,2014,168,6,1,1370,5080,1,0,0,3,6,1120,250,1931,1931,98106,47.524,122.35,1020,5080,83,0,7,2390,6450
9.2e+05,2014,356,6,3,3300,4218,2,0,0,3,8,2200,1100,1970,1970,98103,47.656,122.34,1420,4218,44,0,9,4720,7518
9.628e+05,2015,444,4,2.75,3630,11775,2,0,0,3,10,3630,0,1999,1999,98074,47.638,122.07,3800,12451,16,0,6.75,7430,16081
6.1695e+05,2014,320,3,3.5,2490,2722,2,0,0,3,8,2020,470,1999,1999,98005,47.589,122.17,2490,2755,15,0,6.5,4980,5245
6.8e+05,2014,264,3,1.75,2330,9652,1,0,0,4,8,1590,740,1968,1968,98040,47.571,122.21,2420,9631,46,0,4.75,4750,11961
2.7e+06,2014,158,4,3.25,4420,7850,2,1,4,3,11,3150,1270,2001,2001,98008,47.572,122.1,2760,8525,13,0,7.25,7180,12945
2.4e+05,2014,155,3,1,1150,4825,1,0,0,4,6,1150,0,1957,1957,98027,47.532,122.03,1760,7121,57,0,4,2910,8271
9.2e+05,2015,451,3,1,1410,9656,1,0,0,3,7,960,450,1953,1953,98004,47.635,122.21,2410,9384,62,0,4,3820,10794
2.5e+05,2014,189,3,1,990,8062,1,0,0,4,7,990,0,1960,1960,98198,47.415,122.33,1420,8790,54,0,4,2410,9780
4.15e+05,2014,265,4,3.5,3040,7125,2,0,1,3,8,2240,800,2002,2002,98178,47.492,122.22,2220,7800,12,0,7.5,5260,10840
5.25e+05,2014,141,3,1,1450,4000,1,0,1,4,8,950,500,1948,1948,98118,47.555,122.27,1880,4000,66,0,4,3330,5450
5.7e+05,2015,486,4,2.5,2640,11816,2,0,0,3,8,2640,0,1999,1999,98019,47.733,121.97,2400,11816,16,0,6.5,5040,14456
5.24e+05,2015,369,3,1.5,1310,9471,1,0,0,4,8,1310,0,1970,1970,98052,47.664,122.15,2100,9449,45,0,4.5,3410,10759
5.9e+05,2014,286,4,2.5,2240,9385,2,0,0,3,8,2240,0,1991,1991,98133,47.712,122.33,2010,9000,23,0,6.5,4250,11240
4.6e+05,2014,284,2,1.5,1790,3760,1,0,0,4,8,1280,510,1928,1928,98117,47.687,122.37,1540,5080,86,0,3.5,3330,6870
4.7095e+05,2014,307,3,2.5,2560,16420,2,0,0,4,8,2560,0,1989,1989,98014,47.692,121.92,2120,16298,25,0,5.5,4680,18858
5e+05,2015,456,4,3,2450,4668,2,0,0,3,8,2450,0,2004,2004,98028,47.772,122.23,2460,4895,11,0,7,4910,7345
8.3e+05,2015,470,5,2.5,2810,14207,1,0,3,3,9,1540,1270,1979,1979,98008,47.574,122.11,3190,14000,36,0,7.5,6000,16810
4.35e+05,2015,445,3,2.5,3110,6000,1,0,2,3,8,1560,1550,1967,1967,98106,47.533,122.35,2060,6000,48,0,5.5,5170,9110
7.25e+05,2014,279,3,1.5,1790,6000,1,0,0,4,7,1790,0,1903,1903,98115,47.675,122.33,1290,3500,111,0,4.5,3080,5290
3.25e+05,2014,141,3,1,990,6750,1,0,0,4,6,990,0,1947,1947,98133,47.712,122.33,1440,6860,67,0,4,2430,7850
3.275e+05,2015,487,4,2.25,2240,9600,2,0,0,3,8,2240,0,1971,1971,98032,47.361,122.28,2050,9240,44,0,6.25,4290,11480
2.54e+05,2014,198,3,1,1160,7560,1,0,0,4,6,1160,0,1958,1958,98058,47.45,122.18,1160,7560,56,0,4,2320,8720
3.55e+05,2014,177,3,1.75,2040,22693,1,0,0,4,8,2040,0,1980,1980,98042,47.352,122.14,1950,6280,34,0,4.75,3990,8320
4.35e+05,2014,160,5,2.25,1970,15247,1,0,0,3,7,1450,520,1986,1986,98024,47.567,121.91,1300,10800,28,0,7.25,3270,12770
3.16e+05,2014,303,3,1.75,1120,98445,1,0,2,4,7,1120,0,1917,1917,98022,47.185,122.02,1620,34200,97,0,4.75,2740,35320
2.19e+05,2014,222,3,1.5,1200,12000,1,0,0,3,7,1200,0,1986,1986,98001,47.268,122.25,1200,9405,28,0,4.5,2400,10605
4.69e+05,2014,244,3,2.25,1820,8446,2,0,0,3,8,1820,0,1978,1978,98034,47.721,122.24,1850,8437,36,0,5.25,3670,10257
2.6e+05,2014,181,3,2.25,1920,9680,1,0,0,4,7,1300,620,1961,1961,98031,47.412,122.19,1500,9516,53,0,5.25,3420,11436
1.99e+05,2015,401,3,2.5,1750,6725,1,0,0,3,7,1330,420,1993,1993,98038,47.352,122.06,1670,7744,22,0,5.5,3420,9494
5.235e+05,2014,235,2,2,1600,5969,1,0,0,4,7,800,800,1950,1950,98116,47.569,122.39,1520,5969,64,0,4,3120,7569
5e+05,2015,372,3,2.5,1650,4648,2,0,0,3,8,1650,0,2001,2001,98075,47.597,122.02,1800,5637,14,0,5.5,3450,7287
5.9e+05,2014,129,4,2.25,2430,32496,1,0,0,3,9,2430,0,1993,1993,98077,47.764,122.05,2750,35506,21,0,6.25,5180,37936
7.7e+05,2015,368,3,2.5,2190,2658,2,0,3,4,9,2190,0,1979,1979,98033,47.653,122.2,2315,2538,36,0,5.5,4505,4728
5.37e+05,2015,457,4,4.25,4883,26040,2,0,3,3,10,3859,1024,2006,2006,98092,47.263,122.22,3736,9870,9,0,8.25,8619,14753
5.3e+05,2014,179,2,1,840,3400,1,0,2,4,7,840,0,1924,1924,98119,47.64,122.37,2000,4000,90,0,3,2840,4840
1.2e+06,2014,180,4,2,2120,3360,2,0,0,3,9,2120,0,1905,1905,98112,47.623,122.31,2090,3600,109,0,6,4210,5720
3e+05,2014,255,4,2.25,1740,9613,2,0,0,5,8,1740,0,1989,1989,98058,47.463,122.13,1680,9769,25,0,6.25,3420,11509
2.5e+05,2014,159,5,1.5,2520,5753,1,0,0,4,7,1510,1010,1928,1928,98022,47.206,122,1620,6875,86,0,6.5,4140,9395
8.6e+05,2014,190,5,2.25,3480,9200,2,0,0,3,8,3480,0,1979,1979,98006,47.559,122.15,3130,9200,35,0,7.25,6610,12680
8.5e+05,2015,444,5,2.25,3100,97661,2,0,0,3,9,3100,0,1986,1986,98053,47.662,122.06,2370,53993,29,0,7.25,5470,57093
2.3e+05,2014,320,2,2,1260,10200,1,0,0,3,7,1020,240,1983,1983,98003,47.259,122.31,1560,10200,31,0,4,2820,11460
2.9401e+05,2014,236,3,1.75,1550,4057,1,0,0,3,6,830,720,1945,1945,98106,47.529,122.35,1100,4116,69,0,4.75,2650,5666
7.15e+05,2015,486,4,1,1710,6050,1,0,0,3,7,1410,300,1913,1913,98118,47.557,122.29,1560,4950,102,0,5,3270,6660
1.375e+06,2014,354,5,4.5,4350,13405,2,0,0,3,11,4350,0,2014,2014,98074,47.602,122.06,3990,7208,0,0,9.5,8340,11558
1.108e+06,2014,256,4,2.5,3320,9380,2,0,3,3,10,3320,0,1988,1988,98006,47.566,122.11,2870,11779,26,0,6.5,6190,15099
1.5644e+06,2015,481,4,3.75,3730,17000,2,0,3,4,10,2820,910,1986,1986,98040,47.535,122.24,3880,15550,29,0,7.75,7610,19280
3.3995e+05,2015,463,4,2.5,2260,6086,2,0,0,3,8,2260,0,1999,1999,98030,47.364,122.17,2260,6218,16,0,6.5,4520,8478
4.4e+05,2014,231,2,1,1280,12086,1,0,0,3,7,850,430,1983,1983,98074,47.634,122.03,1280,10452,31,0,3,2560,11732
9e+05,2014,189,4,2.5,2230,4372,2,0,0,5,8,1540,690,1935,1935,98103,47.67,122.33,2020,4372,79,0,6.5,4250,6602
5.63e+05,2014,126,4,3,3100,15480,2,0,0,3,8,2400,700,1996,1996,98028,47.747,122.24,2000,42500,18,0,7,5100,45600
3.325e+05,2015,477,4,1,1670,8102,1,0,0,3,6,1670,0,1944,1944,98166,47.469,122.36,1310,7906,71,0,5,2980,9576
4.175e+05,2014,160,4,1,1390,10800,1,0,0,4,7,1390,0,1941,1941,98177,47.725,122.36,1390,9360,73,0,5,2780,10750
1.197e+06,2014,310,4,2.5,3940,4407,2,0,0,4,8,2620,1320,1921,1921,98112,47.637,122.3,1790,4407,93,0,6.5,5730,8347
5.12e+05,2014,209,4,2.5,2600,4506,2,0,0,3,9,2600,0,2005,2005,98056,47.515,122.19,2470,6041,9,0,6.5,5070,8641
6.8e+05,2015,474,3,2.5,2120,3600,2,0,0,3,9,2120,0,2005,2005,98052,47.665,122.08,2540,4592,10,0,5.5,4660,6712
4.5e+05,2014,271,3,2.5,2410,4293,2,0,0,3,7,2410,0,2007,2007,98065,47.52,121.87,2190,5900,7,0,5.5,4600,8310
1.928e+06,2014,271,4,3.25,4280,20296,2,0,0,4,11,4280,0,1984,1984,98004,47.638,122.21,3420,16351,30,0,7.25,7700,20631
5.54e+05,2015,374,3,2.5,2140,4126,2,0,0,3,8,1960,180,2005,2005,98027,47.537,122.07,2280,2615,10,0,5.5,4420,4755
3.3e+05,2014,140,3,1,1180,43124,1,0,0,4,6,1180,0,1959,1959,98027,47.528,122.06,1410,43560,55,0,4,2590,44740
5.64e+05,2014,168,2,2,1690,4500,1,0,0,3,8,1690,0,2004,2004,98053,47.713,122.03,1640,4500,10,0,4,3330,6190
6.02e+05,2015,400,4,1.75,2430,14000,1,0,0,4,7,1580,850,1963,1963,98052,47.655,122.13,1910,8285,52,0,5.75,4340,10715
4.82e+05,2014,168,3,3.25,1380,1120,3,0,0,3,8,1380,0,2008,2008,98103,47.662,122.35,1310,1405,6,0,6.25,2690,2785
2.047e+05,2014,135,4,2,1670,9987,1,0,0,3,7,1670,0,1967,1967,98001,47.341,122.28,1640,7280,47,0,6,3310,8950
1.62e+05,2015,408,3,2.25,1810,6750,1,0,0,3,7,1280,530,1978,1978,98023,47.298,122.38,1690,7770,37,0,5.25,3500,9580
2.6e+05,2014,269,3,2.5,1427,4337,2,0,0,3,7,1427,0,2009,2009,98042,47.386,122.16,1443,4347,5,0,5.5,2870,5774
3.91e+05,2014,152,3,2.25,1410,1290,2,0,0,3,7,1290,120,2004,2004,98027,47.535,122.07,1490,1380,10,0,5.25,2900,2790
4.26e+05,2015,438,2,1,640,2500,1,0,0,4,6,640,0,1918,1918,98117,47.678,122.36,1460,4200,97,0,3,2100,4840
2.915e+05,2014,173,3,1,880,9238,1,0,0,5,6,880,0,1946,1946,98155,47.749,122.32,1170,9238,68,0,4,2050,10118
2.8e+05,2015,462,2,1,990,45528,1,0,0,4,7,990,0,1992,1992,98070,47.501,122.46,1730,45528,23,0,3,2720,46518
2.96e+05,2014,230,4,1.5,1370,9750,1,0,0,3,7,1070,300,1953,1953,98168,47.472,122.32,1540,9789,61,0,5.5,2910,11159
1.18e+06,2014,261,5,2.25,3270,16553,2,0,2,5,9,2470,800,1968,1968,98040,47.543,122.24,3690,17916,46,0,7.25,6960,21186
3.93e+05,2014,211,4,2,1450,5456,1,0,0,5,7,1450,0,1951,1951,98108,47.544,122.3,980,6100,63,0,6,2430,7550
4.56e+05,2014,245,4,1,1700,7689,1,0,0,3,7,1080,620,1977,1977,98052,47.696,122.12,1700,7333,37,0,5,3400,9033
4.52e+05,2014,229,2,1,1340,8100,1,0,2,3,8,1340,0,1950,1950,98177,47.721,122.36,1680,7752,64,0,3,3020,9092
5.25e+05,2014,255,3,2,1600,16530,1,0,0,5,7,1600,0,1967,1967,98075,47.582,122.02,1850,41006,47,0,5,3450,42606
2.45e+05,2015,456,3,2.5,1600,4271,2,0,0,3,7,1600,0,2003,2003,98038,47.386,122.04,1520,3225,12,0,5.5,3120,4825
3.5e+05,2014,334,1,1,790,4590,1,0,0,3,6,790,0,1911,1911,98118,47.568,122.28,1070,4590,103,0,2,1860,5380
2.3525e+05,2015,387,4,2.5,1954,5075,2,0,0,3,8,1954,0,2007,2007,98001,47.261,122.25,1934,5000,8,0,6.5,3888,6954
2.35e+05,2014,166,2,1.5,880,1805,2,0,0,3,7,880,0,1999,1999,98133,47.706,122.34,880,5060,15,0,3.5,1760,5940
4.27e+05,2014,237,3,2,1720,1.2807e+05,1,0,0,3,7,1720,0,1994,1994,98027,47.449,121.98,2360,1.1108e+05,20,0,5,4080,1.128e+05
3.75e+05,2014,210,4,1.75,2190,9225,1,0,0,4,7,1250,940,1959,1959,98028,47.74,122.26,2190,9225,55,0,5.75,4380,11415
2.7e+06,2014,174,5,2.75,3831,13800,2,1,4,3,9,3831,0,1959,1980,98040,47.592,122.25,3850,36563,55,1,7.75,7681,40394
3.4e+05,2014,349,2,1.75,1880,7208,1,0,0,3,7,940,940,1951,1951,98115,47.695,122.33,1880,8051,63,0,3.75,3760,9931
4.97e+05,2014,135,4,2.5,2240,7200,2,0,0,3,8,2240,0,1995,1995,98118,47.564,122.28,1860,6600,19,0,6.5,4100,8840
1.95e+05,2014,217,3,1.75,1580,7875,1,0,0,3,7,1580,0,1979,1979,98022,47.196,122,1560,8314,35,0,4.75,3140,9894
1.5e+06,2014,346,4,2.75,2930,25697,1,0,0,4,9,2310,620,1964,1964,98004,47.626,122.23,3810,20681,50,0,6.75,6740,23611
5.56e+05,2014,141,3,3,1960,1168,2,0,0,3,9,1600,360,2007,2007,98027,47.544,122.01,2080,1423,7,0,6,4040,3383
1.955e+06,2015,471,4,2.75,3120,7898,1,1,4,4,8,1560,1560,1963,1963,98034,47.717,122.26,2630,13868,52,0,6.75,5750,16988
1.205e+06,2014,342,5,4.25,4420,13497,2,0,0,3,11,3510,910,2000,2000,98059,47.526,122.14,4220,12015,14,0,9.25,8640,16435
2.6e+05,2015,456,4,1.75,2010,10816,1,0,0,3,7,1410,600,1955,1955,98178,47.505,122.25,1610,9360,60,0,5.75,3620,11370
2.7e+05,2014,135,3,1,1010,9514,1,0,0,3,7,1010,0,1969,1969,98059,47.494,122.11,1010,9514,45,0,4,2020,10524
3.9e+05,2014,321,4,2.5,2560,43560,2,0,0,3,8,2560,0,1989,1989,98038,47.369,122.05,2130,10150,25,0,6.5,4690,12710
8.266e+05,2015,444,4,3.25,3230,5000,1,0,0,4,7,1750,1480,1916,1916,98105,47.67,122.3,1730,4000,99,0,7.25,4960,7230
1.85e+05,2014,273,3,1.75,1170,9085,1,0,0,3,7,1170,0,1967,1967,98023,47.281,122.35,1230,9085,47,0,4.75,2400,10255
5.64e+05,2015,465,4,1.75,1960,6138,1,0,0,4,7,1260,700,1960,1960,98115,47.697,122.3,2000,7057,55,0,5.75,3960,9017
3.9e+05,2014,332,3,2.5,2350,5100,2,0,0,3,8,2350,0,2003,2003,98038,47.351,122.01,2350,5363,11,0,5.5,4700,7713
5.85e+05,2015,395,2,1.75,1980,8550,1,0,0,3,7,990,990,1981,1981,98117,47.699,122.37,1480,6738,34,0,3.75,3460,8718
4.3772e+05,2014,313,3,2.5,1800,3265,2,0,0,3,8,1800,0,2014,2014,98065,47.534,121.84,1800,3663,0,0,5.5,3600,5463
2.3995e+05,2015,395,2,1.5,1068,1452,2,0,0,3,7,1068,0,1990,1990,98028,47.753,122.24,1078,1357,25,0,3.5,2146,2425
4e+05,2014,201,3,1.75,1390,4602,1,0,0,3,7,930,460,1981,1981,98117,47.694,122.37,1230,4800,33,0,4.75,2620,6190
5.25e+05,2015,480,5,3.5,3450,19080,2,0,3,3,9,3450,0,2001,2001,98022,47.212,122,2570,17007,14,0,8.5,6020,20457
4.895e+05,2015,487,4,3.5,2730,5707,2,0,0,3,8,2000,730,2011,2011,98019,47.733,121.97,2430,5899,4,0,7.5,5160,8629
5.1e+05,2015,457,3,3,1320,1012,3,0,0,3,8,1320,0,2009,2009,98117,47.69,122.39,1320,1536,6,0,6,2640,2856
6.35e+05,2014,301,3,2.25,1940,7482,1,0,0,4,7,1240,700,1964,1964,98004,47.6,122.19,2340,9310,50,0,5.25,4280,11250
8.85e+05,2014,278,4,2.25,4470,86225,2,0,0,3,10,4470,0,1991,1991,98053,47.638,121.98,3850,97049,23,0,6.25,8320,1.0152e+05
8.29e+05,2015,396,3,2.75,2690,10443,1,0,0,3,9,2690,0,2007,2007,98053,47.718,122.02,1440,4185,8,0,5.75,4130,6875
4.7e+05,2014,211,3,2.25,2220,9800,2,0,0,3,8,2220,0,1987,1987,98155,47.764,122.29,2420,10232,27,0,5.25,4640,12452
3.385e+05,2014,289,3,1.75,2130,5489,1,0,0,3,8,1370,760,1999,1999,98070,47.449,122.46,1750,7200,15,0,4.75,3880,9330
1.6e+06,2015,474,5,2.5,3100,5374,2,0,0,4,9,3100,0,1906,1906,98122,47.615,122.28,2180,5800,109,0,7.5,5280,8900
6.434e+05,2014,263,3,2.5,2350,9648,1,0,0,4,9,2350,0,1966,1966,98008,47.616,122.11,2320,10512,48,0,5.5,4670,12862
9.5e+05,2014,180,4,2.5,3670,7680,2,0,0,3,10,3670,0,2007,2007,98029,47.54,121.99,3130,6112,7,0,6.5,6800,9782
2.415e+05,2014,259,4,2.5,2500,9654,1,0,0,3,8,1830,670,1979,1979,98023,47.314,122.34,2500,8839,35,0,6.5,5000,11339
7.33e+05,2015,386,6,2.75,2730,5000,1,0,0,3,8,1780,950,1962,1962,98107,47.675,122.38,2090,5000,53,0,8.75,4820,7730
5.49e+05,2014,337,3,1.75,1540,1044,3,0,0,3,8,1540,0,2014,2014,98115,47.676,122.32,1580,3090,0,0,4.75,3120,4630
3.615e+05,2014,201,3,1.75,1070,9000,1,0,0,4,7,1070,0,1978,1978,98052,47.698,122.13,1700,8400,36,0,4.75,2770,9470
4.59e+05,2014,151,3,1.75,1620,7330,1,0,0,4,7,1090,530,1974,1974,98034,47.715,122.21,1380,7191,40,0,4.75,3000,8811
6.352e+05,2014,149,4,1.75,1640,4240,1,0,0,5,7,920,720,1921,1921,98117,47.677,122.37,1300,4240,93,0,5.75,2940,5880
4.55e+05,2014,360,4,2,2380,4500,1,0,0,3,6,1470,910,1926,2014,98118,47.565,122.28,1300,4500,88,1,6,3680,6880
3.4e+05,2014,325,3,1,1710,10190,1,0,0,3,6,1310,400,1949,1949,98168,47.506,122.33,1200,6251,65,0,4,2910,7961
2.05e+05,2014,206,2,1,900,4397,1,0,0,3,6,900,0,1918,1918,98055,47.485,122.2,1430,4500,96,0,3,2330,5400
9.3e+05,2014,153,2,2.5,2680,11214,1,0,0,3,9,2680,0,2006,2006,98053,47.708,122.02,2305,6908,8,0,4.5,4985,9588
1.56e+05,2015,388,2,1,600,4000,1,0,0,3,5,600,0,1933,1933,98146,47.507,122.34,1290,6973,82,0,3,1890,7573
1.067e+06,2014,191,6,3.5,4860,11793,2,0,0,3,11,3860,1000,1998,1998,98006,47.552,122.14,3600,11793,16,0,9.5,8460,16653
5.4e+05,2014,297,4,2.5,3000,5471,2,0,0,3,8,3000,0,2013,2013,98059,47.48,122.13,2730,5471,1,0,6.5,5730,8471
2.72e+05,2014,314,3,2.5,1680,8512,2,0,0,3,7,1680,0,1991,1991,98022,47.195,121.99,1580,8512,23,0,5.5,3260,10192
3.75e+05,2014,319,3,2.5,1600,2042,2,0,0,3,8,1600,0,2005,2005,98027,47.534,122.07,1445,1370,9,0,5.5,3045,2970
2.5e+05,2015,383,3,1.5,2840,10182,1,0,0,3,8,1510,1330,1951,1951,98056,47.524,122.2,2210,9669,64,0,4.5,5050,12509
3.375e+05,2015,479,3,2.25,1530,6600,1,0,0,4,7,1240,290,1968,1968,98055,47.462,122.19,1500,7700,47,0,5.25,3030,9230
2.68e+05,2014,235,3,1.75,1480,8009,1,0,0,3,7,980,500,1980,1980,98032,47.366,122.28,1790,7678,34,0,4.75,3270,9158
3.15e+05,2014,177,6,4,3120,4240,2,0,2,4,7,2090,1030,1993,1993,98106,47.531,122.35,1460,4240,21,0,10,4580,7360
3.8e+05,2015,422,3,1,1260,7980,1,0,0,3,7,1260,0,1951,1951,98177,47.701,122.37,1760,7606,64,0,4,3020,8866
3.535e+05,2014,166,4,2.25,1760,9602,2,0,0,3,7,1760,0,1987,1987,98058,47.425,122.16,1860,9656,27,0,6.25,3620,11416
4.4e+05,2015,408,3,2.5,1830,6807,2,0,0,5,7,1830,0,1954,1954,98155,47.761,122.32,1340,6807,61,0,5.5,3170,8637
2.335e+05,2014,245,3,1.5,1580,10517,1,0,0,4,6,1580,0,1957,1957,98002,47.29,122.21,1400,10658,57,0,4.5,2980,12238
3.85e+05,2015,424,3,2,1320,1297,3,0,0,3,7,1320,0,1995,1995,98117,47.696,122.38,1380,1503,20,0,5,2700,2823
3.111e+05,2014,129,4,2.25,2130,8078,1,0,0,4,7,1380,750,1977,1977,98055,47.448,122.21,2300,8112,37,0,6.25,4430,10242
4.8e+05,2015,451,4,2.5,2180,9861,2,0,2,3,8,2180,0,1997,1997,98045,47.482,121.8,2390,9761,18,0,6.5,4570,11941
1.225e+06,2014,159,4,2.5,2740,16007,2,0,0,3,9,2740,0,1984,1984,98039,47.635,122.23,2760,16008,30,0,6.5,5500,18748
8.14e+05,2014,235,4,2.5,2840,8820,1,0,2,5,8,1420,1420,1952,1952,98118,47.554,122.27,2310,8750,62,0,6.5,5150,11590
8e+05,2014,236,4,2,2130,2800,1,0,0,5,7,1070,1060,1922,1922,98103,47.654,122.33,1990,3990,92,0,6,4120,6120
3.365e+05,2014,316,4,2.5,2500,5264,2,0,0,3,7,2500,0,2003,2003,98038,47.385,122.03,1960,5250,11,0,6.5,4460,7750
4.42e+05,2015,390,2,1,1410,5000,1,0,2,4,7,940,470,1918,1918,98126,47.553,122.38,1450,5000,97,0,3,2860,6410
5.59e+05,2014,325,2,3,1650,960,3,0,0,3,8,1350,300,2015,2015,98103,47.661,122.35,1650,3000,-1,0,5,3300,4650
8.6e+05,2015,437,3,2,2090,4190,1,0,0,4,8,1490,600,1930,1930,98122,47.618,122.28,2090,6270,85,0,5,4180,8360
1.57e+06,2014,188,4,2.25,2890,18226,3,1,4,3,10,2890,0,1984,1984,98056,47.517,122.21,2870,11151,30,0,6.25,5760,14041
3.75e+05,2014,135,4,1.75,1890,8000,1,0,0,4,7,1250,640,1960,1960,98133,47.758,122.33,1870,8270,54,0,5.75,3760,10160
4.19e+05,2014,198,3,2.5,1970,4058,2,0,0,3,7,1970,0,2004,2004,98065,47.531,121.85,2340,4067,10,0,5.5,4310,6037
4.55e+05,2015,460,3,2.25,1790,7500,1,0,0,3,7,1390,400,1973,1973,98034,47.732,122.2,1940,7192,42,0,5.25,3730,8982
4.565e+05,2014,205,3,1,1290,3880,1,0,0,4,7,1290,0,1919,1919,98117,47.688,122.39,1290,4850,95,0,4,2580,6140
7.15e+05,2014,134,4,2.25,2060,5649,1,0,0,5,8,1360,700,1941,1941,98199,47.65,122.41,2060,5626,73,0,6.25,4120,7686
3.47e+05,2014,196,3,1,1010,7200,1,0,0,3,7,1010,0,1968,1968,98034,47.722,122.18,1120,7200,46,0,4,2130,8210
3.5e+05,2014,332,3,1.75,1740,29597,1,0,0,4,7,1740,0,1965,1965,98059,47.481,122.11,1560,20741,49,0,4.75,3300,22481
3.65e+05,2015,388,4,2.5,1904,8200,2,0,0,5,7,1904,0,1999,1999,98010,47.311,122,1560,12426,16,0,6.5,3464,14330
3.85e+05,2014,191,3,2,1860,7400,1,0,0,3,8,930,930,1922,2004,98166,47.46,122.35,1640,8461,92,1,5,3500,10321
3.5e+05,2014,263,3,3.25,1600,1298,3,0,0,3,8,1600,0,1999,1999,98117,47.695,122.38,1600,1348,15,0,6.25,3200,2948
6.25e+05,2014,202,5,1,3240,5324,2,0,0,3,9,3240,0,2007,2007,98065,47.523,121.88,3240,6036,7,0,6,6480,9276
7.6e+05,2014,215,4,2.5,2920,7901,2,0,0,3,9,2920,0,2004,2004,98052,47.704,122.13,3020,7900,10,0,6.5,5940,10820
2.34e+05,2015,479,3,1,960,9624,1,0,0,3,7,960,0,1953,1953,98155,47.776,122.3,1540,9624,62,0,4,2500,10584
7.05e+05,2015,478,3,2.75,2260,4000,2,0,0,4,8,1540,720,1956,1956,98109,47.644,122.35,2120,4000,59,0,5.75,4380,6260
5.5e+05,2015,426,3,2.5,2010,2261,2,0,0,3,8,1390,620,2014,2014,98029,47.551,122,1690,1899,1,0,5.5,3700,3909
7.7e+05,2014,168,4,2.5,3210,14910,2,0,0,3,10,3210,0,1995,1995,98074,47.607,122.06,3280,14910,19,0,6.5,6490,18120
5.45e+05,2015,443,2,1.5,1620,3760,2,0,0,5,7,1170,450,1924,1924,98144,47.601,122.29,2130,4000,91,0,3.5,3750,5620
4.15e+05,2015,409,6,2,2500,5200,1,0,0,3,8,1250,1250,1966,1966,98118,47.552,122.27,1800,5200,49,0,8,4300,7700
3.425e+05,2015,488,5,2.25,2100,10726,1,0,0,4,7,1050,1050,1963,1963,98059,47.492,122.13,2100,10726,52,0,7.25,4200,12826
3.95e+05,2014,353,4,2.75,2280,5013,2,0,0,3,8,2280,0,2009,2009,98019,47.733,121.98,2130,5121,5,0,6.75,4410,7401
2.28e+05,2014,128,4,1.75,2000,6120,1,0,0,3,7,1100,900,1965,1965,98178,47.504,122.26,1880,6120,49,0,5.75,3880,8120
4.05e+05,2014,262,3,2.5,2070,4697,2,0,0,3,7,2070,0,2002,2002,98065,47.531,121.88,2230,4437,12,0,5.5,4300,6507
3.5e+05,2014,190,4,2.5,2800,9538,2,0,0,3,8,2800,0,1993,1993,98003,47.267,122.31,1970,7750,21,0,6.5,4770,10550
3.45e+05,2014,183,4,2.5,2040,5523,2,0,0,3,7,2040,0,1999,1999,98148,47.432,122.33,1720,6646,15,0,6.5,3760,8686
1.41e+06,2015,470,2,2,2180,18525,1,1,4,5,9,1580,600,1952,1952,98146,47.504,122.39,2480,21503,63,0,4,4660,23683
5.9e+05,2014,198,4,2.75,2910,10650,1,0,2,3,8,1780,1130,1975,1975,98033,47.666,122.19,2920,10988,39,0,6.75,5830,13898
6.725e+05,2014,216,2,1.75,1860,5940,1,0,2,5,8,1020,840,1956,1956,98116,47.575,122.41,2130,5940,58,0,3.75,3990,7800
4.4e+05,2014,127,3,1.75,1500,6180,1,0,0,4,6,1060,440,1947,1947,98118,47.569,122.28,1740,6180,67,0,4.75,3240,7680
2.8e+05,2015,387,3,2.5,1650,6000,2,0,0,3,7,1650,0,1990,1990,98030,47.36,122.19,1750,6000,25,0,5.5,3400,7650
2.575e+05,2014,174,2,2,1180,9265,1,0,0,3,7,1180,0,1940,1940,98125,47.725,122.3,460,18000,74,0,4,1640,19180
5.25e+05,2014,305,3,2.5,2990,6725,2,0,0,3,9,2990,0,2003,2003,98059,47.493,122.14,2790,6725,11,0,5.5,5780,9715
5.95e+05,2015,467,4,2.5,2360,43017,2,0,0,3,9,2360,0,1989,1989,98077,47.774,122.08,2750,40334,26,0,6.5,5110,42694
6e+05,2014,188,4,2.5,2250,11370,2,0,0,3,8,2250,0,1991,1991,98034,47.712,122.24,2190,9611,23,0,6.5,4440,11861
4e+05,2014,168,3,1.75,1050,6150,1,0,0,4,6,950,100,1928,1928,98116,47.572,122.39,1360,6150,86,0,4.75,2410,7200
4.7e+05,2014,339,2,1,900,5512,1,0,0,3,7,900,0,1947,1947,98115,47.688,122.29,1270,5512,67,0,3,2170,6412
2.615e+05,2015,451,3,1,1410,8174,1,0,0,3,8,1410,0,1958,1958,98056,47.497,122.18,1500,8058,57,0,4,2910,9468
2.49e+05,2014,173,3,1,1000,19204,1,0,0,3,7,1000,0,1968,2010,98042,47.317,122.08,2450,25927,46,1,4,3450,26927
3.7e+05,2015,485,6,2.75,3240,5750,1,0,0,4,6,2160,1080,1950,1950,98002,47.305,122.22,1230,5750,65,0,8.75,4470,8990
3.5e+05,2014,169,2,1,1620,9205,1,0,0,5,6,850,770,1921,1921,98034,47.712,122.23,2460,5469,93,0,3,4080,7089
3.75e+05,2014,225,2,1.5,1160,1648,2,0,0,3,7,1160,0,2002,2002,98144,47.592,122.29,1458,2351,12,0,3.5,2618,3511
4.9e+05,2015,472,4,3,2640,5267,2,0,0,3,7,2640,0,2001,2001,98065,47.53,121.88,2640,5670,14,0,7,5280,8310
4.7995e+05,2014,205,3,2,2260,7163,1,0,0,3,9,2260,0,2012,2012,98058,47.459,122.14,2340,6730,2,0,5,4600,8990
5.5e+05,2014,264,4,3,4180,35169,2,0,0,3,11,4180,0,1986,1998,98038,47.4,122.03,3010,35190,28,1,7,7190,39370
1.05e+06,2015,463,5,2.75,2520,18625,1,0,0,3,8,1660,860,1959,1959,98004,47.641,122.21,3000,16624,56,0,7.75,5520,19144
3.7e+05,2014,237,3,1.75,1150,6600,1,0,0,4,6,1150,0,1970,1970,98033,47.671,122.19,1530,6600,44,0,4.75,2680,7750
9.12e+05,2014,211,3,2.5,2979,17313,2,0,2,3,11,2979,0,1993,1993,98006,47.55,122.12,3890,14797,21,0,5.5,6869,17776
4.495e+05,2014,173,3,2.25,1780,7280,1,0,2,3,7,1340,440,1972,1972,98034,47.723,122.22,2060,7280,42,0,5.25,3840,9060
4.1495e+05,2014,290,4,1.75,2200,8545,1,0,0,4,7,1100,1100,1918,1982,98133,47.748,122.35,1940,9315,96,1,5.75,4140,11515
4.95e+05,2014,303,3,3.5,1650,1577,2,0,0,3,7,1100,550,2012,2012,98109,47.63,122.34,1580,1280,2,0,6.5,3230,2930
3.785e+05,2015,450,4,2,1830,6000,1,0,0,5,7,1070,760,1953,1953,98118,47.545,122.28,1830,5500,62,0,6,3660,7330
1.695e+05,2014,221,3,1,1060,10023,1,0,0,3,6,1060,0,1962,1962,98023,47.287,122.36,1060,10023,52,0,4,2120,11083
5.1e+05,2015,471,2,1.5,1860,5100,1,0,0,3,7,1060,800,1940,1940,98136,47.557,122.39,1710,5100,75,0,3.5,3570,6960
3.5e+05,2015,453,3,2.25,2010,4400,1,0,0,3,7,2010,0,1986,1986,98055,47.474,122.19,1720,4187,29,0,5.25,3730,6197
2.6075e+05,2014,215,3,2,1560,9635,1,0,0,3,7,1260,300,1966,1966,98003,47.341,122.31,1570,8276,48,0,5,3130,9836
3.925e+05,2015,429,3,1,1390,10500,1,0,0,3,6,1390,0,1940,1940,98024,47.567,121.89,1350,9800,75,0,4,2740,11190
6e+05,2015,369,4,2.25,2840,31720,1,0,0,3,8,1780,1060,1958,1958,98177,47.751,122.38,2290,29577,57,0,6.25,5130,32417
5.25e+05,2014,319,4,1.5,1430,6380,1,0,0,4,7,1130,300,1945,1945,98115,47.694,122.32,1570,6380,69,0,5.5,3000,7810
4.13e+05,2014,194,3,2,1520,3451,1,0,0,3,8,1520,0,1996,1996,98177,47.775,122.38,1800,3451,18,0,5,3320,4971
6.45e+05,2014,133,3,2.5,1740,13750,2,0,0,4,9,1740,0,1975,1975,98008,47.626,122.09,2540,14300,39,0,5.5,4280,16040
2.53e+05,2014,134,4,2.5,2230,4541,2,0,0,3,7,2230,0,2006,2006,98042,47.385,122.1,2800,4860,8,0,6.5,5030,7090
1.65e+05,2014,232,3,2.5,1660,2415,2,0,0,3,7,1660,0,1983,1983,98042,47.376,122.15,1740,2624,31,0,5.5,3400,4284
6.6e+05,2014,249,3,2.5,2650,11250,2,0,0,3,9,2650,0,2005,2005,98155,47.764,122.29,2200,10013,9,0,5.5,4850,12663
8.6e+05,2014,150,3,2.25,3060,12095,2,0,0,3,10,3060,0,1983,1983,98006,47.561,122.11,3060,11455,31,0,5.25,6120,14515
4.95e+05,2015,438,4,2.25,2070,20280,2,0,0,4,7,2070,0,1968,1968,98072,47.774,122.13,2190,21560,47,0,6.25,4260,23630
2.43e+05,2015,362,3,1.75,1320,10416,1,0,0,3,7,1320,0,1996,1996,98031,47.39,122.21,1670,7991,19,0,4.75,2990,9311
3.44e+05,2015,372,1,1.5,760,779,3,0,0,3,8,760,0,2006,2006,98107,47.672,122.38,1290,1189,9,0,2.5,2050,1949
3.5e+05,2014,348,3,1.75,1480,9375,1,0,0,4,7,1480,0,1957,1957,98146,47.508,122.37,1370,9000,57,0,4.75,2850,10480
2.0013e+05,2014,251,3,2.5,2040,15463,1,0,0,3,8,1340,700,1968,1968,98003,47.333,122.32,2370,12672,46,0,5.5,4410,14712
1.738e+06,2014,185,4,2.25,2920,6513,2,0,0,4,9,2260,660,1937,1937,98112,47.638,122.29,4510,9248,77,0,6.25,7430,12168
2.42e+05,2014,345,4,2.5,1750,11400,2,0,0,4,7,1750,0,1975,1975,98023,47.315,122.39,1890,9024,39,0,6.5,3640,10774
3.9995e+05,2015,392,4,2.75,1920,4400,1,0,0,4,6,960,960,1906,1906,98106,47.553,122.36,1040,4400,109,0,6.75,2960,6320
4.212e+05,2014,271,3,2.5,1440,3060,2,0,0,3,7,1440,0,2003,2003,98053,47.682,122.03,1650,3060,11,0,5.5,3090,4500
2.35e+05,2014,252,3,1,1020,6173,1,0,0,3,6,780,240,1948,1948,98168,47.504,122.33,1330,5909,66,0,4,2350,6929
2.64e+05,2014,256,1,1,710,4725,1,0,0,3,6,710,0,1939,1939,98133,47.733,122.34,900,5250,75,0,2,1610,5960
5.4253e+05,2014,166,4,2.5,2650,5600,2,0,0,3,8,2650,0,2014,2014,98059,47.479,122.12,2650,5600,0,0,6.5,5300,8250
4.625e+05,2014,231,3,2.25,2350,51400,1,0,0,3,7,1390,960,1977,1977,98077,47.742,122.05,2350,51400,37,0,5.25,4700,53750
7.48e+05,2015,481,3,2.5,2600,10183,1,0,0,3,8,1300,1300,2004,2004,98033,47.698,122.2,1860,10401,11,0,5.5,4460,13001
2.3e+05,2014,244,5,1,1920,19040,1,0,0,3,7,1160,760,1961,1961,98168,47.476,122.29,1920,11520,53,0,6,3840,13440
2.77e+05,2015,453,4,1,1500,5750,1,0,0,3,6,1500,0,1925,1925,98055,47.477,122.21,1330,5750,90,0,5,2830,7250
1.225e+06,2014,361,4,2.5,2600,11542,1,0,0,4,9,2200,400,1939,1939,98177,47.708,122.38,2840,10960,75,0,6.5,5440,13560
2.5378e+05,2014,168,4,2,2030,9600,1,0,0,3,6,1430,600,1947,1947,98188,47.446,122.27,1820,14600,67,0,6,3850,16630
3.87e+05,2014,291,2,2.5,1170,1394,2,0,0,3,8,1170,0,2001,2001,98122,47.613,122.3,1250,3136,13,0,4.5,2420,4306
3.3e+05,2014,297,3,2,2500,10697,1,0,0,3,8,2500,0,1994,1994,98022,47.193,122.01,2560,9772,20,0,5,5060,12272
3.07e+06,2014,320,3,2.5,3930,55867,1,1,4,4,8,2330,1600,1957,1957,98034,47.702,122.22,2730,26324,57,0,5.5,6660,30254
5.99e+05,2014,303,3,1.75,1650,1180,3,0,0,3,8,1650,0,2014,2014,98105,47.664,122.32,1650,1960,0,0,4.75,3300,3610
7.06e+05,2014,162,3,2.75,1900,6400,1,0,0,5,7,1410,490,1942,1942,98105,47.67,122.28,1350,6400,72,0,5.75,3250,8300
3.26e+05,2014,173,3,1,1030,9834,1,0,0,3,7,1030,0,1969,1969,98072,47.768,122.16,1210,9875,45,0,4,2240,10905
3.24e+05,2014,129,3,2.25,998,904,2,0,0,3,7,798,200,2007,2007,98117,47.698,122.37,998,1110,7,0,5.25,1996,2108
2.999e+05,2014,245,4,2.5,2200,5730,2,0,0,3,8,2200,0,2003,2003,98042,47.348,122.15,2200,5772,11,0,6.5,4400,7972
2.255e+05,2014,176,2,1.75,1590,11276,1,0,0,4,7,1590,0,1972,1972,98002,47.318,122.21,1750,10687,42,0,3.75,3340,12277
5.45e+05,2015,486,3,2,1900,9975,1,0,0,3,8,1500,400,1973,1973,98027,47.531,122.05,2140,9825,42,0,5,4040,11725
3.7926e+05,2014,221,3,2.5,1730,7202,1,0,0,3,7,1330,400,1991,1991,98198,47.41,122.33,2100,8125,23,0,5.5,3830,9855
2.5e+05,2014,217,3,1,1700,7700,1,0,0,3,7,1120,580,1960,1960,98168,47.511,122.32,1700,8800,54,0,4,3400,10500
6.625e+05,2015,453,3,2.5,3560,9796,1,0,0,3,8,1860,1700,1965,1965,98007,47.601,122.14,2210,8925,50,0,5.5,5770,12485
3.8e+05,2014,160,4,1.5,1680,11123,1,0,0,3,7,1130,550,1959,1959,98177,47.757,122.36,1770,10103,55,0,5.5,3450,11783
2.75e+05,2015,450,4,1,1770,7345,1,0,0,3,7,1770,0,1966,1966,98106,47.539,122.35,1580,7345,49,0,5,3350,9115
9.4e+05,2015,400,4,2.5,3090,9238,1,0,3,4,8,1680,1410,1967,1967,98006,47.565,122.16,2690,8500,48,0,6.5,5780,11590
2.65e+05,2014,272,3,2.5,1400,3368,2,0,0,3,7,1400,0,2013,2013,98146,47.513,122.34,1400,4316,1,0,5.5,2800,5716
3.05e+05,2014,140,2,2.5,1590,2656,2,0,0,3,7,1220,370,2009,2009,98106,47.549,122.36,1590,2306,5,0,4.5,3180,3896
3.63e+05,2014,339,2,1,1120,4800,1,0,0,3,7,770,350,1926,1926,98126,47.567,122.37,1510,4800,88,0,3,2630,5920
3.2e+05,2015,478,4,1.5,1310,1.3721e+05,1,0,0,4,7,1310,0,1926,1926,98198,47.362,122.32,1310,9450,89,0,5.5,2620,10760
2.87e+05,2014,279,4,2.5,2240,4648,2,0,0,3,7,2240,0,2005,2005,98001,47.338,122.26,2221,4557,9,0,6.5,4461,6797
3.595e+05,2015,471,6,3.75,3190,4700,2,0,0,3,8,3190,0,2003,2003,98042,47.372,122.11,2680,5640,12,0,9.75,5870,8830
3.43e+05,2015,447,2,1.5,1100,1228,2,0,0,3,7,900,200,2007,2007,98118,47.554,122.28,1340,1380,8,0,3.5,2440,2480
8.75e+05,2014,307,3,1,1220,8119,1,0,0,4,7,1220,0,1955,1955,98039,47.633,122.24,1910,8119,59,0,4,3130,9339
5.225e+05,2014,222,3,1.75,1710,9707,1,0,0,4,8,1710,0,1966,1966,98008,47.623,122.11,1820,8700,48,0,4.75,3530,10410
3.7e+05,2015,488,4,2,1950,3757,1,0,0,4,6,1160,790,1908,1908,98118,47.537,122.27,1720,3757,107,0,6,3670,5707
7.95e+05,2014,155,4,2.25,2070,13084,1,0,0,4,8,1700,370,1967,1967,98040,47.561,122.22,2520,10180,47,0,6.25,4590,12250
2.7e+05,2014,191,3,2.5,1690,7165,2,0,0,4,7,1690,0,1992,1992,98038,47.35,122.06,1410,8590,22,0,5.5,3100,10280
5.4e+05,2015,451,2,1.75,1240,4120,1,0,0,4,7,890,350,1906,1906,98105,47.669,122.31,1640,3740,109,0,3.75,2880,4980
5.7995e+05,2015,487,4,2.75,2460,8643,2,0,0,3,9,2460,0,2011,2011,98059,47.483,122.13,3110,8626,4,0,6.75,5570,11086
5.27e+05,2014,244,4,2.25,2330,19436,2,0,0,3,8,2330,0,1987,1987,98011,47.766,122.22,1910,10055,27,0,6.25,4240,12385
9.9e+05,2014,320,4,2.5,3140,11049,2,0,0,3,10,3140,0,1988,1988,98004,47.582,122.19,2750,11049,26,0,6.5,5890,14189
4.77e+05,2014,147,4,2.75,1720,6270,2,0,0,3,8,1720,0,1978,1978,98118,47.546,122.27,2130,8700,36,0,6.75,3850,10420
4.9e+05,2014,320,3,1.75,1560,9247,1,0,0,3,7,1160,400,1989,1989,98033,47.695,122.17,1690,8772,25,0,4.75,3250,10332
5.2495e+05,2015,415,3,1.5,2700,24539,2,0,0,3,7,2120,580,1977,2014,98019,47.735,121.98,1830,11000,38,1,4.5,4530,13700
4.6e+05,2014,277,3,1.75,2560,8400,1,0,0,3,7,1970,590,1959,1959,98011,47.767,122.2,1970,8400,55,0,4.75,4530,10960
4.86e+05,2015,453,4,3,2260,7336,2,0,0,4,7,2260,0,1977,1977,98034,47.73,122.22,2200,7724,38,0,7,4460,9984
6.65e+05,2014,255,3,2.5,2630,10047,2,0,0,3,9,2630,0,1996,1996,98027,47.551,122.08,2640,10620,18,0,5.5,5270,13250
5.89e+05,2014,346,4,1,2210,4366,2,0,0,3,8,2210,0,1901,1901,98122,47.611,122.31,1740,1745,113,0,5,3950,3955
3.85e+05,2014,242,3,2.25,1630,1598,3,0,0,3,8,1630,0,2008,2008,98103,47.69,122.35,1320,1605,6,0,5.25,2950,3235
5.25e+05,2014,292,3,1.75,1710,7350,1,0,0,3,8,1280,430,1981,1981,98033,47.699,122.17,2100,7560,33,0,4.75,3810,9270
2.78e+05,2014,284,4,2.5,2290,3777,2,0,0,3,7,2290,0,2004,2004,98198,47.362,122.31,1480,3608,10,0,6.5,3770,5898
3.5e+05,2015,422,3,1,1150,12877,1,0,0,4,6,1150,0,1970,1970,98053,47.661,122.06,1490,12150,45,0,4,2640,13300
9.75e+05,2014,163,5,2.75,3100,10014,1,0,2,4,9,1660,1440,1973,1973,98040,47.573,122.21,3230,10279,41,0,7.75,6330,13379
6.45e+05,2014,195,4,2.75,2330,3917,2,0,0,3,9,2330,0,2004,2004,98029,47.553,121.99,2620,4400,10,0,6.75,4950,6730
4.75e+05,2014,305,3,2.5,2220,60984,2,0,0,4,8,2220,0,1987,1987,98027,47.48,122.05,1930,55333,27,0,5.5,4150,57553
5.51e+05,2014,237,5,3.75,3090,4943,2,0,0,3,10,3090,0,2010,2010,98058,47.459,122.13,3191,5561,4,0,8.75,6281,8651
5.09e+05,2014,294,4,2.5,2600,9355,1,0,0,3,9,1840,760,1983,1983,98028,47.745,122.25,2250,7691,31,0,6.5,4850,10291
3.915e+05,2014,187,3,2.5,1920,9625,2,0,0,3,8,1920,0,1993,1993,98045,47.488,121.8,1920,10343,21,0,5.5,3840,12263
3.09e+05,2014,168,3,2.25,1490,1294,2,0,0,3,7,1220,270,2010,2010,98106,47.557,122.36,1490,1283,4,0,5.25,2980,2773
4.85e+05,2015,413,3,1,1260,3230,1,0,0,3,7,1260,0,1907,1907,98119,47.644,122.37,1700,3500,108,0,4,2960,4760
5.685e+05,2014,244,4,2.5,3010,6181,2,0,0,3,9,3010,0,2000,2000,98056,47.521,122.19,2960,6515,14,0,6.5,5970,9525
4.28e+05,2014,127,2,2,1350,3900,1,0,0,3,8,1350,0,2003,2003,98053,47.709,122.03,1440,3900,11,0,4,2790,5250
4.955e+05,2015,395,3,2.5,3190,7828,2,0,0,3,9,3190,0,2006,2006,98059,47.505,122.14,2970,7828,9,0,5.5,6160,11018
5.5e+05,2014,304,4,2.25,1650,7200,1,0,0,3,8,1650,0,1967,1967,98008,47.638,122.12,2180,7950,47,0,6.25,3830,9600
4.55e+05,2015,488,4,2.5,1770,13168,2,0,0,3,7,1770,0,1990,1990,98019,47.731,121.97,2050,14859,25,0,6.5,3820,16629
4.235e+05,2014,229,3,2.25,1890,7498,1,0,0,3,7,1190,700,1987,1987,98125,47.73,122.3,1660,8100,27,0,5.25,3550,9990
2.5275e+05,2014,176,4,1,1230,7410,1,0,0,3,7,1230,0,1944,1944,98166,47.48,122.34,1020,7648,70,0,5,2250,8878
4.02e+05,2014,215,5,2.75,2160,7200,1,0,0,3,7,1220,940,1955,1955,98118,47.558,122.27,1900,7200,59,0,7.75,4060,9360
2.85e+05,2014,232,3,2,2110,6900,1,0,0,5,6,1220,890,1955,1955,98178,47.504,122.26,1350,7683,59,0,5,3460,9793
3.45e+05,2014,325,3,1,1620,10610,1,0,0,4,6,1620,0,1958,1958,98059,47.474,122.13,1680,10795,56,0,4,3300,12415
1.7e+06,2014,218,4,3.5,4330,15335,2,0,0,4,11,3230,1100,1988,1988,98040,47.532,122.23,3840,14311,26,0,7.5,8170,18641
4.19e+05,2015,462,4,2.25,1880,9727,1,0,0,3,7,1100,780,1979,1979,98028,47.773,122.26,1790,10274,36,0,6.25,3670,12154
2.02e+05,2015,387,2,1,670,7844,1,0,0,3,6,670,0,1942,1942,98126,47.517,122.37,740,7218,73,0,3,1410,7888
2.45e+05,2015,491,1,1,390,2000,1,0,0,4,6,390,0,1920,1920,98103,47.694,122.35,1340,5100,95,0,2,1730,5490
2.9e+05,2014,305,4,1,1330,8184,1,0,0,3,7,1330,0,1949,1949,98133,47.734,122.35,1220,660,65,0,5,2550,1990
7.95e+05,2014,162,3,2,2420,17859,1,0,1,5,9,1500,920,1979,1979,98034,47.707,122.25,2955,17859,35,0,5,5375,20279
1.01e+06,2014,161,4,2.5,3760,29224,2,0,0,3,11,3760,0,1987,1987,98052,47.72,122.13,3930,19916,27,0,6.5,7690,23676
2.3e+05,2015,387,3,1,880,9035,1,0,0,4,6,880,0,1967,1967,98059,47.476,122.15,1440,10350,48,0,4,2320,11230
7.255e+05,2014,211,4,2.5,2790,74495,2,0,0,3,9,2790,0,1997,1997,98053,47.663,122.06,2790,24643,17,0,6.5,5580,27433
4.85e+05,2014,203,4,2.5,2420,10603,1,0,0,5,7,1210,1210,1958,1958,98028,47.74,122.26,1750,10800,56,0,6.5,4170,13220
1.3388e+06,2014,245,3,2.75,2730,38869,1,1,4,3,9,1940,790,1963,2001,98146,47.486,122.36,2630,28188,51,1,5.75,5360,30918
4.97e+05,2014,194,3,1.5,2240,28750,1,0,0,3,8,1620,620,1956,1956,98034,47.714,122.25,3200,23873,58,0,4.5,5440,26113
7.07e+05,2015,365,5,4.5,3540,21217,2,0,0,4,8,2940,600,1926,1926,98188,47.427,122.28,1290,12040,89,0,9.5,4830,15580
6.675e+05,2014,319,3,1.75,2130,20423,1,0,0,3,9,2130,0,1953,1953,98004,47.634,122.19,2370,20875,61,0,4.75,4500,23005
7.25e+05,2015,481,3,2.5,2810,6300,2,0,0,3,8,2810,0,2001,2001,98074,47.608,122.02,2860,6630,14,0,5.5,5670,9440
1.465e+06,2015,362,4,4,4930,22093,2,0,3,3,12,4930,0,2004,2004,98075,47.587,121.97,4630,18889,11,0,8,9560,23819
6e+05,2014,361,3,1.75,1410,4080,1,0,0,4,7,1000,410,1950,1950,98117,47.681,122.38,1410,4080,64,0,4.75,2820,5490
3.2995e+05,2014,125,2,1,1140,5250,1,0,0,4,6,1140,0,1949,1949,98133,47.731,122.34,1450,5250,65,0,3,2590,6390
8.4e+05,2014,251,4,3.5,2840,40139,1,0,4,4,10,2840,0,1986,1986,98038,47.401,122.03,3180,36852,28,0,7.5,6020,39692
4.65e+05,2015,374,3,2.5,2714,17936,2,0,0,3,9,2714,0,2005,2005,98001,47.319,122.28,2590,18386,10,0,5.5,5304,21100
7.35e+05,2015,415,6,2.75,3360,84506,1,0,0,5,7,2040,1320,1962,1962,98052,47.715,122.12,2190,43124,53,0,8.75,5550,46484
2.15e+05,2015,458,3,1,1010,10125,1,0,0,4,7,1010,0,1972,1972,98042,47.342,122.09,1230,10125,43,0,4,2240,11135
1.82e+05,2014,266,3,1,1060,7350,1,0,0,4,7,1060,0,1959,1959,98032,47.381,122.29,1060,7350,55,0,4,2120,8410
8.58e+05,2015,422,4,2.25,3070,13720,2,0,0,3,9,3070,0,1978,1978,98007,47.613,122.15,3010,9657,37,0,6.25,6080,12727
8.63e+05,2014,163,4,2.5,4120,22370,2,0,0,3,10,4120,0,1997,1997,98074,47.624,122.02,3180,7257,17,0,6.5,7300,11377
5.8e+05,2015,388,2,1.5,1460,5700,1,0,0,3,7,1460,0,1912,1912,98115,47.684,122.31,1780,3800,103,0,3.5,3240,5260
4.35e+05,2014,188,4,2.5,2150,3143,2,0,0,3,7,2150,0,2010,2010,98059,47.505,122.15,2640,3200,4,0,6.5,4790,5350
3.76e+05,2014,223,6,2.5,2420,11662,1,0,2,4,7,1420,1000,1965,1965,98188,47.446,122.28,1630,11662,49,0,8.5,4050,14082
5.49e+05,2014,204,2,2,1980,6000,1,0,0,5,7,1220,760,1906,1906,98103,47.681,122.35,1280,3900,108,0,4,3260,5880
5.65e+05,2015,399,4,1,2170,12100,1,0,0,5,7,2170,0,1961,1961,98033,47.689,122.16,1270,12844,54,0,5,3440,15014
3.25e+05,2014,244,4,1,1400,9384,1,0,0,4,6,1400,0,1948,1948,98106,47.517,122.36,1600,8432,66,0,5,3000,9832
5.55e+05,2014,225,2,1.5,1780,4750,1,0,0,4,7,1080,700,1947,1947,98117,47.686,122.39,1690,5962,67,0,3.5,3470,7742
2.95e+05,2014,177,1,1,700,2500,1,0,0,4,7,700,0,1907,1907,98106,47.566,122.36,1340,5000,107,0,2,2040,5700
3e+05,2014,168,3,2.5,1700,3575,2,0,0,3,7,1700,0,2000,2000,98108,47.542,122.3,1590,3380,14,0,5.5,3290,5080
4.65e+05,2014,222,2,1.5,1220,1120,2,0,0,3,8,1110,110,2008,2008,98199,47.637,122.39,2010,3175,6,0,3.5,3230,4395
1.15e+06,2015,463,4,2.5,2330,30122,1,0,1,3,8,1490,840,1951,1951,98115,47.684,122.27,2430,6726,64,0,6.5,4760,9056
7.75e+05,2015,466,3,2.5,3550,32807,2,0,0,3,9,3550,0,1989,1989,98077,47.729,122.08,3270,35001,26,0,5.5,6820,38551
9.68e+05,2014,148,6,2.75,3610,17580,1,0,4,5,9,2070,1540,1959,1959,98075,47.574,122.07,2890,14060,55,0,8.75,6500,17670
2.7e+05,2014,148,3,1.75,1300,4127,1,0,0,4,6,650,650,1918,1953,98106,47.535,122.35,1420,4000,96,1,4.75,2720,5300
3.2e+05,2015,472,4,2.25,1550,7579,2,0,0,3,8,1550,0,1993,1993,98038,47.354,122.05,1630,6397,22,0,6.25,3180,7947
7.75e+05,2014,340,3,2.5,3820,35016,2,0,0,4,9,3820,0,1987,1987,98053,47.65,122.04,3010,35190,27,0,5.5,6830,39010
3.15e+05,2015,456,2,1,630,6550,1,0,0,3,5,630,0,1918,1918,98126,47.549,122.38,1420,6550,97,0,3,2050,7180
6.9985e+05,2014,166,4,3.5,2690,6164,2,0,0,3,9,2690,0,2002,2002,98075,47.599,121.97,2910,5000,12,0,7.5,5600,7690
8.32e+05,2015,373,4,2.25,3190,52953,2,0,0,4,10,3190,0,1980,1980,98075,47.593,122.08,3190,51400,35,0,6.25,6380,54590
4.25e+05,2015,483,4,1.75,2520,11017,1,0,0,4,7,1320,1200,1956,1956,98133,47.76,122.36,1660,8775,59,0,5.75,4180,11295
2e+05,2015,375,4,2.5,1720,8638,2,0,0,3,8,1720,0,1994,1994,98003,47.27,122.31,1870,7455,21,0,6.5,3590,9175
4.15e+05,2014,353,2,1,760,4000,1,0,0,3,7,760,0,1944,1944,98117,47.69,122.4,1520,4000,70,0,3,2280,4760
4.81e+05,2014,187,4,2.5,2286,8269,2,0,0,3,8,2286,0,2002,2002,98056,47.517,122.19,2110,4711,12,0,6.5,4396,6997
4.182e+05,2015,414,3,2.5,2260,74297,2,0,0,3,9,2260,0,1992,1992,98022,47.27,122.01,3110,98000,23,0,5.5,5370,1.0026e+05
4.55e+05,2015,368,2,1,1070,5150,1,0,0,4,6,870,200,1908,1908,98117,47.685,122.37,1520,3860,107,0,3,2590,4930
3.8638e+05,2014,135,3,2.5,1720,3600,2,0,0,3,7,1720,0,2010,2010,98053,47.686,122.01,1720,3600,4,0,5.5,3440,5320
6.9e+05,2015,393,2,2.5,1990,1756,3,0,0,3,9,1780,210,2005,2005,98102,47.626,122.32,1955,1438,10,0,4.5,3945,3428
3.25e+05,2014,345,3,2,2330,4950,1,0,0,3,6,1430,900,1900,1900,98118,47.559,122.29,1160,5115,114,0,5,3490,7445
4.335e+05,2014,203,3,1,1230,6000,1,0,0,4,7,780,450,1937,1937,98115,47.684,122.28,1570,5000,77,0,4,2800,6230
3.25e+05,2014,263,4,2.5,1930,8458,2,0,0,3,7,1930,0,1993,1993,98038,47.364,122.04,1670,9485,21,0,6.5,3600,11415
2.8e+05,2015,472,2,1,1310,6600,1,0,0,3,6,1310,0,1942,1942,98168,47.483,122.33,1240,6600,73,0,3,2550,7910
2.75e+05,2014,195,3,1.5,1060,6954,1,0,0,4,6,1060,0,1983,1983,98106,47.55,122.36,1560,6954,31,0,4.5,2620,8014
1.69e+05,2014,266,3,1,910,7686,1,0,0,3,7,910,0,1969,1969,98001,47.34,122.29,1020,7686,45,0,4,1930,8596
2.41e+05,2015,409,3,2,1650,6000,1,0,0,3,7,1650,0,1990,1990,98023,47.29,122.35,1870,6000,25,0,5,3520,7650
3.065e+05,2015,410,3,1.5,1100,8140,1,0,0,4,7,1100,0,1965,1965,98059,47.5,122.16,1430,7700,50,0,4.5,2530,8800
3.035e+05,2015,374,6,4.5,3390,7200,2,0,0,3,8,2440,950,2007,2007,98118,47.52,122.29,2040,7214,8,0,10.5,5430,10604
3.1e+05,2014,134,3,1,1480,7830,1,0,0,3,7,1480,0,1952,1952,98133,47.77,122.34,1450,7830,62,0,4,2930,9310
3.4e+05,2014,271,3,2.5,2690,8577,2,0,0,3,9,2690,0,1987,1987,98023,47.303,122.35,2570,8066,27,0,5.5,5260,10756
4.155e+05,2014,262,3,1.5,1240,12400,1,0,0,3,7,1240,0,1958,1958,98007,47.607,122.13,1640,9600,56,0,4.5,2880,10840
3.45e+05,2015,446,3,1,1250,17380,1,0,0,4,7,1250,0,1970,1970,98072,47.75,122.11,1410,18200,45,0,4,2660,19450
3e+05,2014,229,4,2,1640,7200,1,0,0,5,6,820,820,1944,1944,98166,47.479,122.35,1640,8200,70,0,6,3280,9840
2.89e+05,2015,459,2,1.75,2056,52333,1,0,0,4,7,1048,1008,1980,1980,98001,47.259,122.29,2220,6458,35,0,3.75,4276,8514
3.65e+05,2014,235,4,2.5,1800,5070,1,0,0,5,7,1080,720,1979,1979,98118,47.53,122.28,1870,5365,35,0,6.5,3670,7165
8.5e+05,2014,305,2,2,2640,13939,1,0,1,5,8,1640,1000,1963,1963,98006,47.565,122.17,2880,14810,51,0,4,5520,17450
2.6e+05,2014,122,4,2,1480,8625,1,0,0,4,7,1480,0,1974,1974,98055,47.462,122.19,2130,8502,40,0,6,3610,9982
4.25e+05,2014,266,2,2,1280,4095,2,0,0,4,8,1280,0,1918,1918,98136,47.55,122.39,1470,5500,96,0,4,2750,6780
3.8e+05,2015,479,3,2.25,2530,12042,2,0,0,3,8,2530,0,1989,1989,98042,47.374,122.13,2480,10172,26,0,5.25,5010,12702
7.125e+05,2015,478,4,2.75,2420,11201,1,0,1,3,8,1420,1000,1948,1999,98118,47.546,122.27,3170,9385,67,1,6.75,5590,11805
3.66e+05,2014,221,3,2,1350,10200,1,0,0,3,7,1350,0,1977,1977,98074,47.616,122.05,1820,9600,37,0,5,3170,10950
4.52e+05,2015,438,5,2.5,5067,13315,1,0,2,3,9,3154,1913,1968,1968,98003,47.339,122.33,2860,13957,47,0,7.5,7927,19024
1.89e+05,2014,303,2,1,790,7128,1,0,0,3,6,790,0,1944,1944,98168,47.487,122.32,1110,7150,70,0,3,1900,7940
7.65e+05,2015,393,3,1,1270,6500,1,0,0,4,7,1270,0,1956,1956,98033,47.687,122.21,2260,7200,59,0,4,3530,8470
2.399e+05,2014,215,4,1.75,1570,18730,1,0,0,3,7,1200,370,1960,1960,98198,47.4,122.3,1920,18295,54,0,5.75,3490,19865
3.77e+05,2015,451,4,1.75,1800,8385,1,0,0,5,6,900,900,1950,1950,98133,47.774,122.34,1770,8385,65,0,5.75,3570,10185
4.5e+05,2014,203,3,2.25,1760,10013,2,0,0,4,8,1760,0,1983,1983,98056,47.534,122.19,1810,9768,31,0,5.25,3570,11528
5.05e+05,2015,439,3,2,1260,5460,1,0,0,3,7,1260,0,1972,1972,98034,47.736,122.18,1510,5460,43,0,5,2770,6720
1.1e+05,2014,255,1,1,640,10280,1,0,0,2,5,640,0,1920,1920,98126,47.514,122.37,1090,9000,94,0,2,1730,9640
6.325e+05,2015,424,4,2,1770,5000,2,0,0,4,7,1770,0,1906,1906,98107,47.675,122.39,1550,5000,109,0,6,3320,6770
5.65e+05,2014,244,5,3.5,2700,11675,1,0,2,4,6,1950,750,1948,1948,98133,47.717,122.35,2160,8114,66,0,8.5,4860,10814
3.525e+05,2015,460,3,1.75,1860,7881,1,0,0,3,7,1160,700,1986,1986,98198,47.386,122.32,1490,7527,29,0,4.75,3350,9387
3.58e+05,2015,374,3,2.25,2510,12013,2,0,0,3,8,2510,0,1988,1988,98003,47.347,122.31,1870,8017,27,0,5.25,4380,10527
6.9e+05,2015,410,4,3.5,2710,2147,2,0,0,3,10,2220,490,2007,2007,98029,47.547,121.99,2650,2252,8,0,7.5,5360,4962
3.6e+05,2014,230,3,2.25,2200,8000,2,0,0,3,8,2200,0,1981,1981,98055,47.452,122.21,2170,8000,33,0,5.25,4370,10200
5.13e+05,2014,297,4,2,2090,4000,1,0,0,3,7,1480,610,1951,1951,98107,47.675,122.38,1510,5000,63,0,6,3600,7090
7e+05,2014,341,4,1.75,1950,7139,1,1,4,3,7,1150,800,1957,1957,98178,47.512,122.25,1600,13122,57,0,5.75,3550,15072
4.25e+05,2014,175,3,2.5,2320,2267,3,0,0,3,8,2320,0,2009,2009,98177,47.703,122.36,1240,1883,5,0,5.5,3560,4203
5e+05,2014,177,4,1,1440,7100,1,0,0,3,7,1440,0,1906,1906,98107,47.672,122.4,1490,5000,108,0,5,2930,6440
2.87e+05,2015,438,2,1,950,6350,1,0,0,3,7,950,0,1951,1951,98106,47.528,122.35,1080,7620,64,0,3,2030,8570
2.45e+05,2015,481,3,1.75,1740,11547,1,0,0,3,7,1740,0,1954,1954,98178,47.495,122.22,880,78408,61,0,4.75,2620,80148
4.025e+05,2014,181,2,1,800,2280,1,0,0,5,6,800,0,1946,1946,98107,47.659,122.36,1310,4200,68,0,3,2110,5000
1.65e+05,2014,155,3,1,1150,19200,1,0,0,4,5,1150,0,1908,1908,98001,47.276,122.27,1290,19200,106,0,4,2440,20350
4.6e+05,2014,242,3,1,1140,4600,1,0,0,3,7,1140,0,1942,1942,98103,47.69,122.34,1370,5000,72,0,4,2510,6140
2.35e+05,2014,128,2,1,1270,3008,1,0,0,4,6,650,620,1923,1923,98118,47.535,122.28,1270,1514,91,0,3,2540,2784
4.89e+05,2015,440,4,1,1150,5217,1,0,0,3,7,1150,0,1951,1951,98115,47.681,122.29,1220,5217,64,0,5,2370,6367
3.4e+05,2015,463,4,2.5,3020,8750,1,0,0,3,8,1710,1310,1960,1960,98188,47.43,122.29,1900,8750,55,0,6.5,4920,11770
6.61e+05,2014,340,3,2.5,1940,8196,2,0,0,3,8,1940,0,1991,1991,98052,47.679,122.15,2070,8514,23,0,5.5,4010,10454
5.895e+05,2014,177,3,3.25,2310,3075,2,0,0,3,8,1730,580,2005,2005,98116,47.564,122.38,2310,3075,9,0,6.25,4620,5385
2.25e+05,2014,148,3,2.5,1680,6755,2,0,0,3,8,1680,0,1994,1994,98092,47.329,122.17,1860,7257,20,0,5.5,3540,8937
6.8e+05,2014,306,4,3.5,2510,3763,2,0,0,3,8,1990,520,2013,2013,98052,47.7,122.1,2560,3820,1,0,7.5,5070,6330
1.1e+06,2015,414,4,3.5,4270,40097,1,0,0,4,12,4270,0,1993,1993,98077,47.735,122.08,3510,36149,22,0,7.5,7780,40419
2.28e+05,2014,204,2,1,1060,6100,1,0,0,3,6,1060,0,1951,1951,98125,47.732,122.3,1550,9150,63,0,3,2610,10210
2.55e+05,2015,425,3,2.25,1850,7151,2,0,0,3,7,1850,0,1989,1989,98023,47.284,122.35,1710,6827,26,0,5.25,3560,8677
3.5e+05,2014,190,4,2,1720,7210,1,0,0,3,7,860,860,1971,1971,98034,47.731,122.24,1250,7210,43,0,6,2970,8930
8.1e+05,2014,222,4,3.5,4170,4322,2,0,0,3,9,2940,1230,2005,2005,98074,47.614,122.04,2970,4922,9,0,7.5,7140,9092
7.06e+05,2014,257,4,2.5,2740,7571,2,0,0,3,9,2740,0,2009,2009,98033,47.696,122.18,2880,7203,5,0,6.5,5620,9943
3.65e+05,2015,474,3,1.75,1380,9134,1,0,0,5,7,880,500,1981,1981,98056,47.509,122.19,1400,8190,34,0,4.75,2780,9570
8e+05,2014,150,2,2.25,1730,31491,2,1,2,4,7,1730,0,1947,1988,98070,47.373,122.46,1400,12410,67,1,4.25,3130,14140
7.65e+05,2014,342,4,2.5,2910,15016,2,0,0,3,10,2910,0,1990,1990,98052,47.69,122.1,2870,13992,24,0,6.5,5780,16902
2.5e+05,2014,229,2,1,750,6350,1,0,0,3,5,750,0,1920,1920,98103,47.694,122.36,920,6350,94,0,3,1670,7100
5.46e+05,2014,134,3,1.75,2000,5000,1,0,0,4,7,1110,890,1921,1921,98117,47.686,122.4,1750,5000,93,0,4.75,3750,7000
6.92e+05,2014,230,3,2.5,3490,28213,1,0,2,3,9,2242,1248,2009,2009,98070,47.365,122.46,2120,56628,5,0,5.5,5610,60118
3.5375e+05,2014,346,4,2,1710,7490,2,0,0,3,7,1320,390,1956,1956,98166,47.454,122.36,1880,7704,58,0,6,3590,9414
2.485e+05,2015,447,2,1.5,880,1498,2,0,0,3,7,880,0,1999,1999,98133,47.706,122.34,880,5060,16,0,3.5,1760,5940
2.691e+05,2015,403,3,2.5,2190,7904,2,0,0,3,8,2190,0,1995,1995,98092,47.262,122.21,2190,7669,20,0,5.5,4380,9859
4.93e+05,2014,286,4,2,1910,2874,1,0,0,3,7,1060,850,1910,1910,98122,47.61,122.3,1520,2874,104,0,6,3430,4784
3.86e+05,2014,271,5,2.5,2740,12413,2,0,0,3,7,2740,0,1990,1990,98031,47.42,122.18,1900,7416,24,0,7.5,4640,10156
3.15e+05,2015,386,2,1,1120,7350,1,0,0,3,7,1120,0,1942,1942,98155,47.765,122.31,1320,7545,73,0,3,2440,8665
3.5e+05,2015,387,3,1,1050,5518,1,0,0,3,7,1050,0,1948,1948,98118,47.556,122.28,1490,4269,67,0,4,2540,5319
4e+05,2014,149,4,2.75,1240,3867,1,0,0,3,7,800,440,1987,1987,98125,47.716,122.28,1150,7733,27,0,6.75,2390,8973
5e+05,2014,320,5,3,3720,25474,2,0,4,3,9,2090,1630,1986,1986,98001,47.33,122.26,1870,14547,28,0,8,5590,18267
3e+05,2015,438,3,1.75,1350,7370,1,0,0,4,6,1350,0,1912,1912,98118,47.534,122.28,1440,6000,103,0,4.75,2790,7350
3e+05,2014,248,3,1,1010,6300,1,0,0,3,7,1010,0,1957,1957,98133,47.73,122.35,1480,7480,57,0,4,2490,8490
4.14e+05,2014,236,4,2.5,3490,9030,1,0,0,4,8,3490,0,1969,1969,98023,47.32,122.39,2540,8400,45,0,6.5,6030,11890
5.35e+05,2014,286,5,2.75,2620,6389,2,0,0,3,9,2620,0,2007,2007,98028,47.77,122.24,2620,4504,7,0,7.75,5240,7124
3.465e+05,2015,470,5,2.5,2020,8250,1,0,0,4,8,1430,590,1978,1978,98058,47.443,122.14,1680,8959,37,0,7.5,3700,10979
2.93e+05,2015,397,4,2.5,2019,4435,2,0,3,3,8,2019,0,2008,2008,98022,47.196,121.97,1950,4800,7,0,6.5,3969,6819
4.75e+05,2014,263,5,2.5,2300,28480,2,0,0,3,6,2300,0,1994,1994,98053,47.64,121.96,1880,26720,20,0,7.5,4180,29020
3.87e+05,2015,492,3,1,1530,6372,1,0,0,3,7,1210,320,1962,1962,98118,47.535,122.29,1960,6426,53,0,4,3490,7956
8.7995e+05,2014,203,4,2.75,3020,7203,2,0,0,3,9,3020,0,2014,2014,98033,47.695,122.18,3010,7215,0,0,6.75,6030,10235
8.8e+05,2015,402,4,2.5,3550,8618,2,0,0,3,10,3550,0,2007,2007,98052,47.678,122.16,1310,9746,8,0,6.5,4860,13296
4.5e+05,2015,445,4,2.5,2240,4616,2,0,0,3,7,1840,400,2001,2001,98056,47.512,122.19,2260,5200,14,0,6.5,4500,7440
4.15e+05,2015,487,3,1.75,1770,10513,1,0,0,4,7,1400,370,1982,1982,98028,47.773,122.27,2070,9968,33,0,4.75,3840,11738
3.7e+05,2014,135,4,2.5,2710,5880,2,0,0,3,9,2710,0,1998,1998,98092,47.331,122.17,2520,6000,16,0,6.5,5230,8710
6.1e+05,2014,287,3,2.5,2080,1.6727e+05,1,0,0,3,7,2080,0,2000,2000,98038,47.403,121.96,2080,55321,14,0,5.5,4160,57401
3.8e+05,2014,304,3,2.5,1840,6985,1,0,0,3,7,1290,550,1971,1971,98133,47.759,122.34,2160,7990,43,0,5.5,4000,9830
2.05e+05,2014,230,3,1.5,1120,8366,1,0,0,3,7,1120,0,1968,1968,98042,47.363,122.11,1260,9000,46,0,4.5,2380,10120
3.15e+05,2015,458,4,2.5,1700,6675,2,0,0,3,7,1700,0,1997,1997,98038,47.364,122.05,1570,7540,18,0,6.5,3270,9240
1.6995e+05,2014,256,3,1,1180,9832,1,0,0,3,7,1180,0,1970,1970,98042,47.385,122.08,1220,9894,44,0,4,2400,11074
3.5e+05,2014,202,2,2.5,1280,940,2,0,0,3,8,1060,220,2006,2006,98103,47.69,122.36,1290,2900,8,0,4.5,2570,4180
9.6e+05,2014,230,4,2.5,3110,11397,2,0,3,4,10,3110,0,1984,1984,98006,47.562,122.11,3110,11586,30,0,6.5,6220,14696
4.5e+05,2014,156,3,2.5,1480,1961,2,0,0,3,8,1480,0,2005,2005,98029,47.548,122,1400,1138,9,0,5.5,2880,2618
2.58e+05,2014,202,3,2,1390,7200,1,0,0,3,7,1390,0,1996,1996,98058,47.434,122.15,1630,7340,18,0,5,3020,8730
7.8e+05,2014,257,4,3,2440,3600,1,0,0,5,8,1480,960,1929,1929,98103,47.685,122.33,1770,4000,85,0,7,4210,6440
4.92e+05,2014,248,4,2.5,2550,6382,2,0,0,3,7,2550,0,2007,2007,98065,47.52,121.87,2430,5900,7,0,6.5,4980,8450
2.2e+05,2015,374,4,2,1700,8043,1,0,0,3,7,850,850,1954,1954,98168,47.476,122.29,1540,13260,61,0,6,3240,14960
4e+05,2014,154,3,2,2260,11305,1,0,0,3,7,1130,1130,1986,1986,98055,47.454,122.2,2080,10248,28,0,5,4340,12508
5.25e+05,2015,423,4,1.75,2120,7725,1,0,0,3,8,1220,900,1965,1965,98007,47.6,122.14,2160,7725,50,0,5.75,4280,9845
2.829e+05,2014,262,4,2.5,1710,3500,2,0,0,3,7,1710,0,2014,2014,98002,47.345,122.22,1710,3500,0,0,6.5,3420,5210
3.1e+05,2014,258,3,1,990,7050,1,0,0,3,7,990,0,1967,1967,98034,47.727,122.2,1200,8125,47,0,4,2190,9115
3.4e+05,2015,425,4,2.5,2320,4142,2,0,0,3,7,2320,0,2010,2010,98038,47.366,122.02,2150,4140,5,0,6.5,4470,6460
7.27e+05,2014,235,4,3,3150,9703,2,0,0,3,9,3150,0,2001,2001,98075,47.596,122.02,3150,8819,13,0,7,6300,11969
3.45e+05,2014,159,3,2.5,1210,1420,3,0,0,3,8,1210,0,2008,2008,98103,47.698,122.35,1190,1407,6,0,5.5,2400,2617
4.1e+05,2015,471,3,1,1330,5000,1,0,0,3,7,1120,210,1957,1957,98125,47.721,122.31,1920,7790,58,0,4,3250,9120
5.62e+05,2015,407,3,1.75,1600,10530,1,0,2,3,8,1600,0,1962,1962,98155,47.744,122.29,2590,8274,53,0,4.75,4190,9874
2.1e+05,2014,141,3,1,1240,4842,1,0,0,4,6,1240,0,1916,1916,98118,47.517,122.27,1540,5110,98,0,4,2780,6350
2.5e+05,2014,153,3,2.25,1765,7652,2,0,0,3,7,1765,0,1996,1996,98003,47.307,122.33,1765,7719,18,0,5.25,3530,9484
7.65e+05,2014,290,4,2.5,4040,25752,2,0,0,3,10,4040,0,2000,2000,98038,47.458,122.07,3230,22247,14,0,6.5,7270,26287
7.1325e+05,2014,153,3,2,2050,9000,1,0,0,4,7,2050,0,1951,1951,98040,47.589,122.25,2910,8856,63,0,5,4960,10906
2.4e+05,2015,451,3,1,1270,12733,1,0,0,3,7,1270,0,1955,1955,98188,47.445,122.28,1660,11536,60,0,4,2930,12806
1.08e+06,2014,181,3,2.75,3890,7216,2,0,1,3,8,3260,630,1967,2010,98118,47.544,122.27,2490,9920,47,1,5.75,6380,13810
9e+05,2015,458,3,2.5,1920,7200,2,0,2,3,10,1780,140,1997,1997,98116,47.571,122.41,2080,5000,18,0,5.5,4000,6920
1.6e+05,2014,334,3,1,1200,8360,1,0,0,2,6,1200,0,1948,1948,98118,47.541,122.28,1570,6823,66,0,4,2770,8023
5.75e+05,2014,163,3,3,1384,1287,2,0,0,3,8,1144,240,2006,2006,98102,47.63,122.32,1570,1288,8,0,6,2954,2672
2.575e+05,2014,202,4,1.5,1360,9323,1,0,0,4,7,1360,0,1968,1968,98023,47.317,122.4,1180,9611,46,0,5.5,2540,10971
6.2e+05,2015,487,3,1.75,1680,28046,1,0,3,3,8,1180,500,1948,1948,98177,47.765,122.37,2190,26308,67,0,4.75,3870,27988
2.35e+05,2015,426,4,2,1540,9279,1,0,0,3,7,1540,0,1955,1955,98118,47.516,122.27,1540,5110,60,0,6,3080,6650
9.1e+05,2014,292,4,2.5,3170,32430,2,0,0,3,10,3170,0,1989,1989,98053,47.69,122.06,3360,35610,25,0,6.5,6530,38780
2.9995e+05,2014,341,3,1.75,1980,11274,1,0,0,4,7,1480,500,1968,1968,98058,47.447,122.17,1520,8010,46,0,4.75,3500,9990
4.8495e+05,2015,367,3,2.25,1590,926,3,0,0,3,8,1590,0,2014,2014,98136,47.54,122.39,1640,1321,1,0,5.25,3230,2911
4.96e+05,2014,317,3,2.5,2180,4533,2,0,0,3,7,2180,0,2010,2010,98011,47.754,122.22,2180,7347,4,0,5.5,4360,9527
6.08e+05,2014,263,4,2.5,2410,7140,2,0,0,3,8,2410,0,1993,1993,98074,47.633,122.02,2350,7140,21,0,6.5,4760,9550
3.5995e+05,2014,249,3,1.75,1570,6975,1,0,0,3,7,1040,530,1979,1979,98126,47.514,122.37,1280,7813,35,0,4.75,2850,9383
5.76e+05,2014,201,4,2.5,2590,5756,2,0,0,3,8,2590,0,2001,2001,98065,47.536,121.88,2620,6109,13,0,6.5,5210,8699
3.39e+05,2014,176,2,1,950,7954,1,0,0,4,7,950,0,1941,1941,98108,47.557,122.31,1180,6828,73,0,3,2130,7778
2.25e+05,2014,204,3,1.5,1220,8345,1,0,0,3,7,1220,0,1931,1931,98178,47.504,122.27,1880,10169,83,0,4.5,3100,11389
6.95e+05,2014,243,5,3.25,3940,9780,2,0,0,3,9,3940,0,2007,2007,98065,47.544,121.89,3550,8468,7,0,8.25,7490,12408
4.4995e+05,2014,203,3,2.5,1530,3840,2,0,0,3,8,1530,0,1994,1994,98029,47.569,122.01,1720,3985,20,0,5.5,3250,5515
4.185e+05,2014,154,3,2.5,2060,4399,2,0,0,3,7,2060,0,2007,2007,98065,47.541,121.88,2060,4399,7,0,5.5,4120,6459
3.6995e+05,2015,458,3,2.5,1930,8254,2,0,0,3,7,1930,0,2014,2014,98146,47.497,122.35,1540,8849,1,0,5.5,3470,10779
2.9e+05,2014,279,2,0.75,440,8313,1,1,3,4,5,440,0,1943,1943,98070,47.434,122.51,880,26289,71,0,2.75,1320,26729
7.4e+05,2014,345,4,2.5,2300,9900,1,0,2,3,8,1600,700,1961,1961,98136,47.526,122.39,2510,7500,53,0,6.5,4810,9800
4.1e+05,2014,188,3,2,1320,6000,1,0,0,4,7,1320,0,1920,1920,98144,47.575,122.3,1620,4000,94,0,5,2940,5320
7e+05,2014,196,4,2.5,2590,4498,2,0,0,3,9,2590,0,2004,2004,98052,47.705,122.13,2660,5238,10,0,6.5,5250,7828
4.06e+05,2015,472,3,1,960,5264,1,0,0,3,7,960,0,1953,1953,98115,47.681,122.3,1140,5150,62,0,4,2100,6110
4.5e+05,2014,140,3,1.5,2060,44866,1,0,0,3,8,2060,0,1953,1953,98077,47.75,122.05,2320,43995,61,0,4.5,4380,46055
4.12e+05,2014,242,3,2.5,1553,1991,3,0,0,3,8,1553,0,2014,2014,98133,47.705,122.34,1509,2431,0,0,5.5,3062,3984
6.9e+05,2014,202,4,3.25,3730,11820,2,0,0,3,10,2460,1270,1990,1990,98029,47.578,122.02,3680,10667,24,0,7.25,7410,14397
3.249e+05,2014,163,4,2.5,1880,7965,2,0,0,3,7,1880,0,2000,2000,98038,47.364,122.05,1570,7584,14,0,6.5,3450,9464
4.35e+05,2015,456,3,1,950,10080,1,0,0,4,7,950,0,1954,1954,98006,47.572,122.14,1060,10000,61,0,4,2010,10950
6.05e+05,2015,426,4,2.75,1670,6000,1,0,0,5,7,840,830,1917,1917,98136,47.55,122.39,1100,6000,98,0,6.75,2770,7670
5.18e+05,2014,174,4,2.75,2520,14021,2,0,0,3,9,2520,0,1999,1999,98019,47.734,121.96,2330,14007,15,0,6.75,4850,16527
4.65e+05,2015,399,4,2,1470,10291,1,0,0,4,7,1470,0,1963,1963,98008,47.632,122.12,1460,9601,52,0,6,2930,11071
2.32e+06,2015,471,4,3.5,5050,9520,2,0,0,3,11,3610,1440,2007,2007,98004,47.636,122.21,2430,9248,8,0,7.5,7480,14298
9.98e+05,2015,410,5,3.5,3760,10207,2,0,0,3,10,3150,610,1969,1969,98040,47.56,122.22,3550,12118,46,0,8.5,7310,15878
6.37e+05,2015,486,4,2.5,1710,5000,1,0,0,3,8,1110,600,1979,1979,98115,47.677,122.28,1750,5304,36,0,6.5,3460,7014
3.81e+05,2014,162,3,1.75,1800,6000,1,0,0,5,6,900,900,1950,1950,98155,47.751,122.32,1060,6628,64,0,4.75,2860,8428
2.625e+05,2014,279,3,1.75,1470,10390,1,0,0,3,7,1470,0,1989,1989,98031,47.419,122.2,1770,7507,25,0,4.75,3240,8977
7.6695e+05,2014,134,3,2.5,3030,30007,1,0,0,4,10,3030,0,1992,1992,98077,47.743,122.04,3360,34983,22,0,5.5,6390,38013
3.865e+05,2015,457,4,2.5,3110,5048,2,0,0,3,8,3110,0,2002,2002,98042,47.378,122.13,3110,5190,13,0,6.5,6220,8300
1.325e+06,2015,426,4,3.5,2170,3672,2,0,0,3,9,2170,0,1905,1989,98115,47.683,122.33,1950,3450,110,1,7.5,4120,5620
8.6e+05,2015,492,5,2.25,1960,8592,1,0,0,4,8,1290,670,1958,1958,98004,47.607,122.19,1720,8592,57,0,7.25,3680,10552
1.359e+05,2014,310,2,1,760,3800,1,0,0,3,6,760,0,1950,1950,98178,47.502,122.27,1220,7410,64,0,3,1980,8170
3.7415e+05,2014,216,3,1.75,1390,9585,1,0,0,4,7,1390,0,1973,1973,98133,47.752,122.35,1240,8188,41,0,4.75,2630,9578
6.965e+05,2014,291,4,2.75,2540,4400,1,0,0,5,7,1630,910,1925,1925,98103,47.683,122.34,1560,3920,89,0,6.75,4100,6460
5.67e+05,2014,205,5,2.25,2100,6936,1,0,0,3,8,1600,500,1974,1974,98033,47.674,122.17,2100,8661,40,0,7.25,4200,10761
8.915e+05,2014,341,3,2.5,3090,20785,2,0,0,4,10,3090,0,1991,1991,98075,47.56,122.03,3400,7566,23,0,5.5,6490,10656
6.385e+05,2015,470,4,1.75,1770,12462,1,0,2,4,8,1770,0,1962,1962,98166,47.435,122.34,2310,14810,53,0,5.75,4080,16580
5e+05,2014,153,3,1.75,1620,4200,1,0,0,5,7,830,790,1945,1945,98115,47.674,122.28,1580,5000,69,0,4.75,3200,6620
6.5e+05,2014,211,2,1,1280,6000,1,0,0,3,7,1280,0,1965,1965,98112,47.634,122.28,2460,4800,49,0,3,3740,6080
1.328e+06,2015,444,4,2.25,3260,4640,2,0,0,5,9,2360,900,1907,1907,98112,47.627,122.31,3240,5800,108,0,6.25,6500,9060
4.605e+05,2014,196,3,1,1490,10650,1,0,0,3,7,1150,340,1963,1963,98033,47.663,122.18,1730,9800,51,0,4,3220,11290
2.85e+05,2014,259,2,1,920,5850,1,0,0,4,6,920,0,1900,1900,98108,47.544,122.3,1640,5476,114,0,3,2560,6396
8.28e+05,2014,235,4,2.5,2120,10841,1,0,0,4,8,1500,620,1979,1979,98006,47.556,122.16,3130,10950,35,0,6.5,5250,13070
3.45e+05,2015,376,3,2.25,2670,37089,2,0,0,3,9,2670,0,1990,1990,98042,47.335,122.08,2290,36284,25,0,5.25,4960,38954
4.405e+05,2014,294,3,2.5,1600,3172,2,0,0,3,7,1600,0,2002,2002,98053,47.687,122.04,1690,3698,12,0,5.5,3290,5298
4.2e+05,2014,202,4,2,2280,10319,1,0,3,4,8,1270,1010,1989,1989,98198,47.359,122.32,2280,9767,25,0,6,4560,12047
6.24e+05,2014,244,4,3,1540,4140,1,0,0,5,7,1540,0,1902,1902,98107,47.673,122.4,1460,5000,112,0,7,3000,6540
9.5e+05,2014,150,4,1.75,2500,92347,1,0,0,4,8,1500,1000,1970,1970,98040,47.535,122.22,3750,20267,44,0,5.75,6250,22767
2.2e+05,2015,399,3,2.5,1430,9044,2,0,0,3,7,1430,0,1991,1991,98022,47.196,121.99,1580,8624,24,0,5.5,3010,10054
4.25e+05,2015,456,2,1,1090,6000,1,0,0,3,7,1090,0,1922,1922,98144,47.589,122.29,1960,5000,93,0,3,3050,6090
6.5e+05,2014,320,5,3.5,3960,25245,2,0,0,3,9,2500,1460,1996,1996,98056,47.525,122.17,2640,13675,18,0,8.5,6600,17635
2.16e+05,2014,223,3,1.75,1310,8670,1,0,0,4,6,1310,0,1984,1984,98092,47.316,122.19,2622,7191,30,0,4.75,3932,8501
4.25e+05,2014,312,2,1,1070,6625,1,0,0,3,7,830,240,1950,1950,98116,47.574,122.39,1310,6625,64,0,3,2380,7695
4.199e+05,2015,491,3,2.5,1630,1755,2,0,0,3,8,1320,310,1997,1997,98033,47.691,122.18,1920,14550,18,0,5.5,3550,16180
3.7e+05,2015,486,3,1,2150,8480,1,0,0,3,8,1610,540,1951,1951,98115,47.7,122.31,1620,5203,64,0,4,3770,7353
1.85e+05,2015,470,3,1.75,1500,7800,1,0,0,3,7,1500,0,1968,1968,98092,47.314,122.19,1490,7800,47,0,4.75,2990,9300
5.155e+05,2015,375,4,2.75,2830,8126,2,0,0,3,8,2830,0,2005,2005,98059,47.486,122.14,2830,7916,10,0,6.75,5660,10746
3.8e+05,2014,321,4,3.25,2864,8035,3,0,0,3,8,2864,0,2014,2014,98030,47.375,122.19,2419,8984,0,0,7.25,5283,11848
4.906e+05,2014,183,3,2.5,3316,11447,2,0,0,3,9,3316,0,1986,1986,98023,47.304,122.34,3000,11447,28,0,5.5,6316,14763
3.59e+05,2015,473,4,2.5,2160,4500,2,0,0,3,7,2160,0,2002,2002,98056,47.482,122.18,2160,4496,13,0,6.5,4320,6656
2.4e+05,2014,244,3,2,1310,8069,1,0,0,3,7,1310,0,1990,1990,98042,47.369,122.08,1310,8392,24,0,5,2620,9702
2.93e+05,2014,318,3,1,1020,7650,1,0,0,3,7,1020,0,1940,1940,98133,47.72,122.35,1440,7650,74,0,4,2460,8670
7.3e+05,2015,431,4,2.25,2190,9009,2,0,0,4,8,1840,350,1977,1977,98033,47.692,122.19,2190,10251,38,0,6.25,4380,12441
6.135e+05,2015,395,3,2.5,2350,7035,2,0,0,3,8,2350,0,1989,1989,98029,47.571,122.02,2270,7192,26,0,5.5,4620,9542
4.115e+05,2015,429,3,1,1130,8159,1,0,0,4,7,1130,0,1954,1954,98133,47.736,122.33,1570,8162,61,0,4,2700,9292
6e+05,2014,173,3,2.5,2260,10153,2,0,0,3,10,2260,0,1987,1987,98074,47.641,122.07,2740,10153,27,0,5.5,5000,12413
2.9e+05,2014,298,3,1.75,1460,7980,1,0,0,3,7,1460,0,1972,1972,98028,47.771,122.27,1920,7980,42,0,4.75,3380,9440
6.526e+05,2015,366,4,2.5,2220,5900,2,0,0,3,8,2220,0,2014,2014,98117,47.696,122.36,1620,5900,1,0,6.5,3840,8120
3.7e+05,2014,264,3,1.5,1560,6774,1,0,0,4,6,1060,500,1927,1927,98133,47.702,122.35,1320,3844,87,0,4.5,2880,5404
4.4995e+05,2014,143,3,2,1560,4080,2,0,0,3,7,1560,0,1923,1982,98115,47.689,122.32,1900,4080,91,1,5,3460,5640
2.775e+05,2014,298,3,2.25,1820,19602,1,0,0,4,7,1820,0,1964,1964,98001,47.331,122.29,1520,8773,50,0,5.25,3340,10593
3.79e+05,2015,388,4,2.5,2570,10155,2,0,0,3,9,2570,0,1994,1994,98030,47.384,122.17,2770,10155,21,0,6.5,5340,12725
3.5e+05,2014,273,4,2.75,3390,16153,1,0,0,4,7,1970,1420,1961,1961,98031,47.395,122.18,2530,8495,53,0,6.75,5920,11885
2.52e+05,2014,194,3,1,1170,9730,1,0,0,3,7,1170,0,1968,1986,98055,47.456,122.2,1680,10125,46,1,4,2850,11295
4.8e+05,2015,470,3,1,1040,5060,1,0,0,3,7,1040,0,1941,1941,98116,47.564,122.39,890,5060,74,0,4,1930,6100
2.4e+05,2014,168,2,1,670,10920,1,0,0,3,6,670,0,1942,1942,98146,47.513,122.37,900,7425,72,0,3,1570,8095
8.285e+05,2014,259,4,2.5,3720,35000,2,0,0,3,10,3720,0,1983,1983,98072,47.758,122.13,3720,35000,31,0,6.5,7440,38720
2.7e+05,2014,132,3,1,1830,8209,1,0,0,3,7,1830,0,1942,1942,98028,47.744,122.23,2150,12000,72,0,4,3980,13830
4.5e+05,2014,214,3,2.25,1610,8296,2,0,0,3,8,1610,0,1978,1978,98115,47.7,122.3,1610,8288,36,0,5.25,3220,9898
2.4e+05,2015,465,3,1.75,1780,5000,1,0,0,3,6,1080,700,1957,1957,98146,47.511,122.36,1500,5000,58,0,4.75,3280,6780
2.25e+05,2015,396,3,1,1340,4800,1,0,0,4,5,1340,0,1903,1903,98055,47.477,122.21,1240,4800,112,0,4,2580,6140
2e+05,2015,422,3,2,1170,10051,1,0,0,4,7,1170,0,1957,1957,98198,47.423,122.32,1440,9800,58,0,5,2610,10970
5.8e+05,2015,408,2,1,1650,9780,1,0,0,3,7,950,700,1943,1943,98199,47.655,122.39,1650,5458,72,0,3,3300,7108
6.8e+05,2015,431,5,3.25,2440,15815,2,0,0,3,8,1990,450,2014,2014,98155,47.774,122.28,2500,14201,1,0,8.25,4940,16641
5.699e+05,2014,300,5,3.25,2360,3873,2,0,0,3,8,1990,370,2006,2006,98108,47.563,122.3,1720,3071,8,0,8.25,4080,5431
4.95e+05,2014,299,4,2.5,4060,8547,2,0,0,3,9,2790,1270,2007,2007,98038,47.369,122.06,2810,8313,7,0,6.5,6870,12373
7e+05,2014,160,3,2,2080,3880,1,0,0,5,7,1160,920,1954,1954,98117,47.686,122.39,1330,3880,60,0,5,3410,5960
3.9e+05,2015,487,5,2,2400,9537,1,0,0,5,7,1210,1190,1959,1959,98056,47.511,122.19,1760,9533,56,0,7,4160,11933
3.54e+05,2014,264,3,2,1010,21340,1,0,0,3,8,1010,0,1980,1980,98074,47.622,122.04,1700,13045,34,0,5,2710,14055
1.125e+06,2014,140,6,3,2880,3192,2,0,0,4,8,2180,700,1919,1919,98103,47.651,122.33,1870,4533,95,0,9,4750,7413
4.9e+05,2014,339,4,1.75,1870,9500,1,0,0,4,7,1090,780,1962,1962,98033,47.701,122.19,2010,10000,52,0,5.75,3880,11870
3.65e+05,2014,347,3,2.5,2470,7700,2,0,0,4,8,2470,0,1990,1990,98031,47.41,122.17,2400,7700,24,0,5.5,4870,10170
3.265e+05,2014,188,3,1,1060,7920,1,0,0,4,7,1060,0,1968,1968,98106,47.565,122.36,1060,7457,46,0,4,2120,8517
4.75e+05,2015,396,3,1.75,1780,8033,1,0,0,2,7,1210,570,1977,1977,98034,47.727,122.22,1630,7508,38,0,4.75,3410,9288
8.65e+05,2014,262,4,2.5,2260,13600,1,0,0,4,8,1770,490,1974,1974,98040,47.544,122.23,2630,13995,40,0,6.5,4890,16255
4.45e+05,2014,294,3,2.5,1260,1102,3,0,0,3,8,1260,0,2007,2007,98107,47.675,122.39,1320,2500,7,0,5.5,2580,3760
2.5e+05,2014,202,3,1,1250,7920,1,0,0,4,7,1250,0,1960,1960,98059,47.485,122.13,1440,9648,54,0,4,2690,10898
5.15e+05,2014,228,4,1.5,1740,8160,1,0,0,4,7,1400,340,1946,1946,98177,47.724,122.36,1600,8160,68,0,5.5,3340,9900
2.32e+05,2014,125,2,1,1200,8063,1,0,0,4,6,1200,0,1958,1958,98198,47.42,122.32,1200,7500,56,0,3,2400,8700
6.495e+05,2015,488,4,3,3150,6599,2,0,0,3,9,3150,0,2008,2008,98056,47.528,122.2,2680,9430,7,0,7,5830,12580
9.38e+05,2015,473,4,2.5,2410,9886,1,0,0,5,8,1990,420,1975,1975,98040,47.535,122.22,2530,10658,40,0,6.5,4940,13068
6.52e+05,2014,273,3,2.25,1920,9600,1,0,0,4,8,1560,360,1968,1968,98052,47.634,122.1,2040,9600,46,0,5.25,3960,11520
3.9995e+05,2014,189,5,2.75,1970,5400,1,0,0,3,7,1320,650,1986,1986,98144,47.587,122.31,1280,2150,28,0,7.75,3250,4120
1.5908e+05,2014,295,4,1.5,1580,6200,1,0,0,3,6,790,790,1944,1944,98178,47.497,122.24,1320,6499,70,0,5.5,2900,8079
4.955e+05,2014,237,3,1.75,2130,6360,1,0,0,3,7,1720,410,1959,1959,98125,47.706,122.3,1540,6361,55,0,4.75,3670,8491
7.18e+05,2014,273,5,2.75,2930,7663,2,0,0,3,9,2930,0,2013,2013,98056,47.531,122.18,2750,10335,1,0,7.75,5680,13265
8.5e+05,2014,278,3,1.75,1400,9900,1,0,0,3,7,1400,0,1951,1951,98004,47.627,122.21,1810,10796,63,0,4.75,3210,12196
3.23e+05,2014,339,3,1.75,1910,8329,1,0,0,3,8,1910,0,2004,2004,98022,47.19,122.02,2510,9259,10,0,4.75,4420,11169
2.947e+05,2014,156,3,2,1970,9600,1,0,0,4,7,1300,670,1967,1967,98003,47.282,122.3,1710,7703,47,0,5,3680,9673
4.96e+05,2014,333,2,1,1420,4635,2,0,0,4,7,1420,0,1941,1973,98115,47.68,122.3,1810,4635,73,1,3,3230,6055
9.21e+05,2014,195,3,2.25,2380,11200,1,0,0,4,8,2380,0,1963,1963,98004,47.587,122.19,2010,11200,51,0,5.25,4390,13580
1.05e+06,2015,457,3,3,3250,5093,2,0,3,3,10,3250,0,2004,2004,98146,47.512,122.39,2820,7752,11,0,6,6070,11002
4.42e+05,2014,218,3,2.5,1980,39932,2,0,0,3,8,1980,0,1994,1994,98011,47.743,122.2,2610,12769,20,0,5.5,4590,14749
4.78e+05,2014,285,4,2,1690,8208,1,0,0,4,7,1210,480,1958,1958,98008,47.605,122.13,1620,8496,56,0,6,3310,10186
2.79e+05,2014,256,4,2.5,2040,8076,2,0,0,3,7,2040,0,1994,1994,98042,47.369,122.07,2040,8408,20,0,6.5,4080,10448
2.55e+05,2014,318,2,1,620,4760,1,0,0,3,6,620,0,1941,1941,98126,47.529,122.38,620,4760,73,0,3,1240,5380
3.065e+05,2015,451,2,1.75,1310,10200,1,0,0,4,6,1310,0,1947,1947,98065,47.523,121.82,1500,7200,68,0,3.75,2810,8510
1.65e+06,2014,237,4,3.5,4285,9567,2,0,1,5,10,3485,800,1946,1946,98199,47.643,122.41,2960,6902,68,0,7.5,7245,11187
2.0595e+05,2015,430,3,1,970,11963,1,0,0,4,6,970,0,1970,1970,98198,47.378,122.31,1210,11963,45,0,4,2180,12933
5.75e+05,2014,135,4,2.5,3020,17810,1,0,0,3,9,1600,1420,1979,1979,98155,47.773,122.28,2500,15815,35,0,6.5,5520,18835
1.83e+05,2015,446,2,1,760,7272,1,0,0,4,7,760,0,1980,1980,98003,47.321,122.33,1370,7866,35,0,3,2130,8626
1.6e+05,2014,278,3,1.75,1370,8006,2,0,0,3,7,1370,0,1990,1990,98001,47.258,122.25,1530,8006,24,0,4.75,2900,9376
7.6e+05,2015,444,4,3.25,2590,3889,3,0,0,3,9,2590,0,2013,2013,98007,47.626,122.14,2590,4062,2,0,7.25,5180,6652
5.6e+05,2014,173,3,2.5,1960,12476,2,0,0,4,8,1960,0,1989,1989,98056,47.532,122.17,2450,12177,25,0,5.5,4410,14137
4.55e+05,2015,403,4,1.75,1790,45738,1,0,0,3,8,1410,380,1976,1976,98072,47.745,122.13,1870,47480,39,0,5.75,3660,49270
5.25e+05,2014,259,4,2.5,2450,5280,2,0,0,3,8,2450,0,2003,2003,98011,47.773,122.22,2300,4674,11,0,6.5,4750,7124
4.53e+05,2014,173,4,1.75,2120,7420,1,0,0,4,7,1060,1060,1956,1956,98008,47.602,122.13,1540,7420,58,0,5.75,3660,9540
1.4e+05,2014,177,3,1,1060,7473,1,0,0,3,7,1060,0,1959,1959,98198,47.37,122.31,1320,7912,55,0,4,2380,8972
4.5325e+05,2015,485,4,2.5,2260,6300,2,0,0,3,7,2260,0,2001,2001,98019,47.724,121.96,2300,6300,14,0,6.5,4560,8560
1.6125e+06,2014,190,4,2.75,5470,18200,2,1,4,3,11,3730,1740,1992,1992,98118,47.532,122.26,3620,15100,22,0,6.75,9090,20570
1.635e+05,2014,203,2,1.5,1050,3419,2,0,0,3,7,1050,0,1996,1996,98038,47.385,122.04,1050,3417,18,0,3.5,2100,4467
6.7999e+05,2015,477,4,2.75,3320,8653,2,0,0,3,8,3320,0,2014,2014,98133,47.752,122.33,2140,8727,1,0,6.75,5460,12047
1.15e+06,2014,230,3,2.5,4190,9624,2,0,0,3,10,4190,0,1999,1999,98006,47.564,122.13,3650,8321,15,0,5.5,7840,12511
5.9e+05,2014,311,3,2.25,2490,8800,2,0,0,4,8,2490,0,1975,1975,98006,47.567,122.13,2690,10000,39,0,5.25,5180,12490
8.45e+05,2015,438,4,3.5,3350,19487,1,0,0,3,11,2460,890,1992,1992,98075,47.58,122,3360,19460,23,0,7.5,6710,22810
1.7995e+05,2014,341,2,1,1200,9000,1,0,0,3,6,1200,0,1958,1958,98023,47.328,122.35,1040,9600,56,0,3,2240,10800
4.55e+05,2015,392,3,1.5,1380,6657,2,0,0,3,7,1380,0,1986,1986,98034,47.709,122.22,1420,8187,29,0,4.5,2800,9567
2.35e+05,2014,340,3,1.5,1980,11214,1,0,0,3,7,1980,0,1959,1959,98168,47.47,122.3,1510,9072,55,0,4.5,3490,11052
4.1e+05,2014,169,6,2.75,2520,9324,1,0,0,4,7,1320,1200,1962,1962,98155,47.764,122.29,1820,11000,52,0,8.75,4340,13520
3.83e+05,2014,317,4,2,1830,21183,1,0,0,4,7,1060,770,1966,1966,98059,47.483,122.13,1950,6120,48,0,6,3780,7950
1.445e+06,2014,217,4,2.5,3200,3600,3,0,3,4,9,2600,600,1997,1997,98119,47.632,122.37,2490,4080,17,0,6.5,5690,7280
2.09e+05,2014,321,3,1.75,1250,8084,1,0,0,4,7,1250,0,1967,1967,98001,47.336,122.28,1340,7680,47,0,4.75,2590,8930
4.8e+05,2015,383,2,1,710,4800,1,0,0,2,6,710,0,1950,1950,98112,47.621,122.3,1480,1721,65,0,3,2190,2431
4.45e+05,2014,347,4,2.75,2160,7200,1,0,0,4,7,1220,940,1976,1976,98034,47.718,122.22,1790,7614,38,0,6.75,3950,9774
1.735e+06,2014,163,3,2.5,4310,32093,1,0,4,5,10,2510,1800,1982,1982,98177,47.762,122.38,3810,26400,32,0,5.5,8120,30710
9.05e+05,2014,175,5,3.5,3100,10200,1,0,4,3,9,1660,1440,1970,1970,98008,47.613,122.11,2700,10455,44,0,8.5,5800,13555
3.49e+05,2014,202,4,2.5,2280,4096,2,0,0,3,7,2280,0,2003,2003,98056,47.483,122.18,2280,3600,11,0,6.5,4560,5880
3.65e+05,2014,269,4,2.5,2540,6688,2,0,0,3,9,2540,0,2002,2002,98092,47.331,122.18,2810,6776,12,0,6.5,5350,9316
4.7e+05,2014,198,4,2.25,3380,9900,1,0,2,4,8,1690,1690,1969,1969,98166,47.444,122.34,2390,9900,45,0,6.25,5770,13280
9e+05,2015,437,4,2.5,2660,3672,2,0,0,5,8,1800,860,1910,1910,98105,47.661,122.32,1510,3825,105,0,6.5,4170,6485
4.67e+05,2014,140,3,2.25,1270,1213,2,0,0,3,8,1040,230,2005,2005,98107,47.674,122.38,1410,1265,9,0,5.25,2680,2535
3.11e+05,2015,369,4,2.5,2090,11645,1,0,0,3,7,1200,890,1962,1962,98168,47.476,122.3,1450,9481,53,0,6.5,3540,11571
1.4825e+06,2015,487,3,2.25,3290,5000,2,0,0,3,9,2730,560,1939,1939,98105,47.658,122.28,2340,4000,76,0,5.25,5630,7290
4.5e+05,2014,294,4,2.5,2450,20348,1,0,0,3,8,1410,1040,1978,1978,98075,47.589,122.06,2450,50094,36,0,6.5,4900,52544
2.872e+05,2014,122,3,3,1850,19966,1,0,0,4,7,1090,760,1992,1992,98038,47.349,122.03,1410,6715,22,0,6,3260,8565
2.25e+06,2014,162,5,4.25,4860,9453,1,0,1,5,10,3100,1760,1905,1905,98112,47.62,122.29,3150,8557,109,0,9.25,8010,13417
2.96e+05,2015,451,2,1,750,4680,1,0,0,3,5,750,0,1948,1948,98117,47.692,122.37,1450,4400,67,0,3,2200,5150
3e+05,2014,149,3,2.5,2080,9827,2,0,0,3,8,2080,0,1989,1989,98023,47.306,122.39,2660,9861,25,0,5.5,4740,11941
2.9e+05,2014,161,3,1.75,1520,15090,1,0,0,4,7,1520,0,1968,1968,98038,47.398,121.96,1580,18618,46,0,4.75,3100,20138
5.45e+05,2014,195,3,2.5,2660,20369,2,0,0,3,8,2660,0,1992,1992,98027,47.523,122.06,2720,12927,22,0,5.5,5380,15587
4.9e+05,2014,266,4,2.5,3000,8645,2,0,0,3,8,3000,0,1985,1985,98034,47.731,122.22,1930,8866,29,0,6.5,4930,11866
3.0545e+05,2014,127,3,2.5,1600,3573,2,0,0,3,7,1600,0,2013,2013,98056,47.507,122.18,1500,11089,1,0,5.5,3100,12689
3e+05,2015,446,3,1,1290,12415,1,0,0,3,6,1290,0,1908,1908,98070,47.372,122.46,1620,12415,107,0,4,2910,13705
5.07e+05,2014,189,3,1.75,2140,40098,1,0,0,5,8,1490,650,1950,1950,98058,47.43,122.11,2220,35371,64,0,4.75,4360,37511
7.7e+05,2014,313,4,2.75,3820,26300,2,0,0,3,9,2850,970,2014,2014,98028,47.762,122.26,1860,12136,0,0,6.75,5680,15956
7.2e+05,2014,324,3,2.5,3170,7187,2,0,0,3,9,3170,0,2005,2005,98033,47.693,122.17,2790,7336,9,0,5.5,5960,10506
3.2e+05,2014,222,4,2.5,2070,7007,2,0,0,3,7,2070,0,1996,1996,98031,47.397,122.17,2130,8100,18,0,6.5,4200,10170
4.4e+05,2014,319,3,2.5,1440,5434,2,0,0,3,7,1440,0,2003,2003,98053,47.682,122.03,1560,3770,11,0,5.5,3000,5210
2.775e+05,2014,318,3,2.5,2620,4558,2,0,3,3,7,2620,0,2010,2010,98022,47.194,121.97,1670,4558,4,0,5.5,4290,7178
9.05e+05,2015,470,4,2.25,2240,5000,2,0,0,3,8,1770,470,1900,2014,98122,47.603,122.3,2120,5000,115,1,6.25,4360,7240
7.65e+05,2014,140,4,2.25,2560,12100,1,0,0,4,8,1760,800,1976,1976,98052,47.631,122.11,2240,12100,38,0,6.25,4800,14660
4.6e+05,2014,147,3,3.5,1600,1431,2,0,0,3,8,1240,360,2006,2006,98117,47.687,122.36,1500,4120,8,0,6.5,3100,5720
4.9995e+05,2014,190,4,1.75,1520,7700,1,0,0,4,7,1520,0,1967,1967,98034,47.736,122.19,1520,7500,47,0,5.75,3040,9020
4e+05,2014,287,4,1,2320,4000,1,0,0,3,6,1310,1010,1921,1921,98144,47.573,122.31,1750,4000,93,0,5,4070,6320
3.39e+05,2015,437,4,2.5,1740,6000,1,0,0,4,7,1740,0,1952,1952,98178,47.503,122.24,1190,6000,63,0,6.5,2930,7740
9.25e+05,2015,471,4,2.5,3350,4501,2,0,0,3,9,2640,710,2002,2002,98117,47.688,122.38,1000,4500,13,0,6.5,4350,7850
3.45e+05,2014,167,4,2.75,2250,7412,1,0,0,4,8,1480,770,1975,1975,98058,47.445,122.13,2070,7632,39,0,6.75,4320,9882
2.52e+05,2014,318,4,1.75,1940,13370,1,0,0,4,8,1940,0,1974,1974,98023,47.322,122.37,2405,11769,40,0,5.75,4345,13709
3.2e+05,2015,478,3,1.75,1960,11931,1,0,0,3,7,980,980,1954,1954,98118,47.543,122.27,1460,4498,61,0,4.75,3420,6458
2.6e+05,2015,429,4,1.75,1960,8400,1,0,0,4,8,1960,0,1967,1967,98023,47.311,122.38,2080,8400,48,0,5.75,4040,10360
5.77e+05,2015,471,2,1,1090,5265,1,0,0,4,7,1090,0,1947,1947,98105,47.664,122.29,2080,4000,68,0,3,3170,5090
5.75e+05,2014,306,4,2.5,2520,35636,2,0,0,3,8,2520,0,1980,1980,98053,47.652,122.03,2230,35673,34,0,6.5,4750,38193
2.95e+05,2015,408,3,2.5,1500,3060,2,0,0,3,7,1500,0,1994,1994,98006,47.56,122.12,2700,7734,21,0,5.5,4200,9234
3.2756e+05,2015,401,3,2.5,2329,5720,2,0,0,3,8,2329,0,2010,2010,98030,47.362,122.2,2197,5720,5,0,5.5,4526,8049
7.65e+05,2014,129,4,2.75,2790,10819,2,0,0,3,10,2790,0,1996,1996,98027,47.551,122.08,3080,12603,18,0,6.75,5870,15393
2.83e+05,2014,271,3,1,1740,5247,1,0,0,3,7,1270,470,1947,1947,98168,47.505,122.33,1070,5636,67,0,4,2810,7376
2.565e+05,2015,446,5,2.5,1960,7350,1,0,0,4,7,1360,600,1969,1969,98058,47.437,122.17,1900,7350,46,0,7.5,3860,9310
4.095e+05,2014,317,3,1,1340,4120,1,0,0,4,7,1040,300,1921,1921,98103,47.692,122.35,1270,4635,93,0,4,2610,5975
2.3095e+05,2014,217,2,1,930,12724,1,0,0,4,6,930,0,1912,1912,98014,47.657,121.91,1240,21828,102,0,3,2170,22758
2.4e+05,2015,392,3,1.75,1510,10248,1,0,0,3,7,1510,0,1969,1969,98023,47.293,122.37,1510,9753,46,0,4.75,3020,11263
6.3525e+05,2014,283,3,2.25,2210,22040,1,0,0,5,8,1510,700,1976,1976,98004,47.59,122.19,2470,14258,38,0,5.25,4680,16468
3.245e+05,2014,155,3,2.5,1660,3990,2,0,0,3,7,1660,0,2009,2009,98118,47.53,122.27,1670,4050,5,0,5.5,3330,5710
1.85e+05,2014,156,3,1,1840,8100,1,0,0,4,7,920,920,1953,1953,98166,47.455,122.35,1250,8100,61,0,4,3090,9940
6.675e+05,2014,167,3,2,1880,3800,1,0,0,5,7,1030,850,1927,1927,98115,47.684,122.31,1700,3800,87,0,5,3580,5680
1.305e+06,2015,477,4,3.5,3440,5000,2,0,0,3,11,2560,880,2006,2006,98199,47.667,122.41,3090,10241,9,0,7.5,6530,13681
3.39e+05,2015,477,3,1,1150,2496,1,0,0,3,6,1010,140,1947,1947,98126,47.519,122.38,1340,1203,68,0,4,2490,2353
2.65e+05,2014,168,4,1.5,2050,7100,1,0,0,3,7,1050,1000,1963,1963,98001,47.34,122.28,1950,7350,51,0,5.5,4000,9400
4.6525e+05,2014,162,5,2,1940,7642,1,0,0,3,7,1940,0,1957,1957,98177,47.775,122.38,1940,8724,57,0,7,3880,10664
5.8e+05,2015,394,3,2.25,1640,8625,1,0,0,3,8,1320,320,1987,1987,98052,47.677,122.15,1770,9476,28,0,5.25,3410,11116
4.79e+05,2015,415,4,2.25,2270,9464,1,0,0,4,7,1520,750,1940,1940,98146,47.501,122.36,1770,9464,75,0,6.25,4040,11734
4.8e+05,2015,477,4,1.75,1840,9250,1,0,0,4,7,980,860,1956,1956,98133,47.708,122.34,1520,9250,59,0,5.75,3360,11090
1.7325e+05,2014,339,3,1,990,12696,1,0,0,3,7,990,0,1936,1936,98168,47.478,122.28,1260,8937,78,0,4,2250,9927
2.85e+05,2014,242,4,1.75,1440,6720,1,0,0,5,6,720,720,1954,1954,98166,47.457,122.34,1820,6784,60,0,5.75,3260,8224
2.4e+05,2014,230,3,1,1340,7000,1,0,0,4,7,1340,0,1978,1978,98042,47.374,122.15,1850,7904,36,0,4,3190,9244
8.9078e+05,2014,221,5,2.75,3170,8093,2,0,0,3,9,3170,0,2014,2014,98075,47.593,122.06,3210,7062,0,0,7.75,6380,10232
1.393e+06,2014,342,3,3.5,4240,21578,2,0,0,3,10,3500,740,1994,1994,98040,47.561,122.22,3120,16440,20,0,6.5,7360,20680
1.35e+05,2015,365,3,1,840,3000,1,0,0,3,5,840,0,1943,1943,98178,47.494,122.28,1010,6000,72,0,4,1850,6840
4.69e+05,2015,458,4,2.75,3550,13938,1,0,0,5,8,2100,1450,1966,1966,98188,47.425,122.28,2050,9000,49,0,6.75,5600,12550
1.3799e+06,2014,203,3,3.25,3786,38038,1,1,4,3,9,1934,1852,1978,2006,98070,47.391,122.45,2850,33361,36,1,6.25,6636,37147
9.25e+05,2014,221,5,3,2710,4200,2,0,0,3,7,1890,820,1919,2014,98115,47.675,122.31,2150,4200,95,1,8,4860,6910
8.13e+05,2014,290,4,2.5,3430,7508,2,0,0,3,10,3430,0,1998,1998,98052,47.687,122.11,3110,8741,16,0,6.5,6540,12171
1.7e+05,2015,438,3,1,790,6750,1,0,0,2,6,790,0,1944,1944,98178,47.498,122.24,960,6298,71,0,4,1750,7088
9.06e+05,2015,431,3,2.5,2030,1800,3,0,0,3,9,2030,0,2013,2013,98112,47.62,122.3,1450,1441,2,0,5.5,3480,3471
3.5e+05,2014,152,3,2.5,2680,7836,2,0,0,3,8,2680,0,1990,2009,98092,47.32,122.19,2340,8040,24,1,5.5,5020,10720
6.25e+05,2015,467,3,1.75,2100,3264,1,0,0,5,7,1350,750,1912,1912,98107,47.67,122.36,1720,3750,103,0,4.75,3820,5850
7.65e+05,2014,202,5,1.75,2440,15143,1,0,4,4,8,1740,700,1944,1944,98146,47.495,122.37,2390,10907,70,0,6.75,4830,13347
3.29e+05,2014,320,3,2.25,2450,6500,2,0,0,4,8,2450,0,1985,1985,98030,47.374,122.17,2200,6865,29,0,5.25,4650,9315
3.3675e+05,2015,453,4,2.25,1720,7803,1,0,0,3,8,1350,370,1955,1955,98146,47.512,122.34,1720,7803,60,0,6.25,3440,9523
9e+05,2015,396,3,3.25,3870,33980,2,0,0,3,10,3150,720,1991,1991,98006,47.559,122.12,3590,10750,24,0,6.25,7460,14620
5.7e+05,2014,292,4,2.5,3420,1.1543e+05,2,0,0,3,9,3420,0,1989,1989,98038,47.393,121.99,3250,1.1151e+05,25,0,6.5,6670,1.1493e+05
2.68e+05,2014,236,3,2.5,1700,2250,2,0,0,3,7,1700,0,2014,2014,98168,47.491,122.33,1520,4500,0,0,5.5,3220,6200
8.1e+05,2014,299,5,3.5,3550,9600,2,0,0,3,9,2550,1000,1998,1998,98118,47.548,122.27,2030,9600,16,0,8.5,5580,13150
7.5e+05,2014,202,3,2.25,3270,1.68e+05,2,0,0,4,10,3270,0,1982,1982,98056,47.52,122.19,3220,7963,32,0,5.25,6490,11233
2.77e+05,2015,400,4,3,1960,5160,1,0,0,3,7,1170,790,2001,2001,98106,47.531,122.36,1960,5160,14,0,7,3920,7120
3.15e+05,2014,334,3,1.75,1480,6800,1,0,0,4,7,1480,0,1968,1968,98055,47.463,122.19,1500,7900,46,0,4.75,2980,9380
1.15e+06,2014,175,3,2,2110,18815,2,0,0,5,7,2110,0,1979,1979,98075,47.584,122.04,2690,21010,35,0,5,4800,23120
3.69e+05,2015,484,4,2.5,2550,7349,2,0,0,3,9,2550,0,1989,1989,98023,47.306,122.35,2400,8508,26,0,6.5,4950,11058
2.34e+05,2015,445,3,1,1040,8122,1,0,0,5,7,1040,0,1971,1971,98198,47.373,122.31,1470,8676,44,0,4,2510,9716
4.24e+05,2014,298,3,2,1330,5632,1,0,0,3,8,1330,0,1988,1988,98029,47.575,122.02,1900,4842,26,0,5,3230,6172
1.5e+05,2014,244,3,1,1450,6776,1,0,0,3,7,1450,0,1952,1952,98178,47.506,122.24,1680,7200,62,0,4,3130,8650
7.15e+05,2014,217,4,2.25,2460,40635,1,0,0,5,8,2460,0,1968,1968,98053,47.663,122.03,2250,40635,46,0,6.25,4710,43095
1.0595e+06,2014,160,5,3.25,3230,3825,2,0,0,3,9,2480,750,2014,2014,98117,47.678,122.39,1480,5100,0,0,8.25,4710,8330
4.25e+05,2014,127,2,2.5,1150,1027,3,0,0,3,8,1150,0,2008,2008,98103,47.653,122.36,1360,1210,6,0,4.5,2510,2360
4.3e+05,2015,437,3,1.5,1450,7316,1,0,0,3,7,1450,0,1961,1961,98133,47.773,122.35,1440,7316,54,0,4.5,2890,8766
5.2e+05,2014,293,3,2.25,2030,16200,2,0,0,3,8,2030,0,1984,1984,98027,47.516,122.06,2660,17958,30,0,5.25,4690,19988
3.52e+05,2015,460,3,0.75,1240,7200,1,0,0,3,7,1240,0,1947,1947,98133,47.73,122.34,1210,7200,68,0,3.75,2450,8440
2.96e+05,2014,303,2,2,1320,2040,3,0,0,3,7,1320,0,1997,1997,98125,47.722,122.29,1430,2040,17,0,4,2750,3360
2.78e+05,2014,297,3,1.75,2710,9088,1,0,0,4,7,2060,650,1965,1965,98001,47.307,122.27,1690,10454,49,0,4.75,4400,13164
8.425e+05,2014,315,5,4,2980,4500,1,0,0,3,7,2070,910,1921,1921,98115,47.674,122.32,1560,4225,93,0,9,4540,7205
3.98e+05,2014,262,4,1,1420,6458,1,0,0,4,7,1420,0,1953,1953,98117,47.699,122.36,1670,6350,61,0,5,3090,7770
1.284e+06,2015,403,5,4.25,5040,9466,2,0,0,3,11,5040,0,2004,2004,98059,47.528,122.13,4300,9417,11,0,9.25,9340,14457
2.89e+05,2014,196,2,1.5,1010,1309,2,0,0,3,7,860,150,2007,2007,98118,47.566,122.29,1190,3060,7,0,3.5,2200,4070
2.25e+06,2015,446,3,3,4040,7200,1,0,2,4,9,3340,700,1930,1930,98112,47.629,122.28,3450,10800,85,0,6,7490,14840
8.4e+05,2014,314,5,2.75,2790,20824,1,0,0,3,9,1680,1110,1959,1959,98115,47.695,122.28,2380,10465,55,0,7.75,5170,13255
1.2558e+06,2014,360,5,4,4180,12042,2,0,0,3,10,4180,0,2014,2014,98075,47.596,122.01,1800,6052,0,0,9,5980,10232
1.805e+05,2015,367,3,1.5,1540,9800,1,0,0,3,7,1010,530,1973,1973,98058,47.468,122.18,1600,8250,42,0,4.5,3140,9790
3.3e+05,2015,408,4,1,1100,5000,1,0,0,5,6,1100,0,1904,1904,98055,47.487,122.2,1560,4838,111,0,5,2660,5938
2.25e+05,2014,173,3,1.75,1580,8820,1,0,0,4,7,1580,0,1967,1967,98003,47.317,122.33,1280,8500,47,0,4.75,2860,10080
1.26e+06,2014,265,3,2.5,3110,9930,1,0,1,3,8,1640,1470,1954,1954,98039,47.611,122.23,3650,14399,60,0,5.5,6760,17509
2.52e+05,2015,430,3,1.75,1440,16819,1,0,0,4,6,1440,0,1925,1925,98023,47.332,122.37,1560,12376,90,0,4.75,3000,13816
3.55e+05,2015,451,3,1,900,37800,1,0,0,4,5,700,200,1923,1923,98034,47.715,122.23,1750,11998,92,0,4,2650,12898
2.57e+05,2014,339,2,1,770,7200,1,0,0,3,7,770,0,1951,1951,98125,47.714,122.33,1320,7139,63,0,3,2090,7909
1.25e+06,2014,325,4,4.25,4980,13000,2,0,3,3,9,3080,1900,1982,1982,98052,47.641,122.1,2840,11308,32,0,8.25,7820,16288
2.625e+05,2015,362,3,1,970,7854,1,0,0,4,7,970,0,1980,1980,98056,47.49,122.19,1480,7800,35,0,4,2450,8770
4.7e+05,2014,173,3,2.5,2150,8221,2,0,0,3,8,2150,0,1992,1992,98059,47.508,122.15,2490,7951,22,0,5.5,4640,10101
3.75e+05,2014,242,3,2.5,1330,1064,3,0,0,3,8,1330,0,2004,2004,98117,47.684,122.39,1330,1113,10,0,5.5,2660,2443
5.3e+05,2014,312,4,2.5,3010,9000,2,0,0,3,8,3010,0,2008,2008,98059,47.499,122.15,3250,5531,6,0,6.5,6260,8541
3.755e+05,2014,160,3,1.5,1530,7200,1,0,0,3,8,1530,0,1975,1975,98155,47.769,122.3,2150,7216,39,0,4.5,3680,8746
1.697e+06,2015,365,3,2,2600,6600,2,0,4,3,10,1930,670,1970,2014,98122,47.605,122.28,2670,6270,45,1,5,5270,8870
5.39e+05,2015,425,3,1.75,1380,3225,1,0,0,4,7,940,440,1915,1915,98103,47.665,122.34,1250,3750,100,0,4.75,2630,5130
4.1e+05,2015,424,2,1,800,4342,1,0,0,3,6,670,130,1927,1927,98115,47.7,122.32,1210,4343,88,0,3,2010,5143
3.925e+05,2015,452,3,1,930,6572,1,0,0,3,7,930,0,1952,1952,98115,47.689,122.3,960,5840,63,0,4,1890,6770
5.49e+05,2014,257,3,2,2330,3600,1,0,0,4,7,1580,750,1900,1900,98122,47.602,122.3,1750,3600,114,0,5,4080,5930
1.15e+05,2014,195,2,0.75,550,7980,1,0,0,3,5,550,0,1952,1952,98146,47.511,122.35,1330,7980,62,0,2.75,1880,8530
5.6e+05,2015,403,4,2,1380,4048,1,0,0,4,7,1380,0,1906,1906,98103,47.658,122.34,1440,3956,109,0,6,2820,5336
3.5e+05,2014,244,3,1,1240,10800,1,0,0,5,7,1240,0,1959,1959,98056,47.523,122.19,1810,10800,55,0,4,3050,12040
4.36e+05,2015,445,5,3,2720,9856,2,0,0,4,8,2720,0,1969,1969,98059,47.478,122.15,1420,9685,46,0,8,4140,12405
3.37e+05,2014,285,3,2,1690,9087,1,0,0,3,8,1690,0,1997,1997,98042,47.372,122.11,2090,8100,17,0,5,3780,9790
3.55e+05,2014,279,3,2.25,1980,7200,1,0,0,3,8,1300,680,1964,1964,98177,47.763,122.36,1820,8250,50,0,5.25,3800,10230
5.225e+05,2015,410,4,3,2370,8154,1,0,0,3,7,1380,990,1977,1977,98125,47.726,122.31,2100,8148,38,0,7,4470,10518
3.95e+05,2014,150,4,2.5,2910,5000,2,0,0,3,8,2910,0,2002,2002,98042,47.378,122.13,2740,5045,12,0,6.5,5650,7955
6.26e+05,2015,382,4,2.5,2570,7221,1,0,0,4,8,1570,1000,1958,1958,98117,47.692,122.39,2440,7274,57,0,6.5,5010,9844
7.79e+05,2014,255,3,2.5,1580,1487,3,0,1,3,9,1580,0,2009,2009,98119,47.628,122.36,1610,1297,5,0,5.5,3190,2877
9.75e+05,2014,133,4,2.5,3490,7494,2,0,3,3,11,3490,0,2000,2000,98006,47.559,122.13,3260,8437,14,0,6.5,6750,11927
3.12e+05,2014,153,4,2.5,1830,5175,2,0,0,3,7,1830,0,2003,2003,98038,47.356,122.02,1830,5175,11,0,6.5,3660,7005
2.5e+05,2014,258,3,2,1590,8100,1,0,0,3,7,1060,530,1996,1996,98038,47.361,122.05,1590,8100,18,0,5,3180,9690
2.3495e+05,2015,408,4,2,1450,7560,1,0,0,3,7,1450,0,1967,1967,98001,47.337,122.28,1430,7560,48,0,6,2880,9010
6.85e+05,2015,492,2,1.5,1090,4013,1,0,0,3,7,1090,0,1900,1900,98103,47.665,122.34,1390,4013,115,0,3.5,2480,5103
6.15e+05,2015,463,4,2.75,2750,15450,1,0,0,3,8,1800,950,1978,1978,98155,47.775,122.28,2750,10620,37,0,6.75,5500,13370
2.39e+05,2015,475,3,1,1200,7810,1,0,0,4,7,1200,0,1967,1967,98038,47.363,122.05,1590,7800,48,0,4,2790,9000
3.4e+05,2015,477,3,2,1150,700,2,0,0,3,7,800,350,2000,2000,98136,47.555,122.38,1060,1910,15,0,5,2210,3060
5.15e+05,2014,194,3,2.5,1540,6100,1,0,0,3,6,770,770,1944,2014,98126,47.57,122.38,1710,5950,70,1,5.5,3250,7490
3.41e+05,2015,376,3,1,940,4200,1,0,0,3,7,940,0,1955,1955,98103,47.688,122.35,1380,4080,60,0,4,2320,5020
3.4495e+05,2014,270,3,2,1470,6950,1,0,0,5,6,1470,0,1932,1932,98133,47.762,122.34,1660,5065,82,0,5,3130,6535
5.7e+05,2014,147,3,1.75,1930,36210,1,0,0,3,8,1930,0,1977,1977,98072,47.769,122.13,1930,35060,37,0,4.75,3860,36990
4.6e+05,2015,457,3,2.25,1530,1840,2,0,0,3,8,1240,290,2008,2008,98144,47.587,122.3,1800,3431,7,0,5.25,3330,4961
1.55e+06,2015,437,4,3.5,3260,5000,2,0,0,5,9,2630,630,1937,1937,98105,47.66,122.27,2600,5000,78,0,7.5,5860,8260
4.58e+05,2014,167,4,1.5,1550,3000,1,0,0,3,7,1350,200,1918,1918,98105,47.66,122.32,1710,5535,96,0,5.5,3260,7085
2.9995e+05,2014,298,2,1.75,1460,10506,1,0,0,3,7,1460,0,1983,1983,98031,47.405,122.18,1460,8153,31,0,3.75,2920,9613
2.67e+05,2014,183,3,1,1740,10875,1,0,0,4,7,1020,720,1962,1962,98188,47.468,122.28,1470,8532,52,0,4,3210,10272
4e+05,2014,236,3,1.75,1330,9143,1,0,0,3,7,1330,0,1960,1960,98006,47.554,122.18,1950,10384,54,0,4.75,3280,11714
5.4e+05,2014,152,4,1.75,1720,4240,1,0,0,4,7,1460,260,1925,1925,98144,47.579,122.29,1930,4280,89,0,5.75,3650,6000
2.6875e+05,2014,322,4,1,800,8775,1,0,0,3,6,800,0,1943,1943,98166,47.48,122.34,1310,8775,71,0,5,2110,9575
3.1995e+05,2014,285,3,3.25,1510,1245,3,0,0,3,7,1510,0,2007,2007,98133,47.729,122.34,1510,1245,7,0,6.25,3020,2755
3.2e+05,2015,414,3,1,1190,4120,1,0,0,3,6,1190,0,1929,1929,98118,47.551,122.27,1360,4635,86,0,4,2550,5825
7e+05,2015,410,3,2.5,2230,4006,2,0,0,3,8,2230,0,2014,2014,98133,47.73,122.33,2230,4180,1,0,5.5,4460,6410
6.25e+05,2015,367,5,2.5,2990,15085,2,0,0,3,9,2990,0,2007,2007,98011,47.746,122.22,3150,13076,8,0,7.5,6140,16066
5.25e+05,2014,279,3,1.75,1970,8000,1,0,0,4,8,1970,0,1968,1968,98052,47.632,122.1,1910,8000,46,0,4.75,3880,9970
1.15e+06,2014,127,4,4,4460,1.0338e+05,2,0,0,3,11,4460,0,2001,2001,98053,47.634,122,3470,88519,13,0,8,7930,92979
6.22e+05,2014,300,4,1.75,2680,6120,1,0,0,5,8,1340,1340,1959,1959,98117,47.697,122.39,2320,6840,55,0,5.75,5000,9520
2e+05,2014,169,3,1.5,1140,8340,1,0,0,3,7,1140,0,1960,1960,98168,47.477,122.28,1140,8340,54,0,4.5,2280,9480
2.9e+05,2014,299,3,2.5,1190,8175,1,0,0,3,7,1190,0,1986,1986,98055,47.456,122.2,2230,9520,28,0,5.5,3420,10710
2.9e+05,2015,473,5,2.5,2180,8240,1,0,0,4,8,1220,960,1977,1977,98092,47.312,122.19,2050,7590,38,0,7.5,4230,9770
5.5e+05,2015,451,3,2.5,2080,2625,2,0,0,3,8,2080,0,2006,2006,98029,47.547,122,1760,2772,9,0,5.5,3840,4852
3.99e+05,2015,413,3,1.75,1780,11440,1,0,0,3,8,1350,430,1977,1977,98059,47.474,122.14,2180,11440,38,0,4.75,3960,13220
5e+05,2014,147,3,2.25,1760,4539,2,0,0,3,8,1760,0,1988,1988,98029,47.575,122.01,1960,4808,26,0,5.25,3720,6568
7.9e+05,2014,191,4,2.5,3500,9198,2,0,0,3,9,3500,0,2004,2004,98053,47.678,122.03,3990,8598,10,0,6.5,7490,12098
3.58e+05,2014,210,3,1.5,1250,7194,1,0,0,4,7,1250,0,1969,1969,98034,47.73,122.23,1340,7242,45,0,4.5,2590,8492
1.3569e+06,2014,181,4,3.5,4270,5800,2,0,3,5,10,3170,1100,1937,1937,98199,47.647,122.41,3100,5800,77,0,7.5,7370,10070
2.3e+05,2014,187,3,1,1390,6000,1,0,0,3,5,1390,0,1954,1954,98056,47.498,122.17,1170,6000,60,0,4,2560,7390
4.9e+05,2014,292,2,1,1420,4305,1,0,0,4,7,920,500,1941,1941,98115,47.686,122.31,1420,4305,73,0,3,2840,5725
2.35e+05,2014,162,3,1.75,1840,9697,1,0,0,4,7,1500,340,1985,1985,98030,47.376,122.18,1430,8079,29,0,4.75,3270,9919
3.5e+05,2015,485,4,2.25,1780,10416,1,0,0,5,7,1060,720,1963,1963,98055,47.441,122.19,1780,9975,52,0,6.25,3560,11755
2.4e+05,2014,277,3,1,1470,7350,1,0,0,3,7,1470,0,1969,1969,98032,47.362,122.29,1720,8050,45,0,4,3190,9520
1.967e+05,2014,312,2,1,1090,9994,1,0,0,3,7,1090,0,1954,1954,98168,47.476,122.29,1090,11700,60,0,3,2180,12790
1.4e+06,2014,168,4,2.75,3870,10046,2,0,0,3,11,3870,0,2005,2005,98033,47.665,122.19,3560,10046,9,0,6.75,7430,13916
3.463e+05,2015,480,4,2.5,2590,11018,2,0,0,3,8,2590,0,1998,1998,98092,47.263,122.21,2400,8042,17,0,6.5,4990,10632
1.495e+05,2014,160,3,1,1010,9450,1,0,0,4,7,1010,0,1959,1959,98198,47.359,122.31,1240,9450,55,0,4,2250,10460
3e+05,2014,188,4,2.5,2200,8065,2,0,0,3,7,2200,0,1998,1998,98031,47.404,122.21,2641,8535,16,0,6.5,4841,10735
6e+05,2014,232,4,2.5,2370,9135,1,0,0,4,8,1600,770,1967,1967,98006,47.556,122.18,2050,9468,47,0,6.5,4420,11838
8.397e+05,2015,444,4,3.25,2950,4161,2,0,0,3,10,2210,740,2014,2014,98027,47.53,122.07,2790,3693,1,0,7.25,5740,6643
4.08e+05,2014,180,5,3.25,2820,6589,1,0,0,3,7,2320,500,1906,2014,98118,47.536,122.27,1560,5647,108,1,8.25,4380,8467
4.899e+05,2014,231,3,1,1680,8910,1,0,0,4,7,1680,0,1940,1940,98117,47.701,122.38,1620,7182,74,0,4,3300,8862
2.465e+05,2014,149,3,1.5,1270,11600,1,0,0,4,7,1270,0,1964,1964,98031,47.407,122.2,1380,9945,50,0,4.5,2650,11215
7.82e+05,2014,287,4,1.75,1500,6820,1,0,0,5,7,1500,0,1905,1905,98117,47.679,122.37,1360,4125,109,0,5.75,2860,5625
3.37e+05,2014,198,2,1,1010,4000,1,0,0,3,7,1010,0,1947,1947,98136,47.531,122.38,1480,4366,67,0,3,2490,5376
7.91e+05,2014,154,3,2.25,2430,5500,2,0,0,3,8,1810,620,1989,1989,98033,47.681,122.2,2040,5500,25,0,5.25,4470,7930
3.85e+05,2015,472,3,1,1020,5950,1,0,0,3,6,880,140,1950,1950,98106,47.544,122.36,1800,5950,65,0,4,2820,6970
4.35e+05,2014,313,3,2.5,3380,7074,2,0,0,3,8,2200,1180,1999,1999,98019,47.746,121.98,2060,6548,15,0,5.5,5440,9928
2.7e+05,2014,237,3,1.75,1260,7500,1,0,0,3,6,840,420,1947,1947,98155,47.772,122.32,1340,7500,67,0,4.75,2600,8760
5.3e+05,2014,209,3,2.5,1970,6295,2,0,0,3,7,1970,0,2011,2011,98065,47.516,121.87,2710,6009,3,0,5.5,4680,7979
5.4e+05,2015,481,3,2.5,1970,14876,1,0,0,3,7,1320,650,1981,1981,98146,47.503,122.37,2030,8008,34,0,5.5,4000,9978
3.7e+05,2014,270,3,2.25,2110,13300,2,0,0,4,8,2110,0,1985,1985,98038,47.373,122.06,2470,14000,29,0,5.25,4580,16110
5.685e+05,2014,152,3,2.75,2180,7519,1,0,0,4,7,1310,870,1981,1981,98052,47.696,122.13,1510,7107,33,0,5.75,3690,9287
6.67e+05,2015,470,3,1.75,1370,1921,3,0,0,3,8,1370,0,2007,2007,98103,47.66,122.35,1370,4000,8,0,4.75,2740,5370
2.58e+05,2015,477,2,1,750,7000,1,0,0,3,6,750,0,1932,1932,98024,47.566,121.89,1100,8777,83,0,3,1850,9527
3.4e+05,2014,332,3,2.25,1900,8125,1,0,0,3,7,1540,360,1969,1969,98058,47.456,122.16,1480,8284,45,0,5.25,3380,10184
2.28e+05,2014,332,3,1,1000,16376,1,0,0,3,7,1000,0,1959,1959,98059,47.483,122.11,1420,16192,55,0,4,2420,17192
4.53e+05,2015,440,4,2.5,2502,8306,2,0,0,3,9,2502,0,2013,2013,98001,47.295,122.27,2597,6983,2,0,6.5,5099,9485
4.6e+05,2014,181,3,2.5,1450,1053,2,0,0,3,8,940,510,2008,2008,98107,47.675,122.37,1410,1080,6,0,5.5,2860,2530
4.33e+05,2015,445,3,2.5,1270,1062,2,0,0,3,8,1060,210,2008,2008,98105,47.657,122.32,1260,1112,7,0,5.5,2530,2382
3e+05,2014,312,2,1,1100,4010,1,0,0,5,6,1100,0,1920,1920,98106,47.53,122.35,980,4501,94,0,3,2080,5601
4.49e+05,2015,372,3,2.25,1960,44634,1,0,0,3,7,1130,830,1984,1984,98028,47.777,122.25,1970,44634,31,0,5.25,3930,46594
5.97e+05,2014,264,4,2.5,2280,2432,2,0,0,5,8,1520,760,1921,1921,98103,47.66,122.36,1690,2099,93,0,6.5,3970,4379
2.15e+05,2014,189,3,1.75,1770,29004,1,0,0,3,8,1770,0,1959,1959,98023,47.32,122.36,2300,24534,55,0,4.75,4070,26304
2.75e+05,2015,413,3,1.75,1290,9760,1,0,0,3,7,1290,0,1979,1979,98058,47.426,122.15,1410,8034,36,0,4.75,2700,9324
3.75e+05,2014,197,2,1,940,5120,1,0,0,3,7,940,0,1909,1909,98122,47.607,122.31,1300,5120,105,0,3,2240,6060
8.2e+05,2014,144,4,2.5,3670,7000,2,0,0,3,10,3670,0,2005,2005,98075,47.585,122.08,3680,7437,9,0,6.5,7350,11107
4.5e+05,2014,250,3,1,1290,47044,1,0,0,3,7,1150,140,1968,1968,98029,47.566,122,1960,49658,46,0,4,3250,50948
2.85e+05,2015,458,3,1,950,10723,1,0,0,4,6,950,0,1959,1959,98059,47.49,122.13,1520,10723,56,0,4,2470,11673
9e+05,2015,491,5,2.25,2510,35691,1,0,0,3,9,2510,0,1967,1967,98005,47.644,122.15,3160,35037,48,0,7.25,5670,37547
3.051e+05,2014,159,3,2,1590,35988,1,0,0,4,8,1590,0,1974,1974,98058,47.437,122.11,2780,23789,40,0,5,4370,25379
2.6e+05,2014,167,3,1.75,1440,12888,1,0,2,3,7,1090,350,1958,1958,98168,47.471,122.26,1710,12888,56,0,4.75,3150,14328
4.1e+05,2014,229,3,1.75,1510,6597,1,0,0,4,6,950,560,1939,1939,98144,47.594,122.31,1460,5320,75,0,4.75,2970,6830
4.94e+05,2015,472,3,3.5,1570,1486,2,0,0,3,8,1330,240,2000,2000,98199,47.652,122.38,1610,1486,15,0,6.5,3180,3056
5.7265e+05,2014,211,4,2.5,2250,11349,2,0,0,3,8,2250,0,1991,1991,98034,47.711,122.24,2110,9964,23,0,6.5,4360,12214
1.225e+06,2014,211,3,2.5,3420,79279,2,0,0,3,11,3420,0,1990,1990,98052,47.722,122.13,4240,40500,24,0,5.5,7660,43920
8.3e+05,2015,416,2,1,1150,6000,1,0,1,4,7,710,440,1921,1921,98033,47.684,122.21,2450,7200,94,0,3,3600,8350
4.45e+05,2014,306,3,1.75,1750,7200,1,0,0,3,7,1750,0,1966,1966,98008,47.629,122.12,1810,7590,48,0,4.75,3560,9340
2.95e+05,2014,174,2,1,650,5400,1,0,0,3,6,650,0,1950,1950,98122,47.618,122.3,1310,4906,64,0,3,1960,5556
2e+06,2014,310,3,3.25,2610,16387,2,1,4,3,9,2610,0,2006,2006,98125,47.718,122.28,2590,12958,8,0,6.25,5200,15568
5.5e+05,2015,472,4,2,1720,4000,1,0,0,3,7,1420,300,1950,1950,98105,47.665,122.28,1350,1281,65,0,6,3070,3001
2.33e+05,2014,221,3,1,1100,7657,1,0,0,3,7,1100,0,1955,1955,98188,47.437,122.28,1300,8000,59,0,4,2400,9100
1.075e+06,2014,182,3,2.5,3280,10302,1,0,0,3,10,1680,1600,1970,1970,98115,47.695,122.29,1550,6300,44,0,5.5,4830,9580
5.01e+05,2014,125,4,1,2070,7519,1,0,0,3,7,1160,910,1963,1963,98008,47.632,122.12,1730,7519,51,0,5,3800,9589
5.38e+05,2014,334,3,2.75,2000,7204,1,0,0,5,7,1250,750,1960,1960,98006,47.565,122.12,2480,17633,54,0,5.75,4480,19633
3.3e+05,2015,443,2,1.5,1440,11954,1,0,0,4,8,1440,0,1978,1978,98002,47.291,122.22,1460,9730,37,0,3.5,2900,11170
6.025e+05,2015,492,2,2.5,3090,47044,1,0,0,4,10,2250,840,1979,1979,98058,47.429,122.18,1860,62829,36,0,4.5,4950,65919
6.9e+05,2015,459,5,3.25,3340,9075,2,0,0,3,8,2600,740,2005,2005,98065,47.545,121.88,2770,6646,10,0,8.25,6110,9986
5.56e+05,2014,143,5,2.5,3840,16905,2,0,0,3,11,3840,0,1991,1991,98023,47.3,122.34,3270,12133,23,0,7.5,7110,15973
4.13e+05,2015,410,3,1.75,2280,1.3939e+05,1,0,0,3,8,2280,0,1977,1977,98092,47.291,122.12,2280,1.1718e+05,38,0,4.75,4560,1.1946e+05
3.75e+05,2014,203,3,1.5,1110,5500,1,0,0,3,6,1110,0,1940,1997,98033,47.672,122.18,1670,6600,74,1,4.5,2780,7710
4.69e+05,2015,422,4,2.5,2240,5624,1,0,0,3,7,1520,720,1961,1961,98108,47.557,122.31,2240,7495,54,0,6.5,4480,9735
9.31e+05,2014,361,3,2.5,2460,6600,1,0,0,4,8,1560,900,1929,1929,98109,47.636,122.35,2090,3400,85,0,5.5,4550,5860
6.85e+05,2015,413,4,2,2260,10800,1,0,0,3,9,2260,0,1978,1978,98007,47.612,122.15,2650,9900,37,0,6,4910,12160
7.5289e+05,2014,232,3,2.5,2420,9000,2,0,0,4,9,2420,0,1987,1987,98007,47.66,122.15,2630,9000,27,0,5.5,5050,11420
6.505e+05,2014,216,4,1.75,2340,5940,1,0,0,3,8,1290,1050,1953,1953,98115,47.679,122.28,1930,5940,61,0,5.75,4270,8280
3.25e+05,2015,408,2,2,1040,5796,1,0,2,4,6,1040,0,1921,1921,98155,47.736,122.29,2300,5796,94,0,4,3340,6836
1.9e+05,2014,150,3,2.25,1590,11745,1,0,0,3,7,1090,500,1978,1978,98001,47.355,122.28,1540,12530,36,0,5.25,3130,14120
4.07e+05,2014,223,4,2.5,2927,6000,2,0,0,3,7,2927,0,2011,2011,98042,47.374,122.16,2533,6000,3,0,6.5,5460,8927
3.9425e+05,2014,324,3,2,2620,10107,1,0,3,3,7,2620,0,1982,1982,98198,47.41,122.33,1730,7812,32,0,5,4350,10432
1.972e+05,2015,380,3,1,1140,8775,1,0,0,3,6,990,150,1942,1942,98146,47.482,122.34,1300,8775,73,0,4,2440,9915
3.75e+05,2014,127,3,2.5,1830,13042,2,0,0,3,8,1830,0,1990,1990,98038,47.374,122.04,1940,6996,24,0,5.5,3770,8826
3.599e+05,2014,201,4,2.25,2470,7698,2,0,0,3,8,2470,0,1983,1983,98058,47.441,122.14,2330,7986,31,0,6.25,4800,10456
4.66e+05,2015,479,4,2,2240,4508,1,0,2,4,8,1340,900,1926,1926,98178,47.51,122.25,1930,5250,89,0,6,4170,7490
4.26e+05,2015,478,4,2.5,2568,5000,2,0,0,3,9,2568,0,2014,2014,98092,47.26,122.19,2547,4500,1,0,6.5,5115,7068
5.6e+05,2015,457,3,2.75,1620,7500,1,0,0,5,7,1140,480,1979,1979,98074,47.617,122.06,1900,7500,36,0,5.75,3520,9120
2.5e+05,2014,252,2,1,670,4640,1,0,0,3,6,670,0,1943,1943,98106,47.53,122.35,870,4501,71,0,3,1540,5171
7.5e+05,2015,484,2,2,2370,1.5513e+05,1,0,0,3,7,2370,0,1970,1970,98019,47.739,121.97,1860,14475,45,0,4,4230,16845
6.315e+05,2015,478,2,2.5,1780,2493,3,0,0,3,8,1780,0,1981,1981,98107,47.67,122.36,2050,4400,34,0,4.5,3830,6180
4.03e+05,2014,128,3,2.75,2090,8354,2,0,0,3,8,2090,0,2012,2012,98019,47.734,121.97,2280,6348,2,0,5.75,4370,8438
4.33e+05,2014,181,4,1.5,1550,5053,1,0,0,4,7,1180,370,1963,1963,98118,47.55,122.27,1450,5639,51,0,5.5,3000,7189
9.9995e+05,2015,443,3,2.25,3740,22464,2,0,0,5,8,2330,1410,1966,1966,98004,47.635,122.2,2680,19564,49,0,5.25,6420,23304
6.05e+05,2014,214,4,2,1820,7626,1,0,0,5,7,990,830,1941,1941,98103,47.688,122.34,1390,5904,73,0,6,3210,7724
1.7e+05,2014,244,1,1,480,4560,1,0,0,3,5,480,0,1922,1922,98065,47.525,121.83,890,4803,92,0,2,1370,5283
2.9026e+05,2014,190,3,2.25,1720,7885,2,0,0,3,8,1720,0,1983,1983,98023,47.314,122.34,2340,7885,31,0,5.25,4060,9605
5.96e+05,2015,414,3,2.5,1730,2631,2,0,0,3,8,1730,0,2001,2001,98005,47.588,122.17,1730,2751,14,0,5.5,3460,4481
2.95e+05,2015,429,4,2,1650,7200,1,0,0,3,7,1650,0,1964,1964,98133,47.754,122.34,1410,7200,51,0,6,3060,8850
9.99e+05,2014,300,3,2.5,2710,23292,1,0,4,3,9,2080,630,1956,1956,98177,47.761,122.37,2430,20000,58,0,5.5,5140,22710
4.89e+05,2014,324,2,1,850,2850,1,0,0,4,7,850,0,1927,1927,98115,47.688,122.31,1450,4015,87,0,3,2300,4865
3.9e+05,2014,203,4,2.5,1840,15496,2,0,0,3,8,1840,0,1991,1991,98059,47.468,122.07,1840,15040,23,0,6.5,3680,16880
4.915e+05,2014,180,3,2.25,1470,4322,2,0,0,3,7,1470,0,1985,1985,98029,47.567,122.02,1610,4322,29,0,5.25,3080,5792
3e+05,2014,182,2,1,1010,11919,1,0,0,3,6,1010,0,1947,1947,98155,47.746,122.32,1220,11240,67,0,3,2230,12250
3.2e+05,2015,372,3,2,1250,8636,1,0,0,5,7,1250,0,1968,1968,98059,47.507,122.16,1620,7653,47,0,5,2870,8903
3.55e+05,2014,269,4,1.75,2040,15000,1,0,0,4,7,1360,680,1967,1967,98092,47.311,122.19,2310,15000,47,0,5.75,4350,17040
4.85e+05,2015,450,3,2.5,3340,70131,2,0,0,3,9,2420,920,1994,1994,98022,47.267,122.02,2760,1.1674e+05,21,0,5.5,6100,1.2008e+05
3.3e+05,2015,372,4,2.5,2240,7589,2,0,0,3,8,2240,0,1994,1994,98030,47.382,122.21,2250,7300,21,0,6.5,4490,9540
4.35e+05,2014,297,3,2.5,2530,16102,2,0,0,3,9,2530,0,1989,1989,98038,47.371,122.06,2370,14957,25,0,5.5,4900,17487
1.95e+06,2015,458,4,2.5,3440,14554,2,1,4,3,8,2170,1270,2012,2012,98155,47.736,122.29,3170,11810,3,0,6.5,6610,15250
3.4e+05,2014,313,4,1,1200,11834,1,1,3,3,6,1200,0,1972,1972,98070,47.456,122.44,1670,47462,42,0,5,2870,48662
1.465e+06,2014,300,4,2.5,2800,4000,2,0,0,3,9,2800,0,2011,2011,98103,47.669,122.34,1770,4200,3,0,6.5,4570,7000
4e+05,2015,452,3,1,1250,7157,1,0,0,3,7,1250,0,1944,2010,98125,47.732,122.3,1300,6796,71,1,4,2550,8046
1.75e+05,2015,425,3,1,1070,6164,1,0,0,3,7,1070,0,1967,1967,98001,47.338,122.29,1320,7920,48,0,4,2390,8990
6.1985e+05,2014,169,4,2.5,2270,9247,1,0,0,5,8,1500,770,1972,1972,98006,47.56,122.18,2270,9163,42,0,6.5,4540,11433
3.95e+05,2015,414,3,1.5,1730,7800,1,0,0,3,7,1330,400,1958,1958,98133,47.736,122.34,1780,8309,57,0,4.5,3510,10039
2.95e+05,2014,204,3,1,830,3386,1,0,0,3,6,830,0,1942,1989,98133,47.703,122.36,1300,3844,72,1,4,2130,4674
1.5855e+05,2014,273,5,1.5,1710,8100,1,0,0,4,7,1710,0,1961,1961,98032,47.384,122.29,1480,8025,53,0,6.5,3190,9735
2.9e+05,2014,305,3,2.25,1650,10336,1,0,0,3,7,1500,150,1962,1962,98133,47.776,122.35,1420,10260,52,0,5.25,3070,11910
4.03e+05,2014,332,2,1,720,3255,1,0,0,4,6,720,0,1905,1905,98103,47.682,122.35,1430,3170,109,0,3,2150,3890
6.05e+05,2014,303,5,2.25,3220,9603,2,0,0,3,8,3220,0,1972,1972,98052,47.647,122.11,2260,10093,42,0,7.25,5480,13313
1.93e+05,2014,198,3,1,960,10761,1,0,0,4,6,960,0,1962,1962,98002,47.282,122.22,960,10761,52,0,4,1920,11721
2.8093e+05,2014,176,4,2.25,2070,7350,2,0,0,4,8,2070,0,1977,1977,98032,47.361,122.27,2080,7210,37,0,6.25,4150,9280
2.24e+05,2015,474,1,0.75,840,7203,1,0,0,3,6,840,0,1949,1949,98168,47.476,122.3,1560,8603,66,0,1.75,2400,9443
2.35e+05,2015,432,4,1.5,1920,11595,1,0,0,4,7,1920,0,1962,1962,98002,47.286,122.21,1400,10550,53,0,5.5,3320,12470
8.15e+05,2015,479,3,1.5,1940,3570,2,0,0,4,8,1740,200,1916,1916,98105,47.662,122.33,1580,3570,99,0,4.5,3520,5510
2.55e+05,2014,182,4,2,2430,8960,1,0,0,3,7,1430,1000,1960,1960,98178,47.498,122.23,2430,8960,54,0,6,4860,11390
3.92e+05,2015,432,4,2.5,2130,4028,2,0,0,3,8,2130,0,2014,2014,98146,47.511,122.36,1830,7817,1,0,6.5,3960,9947
6.28e+05,2014,202,3,1.75,4000,11894,1,0,0,3,9,2190,1810,1987,1987,98011,47.774,122.2,2530,8650,27,0,4.75,6530,12650
4.25e+05,2014,346,3,1.75,1680,14630,1,0,0,3,8,1680,0,1985,1985,98027,47.527,122.04,1920,14630,29,0,4.75,3600,16310
4.25e+05,2015,460,4,2.5,2400,6053,2,0,0,3,8,2400,0,2001,2001,98038,47.387,122.03,2460,6519,14,0,6.5,4860,8919
2.7e+05,2014,155,3,1.5,1890,9450,1,0,0,3,7,1090,800,1957,1957,98146,47.483,122.34,1470,8100,57,0,4.5,3360,9990
4.3695e+05,2014,273,4,2.5,2708,4772,2,0,0,3,9,2708,0,2014,2014,98092,47.341,122.18,2502,4900,0,0,6.5,5210,7608
4.75e+05,2014,324,3,1.5,1240,8738,1,0,0,3,7,1240,0,1959,1959,98005,47.585,122.17,1440,9344,55,0,4.5,2680,10584
3.83e+05,2014,143,3,1,1800,5612,1,0,0,4,7,1200,600,1942,1942,98126,47.525,122.38,1450,5250,72,0,4,3250,7050
5.4e+05,2014,168,4,2.5,2050,34222,2,0,0,4,8,2050,0,1989,1989,98077,47.757,122.02,2240,51400,25,0,6.5,4290,53450
7.749e+05,2014,318,5,1,1750,3861,1,0,0,3,7,1750,0,1903,1903,98122,47.608,122.3,1700,4255,111,0,6,3450,6005
3.66e+05,2014,258,3,1.75,1680,6108,1,0,0,3,8,1680,0,1989,1989,98055,47.45,122.21,2220,5664,25,0,4.75,3900,7344
7.102e+05,2015,473,4,3,1670,2642,2,0,0,3,8,1350,320,2008,2008,98109,47.64,122.34,1670,2594,7,0,7,3340,4264
3.839e+05,2015,477,3,1.5,1600,8040,1,0,0,4,7,1050,550,1965,1965,98133,47.747,122.34,1810,7819,50,0,4.5,3410,9419
3.19e+05,2014,321,3,2.5,2110,7434,2,0,0,4,7,2110,0,1978,1978,98031,47.394,122.17,2100,7749,36,0,5.5,4210,9859
6.5e+05,2014,332,4,2,1610,8976,1,0,0,4,8,1610,0,1966,1966,98004,47.601,122.19,1930,8976,48,0,6,3540,10586
4.95e+05,2014,141,3,3.5,2380,6250,2,0,3,3,8,1670,710,1997,1997,98118,47.514,122.25,2540,4010,17,0,6.5,4920,6390
5e+05,2014,347,3,2,1560,1156,3,0,0,3,8,1560,0,2014,2014,98122,47.605,122.3,1560,1728,0,0,5,3120,3288
2.4e+05,2014,215,6,1.75,2210,8594,1,0,0,3,7,1310,900,1959,1959,98188,47.459,122.27,1850,8594,55,0,7.75,4060,10804
5.01e+05,2014,144,2,1,1010,4320,1,0,0,5,7,1010,0,1924,1924,98115,47.685,122.32,1680,4320,90,0,3,2690,5330
4.44e+05,2014,222,4,3,2800,7198,2,0,0,3,8,2800,0,2002,2002,98038,47.354,122.01,3610,7845,12,0,7,6410,10645
8.5e+05,2014,168,5,3.5,3450,28324,1,0,0,5,8,2350,1100,1972,1972,98033,47.699,122.2,2640,14978,42,0,8.5,6090,18428
4.9e+05,2014,203,4,2.5,2510,4349,2,0,0,3,8,2510,0,2010,2010,98059,47.493,122.15,2510,4314,4,0,6.5,5020,6824
5.7e+05,2014,352,4,2.75,3250,5600,2,0,0,3,8,3250,0,2011,2011,98059,47.481,122.13,2730,5667,3,0,6.75,5980,8917
9.3e+05,2014,171,3,2.5,3290,6830,2,0,0,3,10,3290,0,2000,2000,98052,47.67,122.14,3200,6227,14,0,5.5,6490,9517
3.37e+05,2014,209,4,2,1590,8779,1,0,0,3,8,1590,0,2001,2001,98019,47.741,121.97,2090,9600,13,0,6,3680,11190
6.35e+05,2015,373,4,2.5,2720,7991,2,0,0,3,9,2720,0,2006,2006,98133,47.717,122.33,1590,8611,9,0,6.5,4310,11331
1.29e+05,2014,154,1,1,650,15364,1,0,0,4,5,650,0,1967,1967,98042,47.372,122.16,1630,7952,47,0,2,2280,8602
6.6875e+05,2014,141,4,2.5,2340,6420,1,0,2,3,8,1590,750,1964,1964,98177,47.773,122.39,2110,10856,50,0,6.5,4450,13196
2.315e+05,2015,466,2,1,1000,7615,1,0,0,4,6,1000,0,1943,1943,98056,47.49,122.19,1060,8000,72,0,3,2060,9000
3.45e+05,2015,443,3,1,1060,5600,1,0,0,4,6,760,300,1943,1943,98146,47.512,122.38,1310,5600,72,0,4,2370,6660
2.9995e+05,2014,251,3,2.5,1780,4650,2,0,0,3,7,1780,0,2011,2011,98038,47.386,122.05,3050,3848,3,0,5.5,4830,5628
7.95e+05,2014,242,3,3.5,3190,10223,2,0,0,3,10,2560,630,1994,1994,98052,47.697,122.1,3120,9735,20,0,6.5,6310,12925
1.4e+05,2015,375,3,1,1000,10560,1,0,0,3,7,1000,0,1955,1955,98003,47.322,122.32,1190,9375,60,0,4,2190,10375
4.11e+05,2014,198,2,2,1130,1148,2,0,0,3,9,800,330,2007,2007,98122,47.602,122.31,1350,1201,7,0,4,2480,2331
4.435e+05,2014,197,3,2.5,2170,5866,2,0,0,3,7,2170,0,2006,2006,98065,47.54,121.89,2440,5798,8,0,5.5,4610,7968
5.3e+05,2014,164,3,2.5,1930,7214,2,0,0,3,8,1930,0,2005,2005,98125,47.719,122.31,1930,7266,9,0,5.5,3860,9196
1.95e+05,2014,177,2,1,1020,8100,1,0,0,3,6,1020,0,1940,1940,98168,47.497,122.33,1200,12500,74,0,3,2220,13520
4.15e+05,2014,307,4,1.5,2700,14760,1,0,0,5,9,2700,0,1940,1940,98022,47.2,122,1670,7200,74,0,5.5,4370,9900
9.95e+05,2015,446,4,2.25,2340,13406,1,0,0,4,9,2340,0,1963,1963,98040,47.538,122.22,2340,10743,52,0,6.25,4680,13083
2.76e+05,2014,155,4,2.5,2068,7242,2,0,0,4,7,2068,0,1976,1976,98001,47.332,122.28,1560,7524,38,0,6.5,3628,9592
3.06e+05,2015,477,2,1,930,5650,1,0,2,3,7,930,0,1941,1941,98126,47.548,122.38,1340,6400,74,0,3,2270,7330
4.3e+05,2014,277,3,1.75,1610,7900,1,0,0,4,8,1310,300,1960,1960,98177,47.759,122.36,2210,7700,54,0,4.75,3820,9310
2.55e+05,2015,457,3,1.75,2190,6000,1,0,0,4,7,2190,0,1920,1920,98002,47.306,122.22,1610,6000,95,0,4.75,3800,8190
6e+05,2014,125,3,1.75,1670,39639,1,0,0,4,8,1670,0,1976,1992,98075,47.593,121.99,2330,30492,38,1,4.75,4000,32162
4.5e+05,2014,331,4,2.75,2900,6400,2,0,0,3,7,2040,860,1911,1970,98136,47.556,122.39,1340,6144,103,1,6.75,4240,9044
2.8e+05,2014,291,3,1,1260,7660,1,0,0,3,6,1260,0,1947,1947,98133,47.748,122.35,1990,7861,67,0,4,3250,9121
3.725e+05,2014,202,2,2.5,1400,2958,2,0,0,3,8,1400,0,2007,2007,98126,47.55,122.37,1540,2385,7,0,4.5,2940,3785
3.43e+05,2014,167,3,2.5,1270,2509,2,0,0,3,8,1270,0,2004,2004,98106,47.536,122.36,1420,2206,10,0,5.5,2690,3476
3.7e+05,2014,146,3,2.5,1780,4050,2,0,0,3,7,1780,0,2001,2001,98155,47.735,122.31,1571,4976,13,0,5.5,3351,6756
2.565e+05,2014,139,2,1,1120,9912,1,0,0,4,6,1120,0,1980,1980,98070,47.373,122.43,1540,9750,34,0,3,2660,10870
1.1995e+06,2015,474,4,2.5,3240,13044,2,0,0,4,9,3240,0,1984,1984,98040,47.583,122.24,2920,13044,31,0,6.5,6160,16284
8.73e+05,2015,414,3,2.25,2720,54450,2,0,0,3,11,2720,0,1997,1997,98027,47.547,122.09,3170,60548,18,0,5.25,5890,63268
4.87e+05,2015,486,3,1.75,1430,12632,1,0,0,3,7,1430,0,1959,1959,98008,47.637,122.12,1750,10350,56,0,4.75,3180,11780
5.5e+05,2015,383,3,1,1520,2500,1,0,0,3,8,1520,0,1912,1912,98109,47.635,122.35,1880,3600,103,0,4,3400,5120
3.3e+05,2014,161,3,2.5,2210,7557,2,0,0,3,9,2210,0,1989,1989,98023,47.308,122.39,2440,8641,25,0,5.5,4650,10851
7.29e+05,2015,365,4,2.5,2660,5608,2,0,0,3,9,2660,0,2003,2003,98029,47.545,122,3010,5608,12,0,6.5,5670,8268
3.65e+05,2015,453,4,1.75,3080,32997,1,0,0,4,7,3080,0,1950,1982,98168,47.498,122.32,1980,5711,65,1,5.75,5060,8791
6.4e+05,2015,408,3,3.5,1740,1975,2,0,3,3,8,1310,430,1998,1998,98122,47.608,122.31,1740,1975,17,0,6.5,3480,3715
5.8e+05,2014,279,6,1.75,2180,4000,1,0,0,4,7,1380,800,1926,1926,98105,47.664,122.29,1720,4000,88,0,7.75,3900,6180
2.2e+05,2014,224,3,1.5,1070,9331,1,0,0,3,6,1070,0,1956,1956,98155,47.763,122.31,1480,8400,58,0,4.5,2550,9470
7.4e+05,2015,460,5,3,3655,51836,1,0,0,5,8,2174,1481,1955,1955,98008,47.643,122.11,2530,8606,60,0,8,6185,12261
1.4e+06,2014,122,4,2.5,2920,4000,1,0,0,5,8,1910,1010,1909,1909,98105,47.658,122.28,2470,4000,105,0,6.5,5390,6920
3.799e+05,2015,437,3,2.5,2190,5071,2,0,0,3,8,2190,0,2004,2004,98038,47.351,122.04,2300,5654,11,0,5.5,4490,7844
3.2895e+05,2014,181,4,1.75,2550,8976,1,0,0,5,7,1300,1250,1978,1978,98058,47.429,122.18,2220,9477,36,0,5.75,4770,12027
2.92e+05,2015,425,3,2.25,1780,9720,1,0,0,3,8,1280,500,1981,1981,98059,47.476,122.16,1710,9790,34,0,5.25,3490,11570
5.675e+05,2014,335,2,1.5,1350,4592,1,0,0,3,7,1070,280,1939,1939,98199,47.651,122.41,1610,5102,75,0,3.5,2960,6452
5.88e+05,2014,256,3,1.5,1780,4200,1,0,0,4,8,1780,0,1916,1916,98103,47.662,122.35,1380,3333,98,0,4.5,3160,5113
1.6958e+05,2014,275,3,1,1300,8284,1,0,0,3,7,1300,0,1968,1968,98003,47.333,122.31,1360,7848,46,0,4,2660,9148
2.7e+05,2014,198,3,2.5,1770,8640,1,0,0,3,7,1420,350,1986,1986,98001,47.326,122.27,1894,7974,28,0,5.5,3664,9744
3.05e+05,2014,269,4,1,1560,8450,1,0,0,4,6,1560,0,1954,1954,98166,47.455,122.35,1380,8100,60,0,5,2940,9660
8.7e+05,2014,152,4,3,4500,21780,2,0,2,3,9,3040,1460,1980,1980,98040,47.558,122.21,3540,20473,34,0,7,8040,24973
7.55e+05,2014,139,4,2.5,2660,10452,2,0,0,3,9,2660,0,1993,1993,98052,47.697,122.1,2890,9025,21,0,6.5,5550,11685
1.387e+06,2015,471,4,4.5,4490,24767,2,0,2,3,11,3800,690,1998,1998,98006,47.554,122.15,3370,32700,17,0,8.5,7860,37190
5.35e+05,2014,209,3,2,2740,23505,2,0,4,3,10,2740,0,1988,1988,98001,47.319,122.26,2800,16400,26,0,5,5540,19140
3.529e+05,2015,395,2,1.5,1240,1892,2,0,0,3,7,1240,0,2002,2002,98144,47.592,122.3,1220,1740,13,0,3.5,2460,2980
2.5875e+05,2014,243,4,2,2300,8400,1,0,0,4,6,1150,1150,1962,1962,98003,47.328,122.33,1230,8400,52,0,6,3530,10700
4.999e+05,2014,204,4,3,2180,12196,2,0,0,4,7,2180,0,1968,1968,98027,47.534,122.03,1500,6534,46,0,7,3680,8714
1.2689e+06,2015,484,5,3.25,4410,35192,2,0,2,3,12,3880,530,1990,1990,98072,47.752,122.13,4410,59677,25,0,8.25,8820,64087
7.56e+05,2014,236,4,2.5,2730,10753,2,0,0,3,9,2730,0,1991,1991,98006,47.541,122.13,3090,10740,23,0,6.5,5820,13470
3.79e+05,2014,293,3,2.5,1500,7420,1,0,0,3,7,1000,500,1972,1972,98034,47.724,122.17,1840,7272,42,0,5.5,3340,8772
5.1e+05,2014,341,2,1,820,4206,1,0,0,3,5,820,0,1949,1949,98125,47.708,122.28,1810,7200,65,0,3,2630,8020
4.9e+05,2014,238,3,2.25,1620,1062,3,0,0,3,8,1620,0,2014,2014,98122,47.605,122.3,1560,1728,0,0,5.25,3180,3348
9.68e+05,2014,197,5,2.5,2900,9799,1,0,0,3,8,1450,1450,1959,1959,98004,47.626,122.21,2810,9687,55,0,7.5,5710,12587
3.25e+05,2014,232,1,1,1220,12426,1,0,4,4,6,1220,0,1946,1946,98198,47.405,122.33,2770,22270,68,0,2,3990,23490
2.0995e+05,2015,438,3,1.5,2290,9600,1,0,0,4,7,2290,0,1967,1967,98042,47.364,122.11,1310,9600,48,0,4.5,3600,11890
6e+05,2014,287,4,2.5,2090,7290,1,0,0,5,8,1420,670,1966,1966,98007,47.624,122.14,2110,8436,48,0,6.5,4200,10526
3.4e+05,2014,211,3,2,1460,5715,1,0,0,3,7,1460,0,1957,2014,98118,47.54,122.28,1400,5715,57,1,5,2860,7175
1.9652e+06,2014,152,4,3.5,4370,8510,2,0,1,3,10,3610,760,2003,2003,98004,47.588,122.2,2960,10347,11,0,7.5,7330,14717
3.8995e+05,2015,467,3,2.25,1580,920,3,0,0,3,8,1580,0,2015,2015,98106,47.558,122.36,1250,1150,0,0,5.25,2830,2730
4.88e+05,2014,126,5,2,2020,5000,1,0,0,4,7,2020,0,1938,1938,98117,47.695,122.37,1510,6600,76,0,7,3530,8620
5.26e+05,2014,313,3,1.75,1530,6125,1,0,0,3,7,1120,410,1958,1958,98116,47.569,122.4,1360,6125,56,0,4.75,2890,7655
4.45e+05,2014,149,4,1.75,1990,4725,1,0,0,4,7,1190,800,1944,1944,98126,47.528,122.38,1240,4961,70,0,5.75,3230,6951
2.9e+05,2014,305,5,2.5,2780,9652,1,0,0,4,8,1390,1390,1967,1967,98001,47.344,122.27,1790,9652,47,0,7.5,4570,12432
2.0456e+05,2015,429,3,1.75,1260,15000,1,0,0,4,7,1260,0,1983,1983,98092,47.274,122.15,2400,21715,32,0,4.75,3660,22975
4.35e+05,2015,400,4,2.25,2210,14073,1,0,0,3,8,1630,580,1978,1978,98059,47.477,122.14,2340,11340,37,0,6.25,4550,13550
4.15e+05,2014,168,3,1.75,1270,4800,1,0,0,3,7,1270,0,1952,2014,98126,47.536,122.38,1220,4800,62,1,4.75,2490,6070
6.715e+05,2014,224,5,2.75,2160,4000,1,0,0,5,7,1530,630,1927,1927,98105,47.667,122.29,2040,4000,87,0,7.75,4200,6160
2.8e+05,2014,228,3,1.75,1550,7410,1,0,0,5,7,1550,0,1944,1944,98178,47.495,122.24,1250,7467,70,0,4.75,2800,9017
5.35e+05,2015,381,4,2.5,2880,23994,2,0,3,3,9,2880,0,2002,2002,98022,47.212,122,2470,17009,13,0,6.5,5350,19889
2.05e+05,2015,425,4,1,1340,7920,1,0,0,4,7,1340,0,1970,1970,98001,47.285,122.27,1090,9600,45,0,5,2430,10940
4.95e+05,2014,349,2,2.25,1460,1623,2,0,0,3,8,1260,200,2005,2005,98115,47.676,122.3,1460,1137,9,0,4.25,2920,2597
2.637e+05,2015,433,3,1,1200,6561,1,0,0,3,6,1200,0,1950,1968,98177,47.776,122.36,1340,9450,65,1,4,2540,10650
3.4289e+05,2015,400,2,1,790,5150,1,0,0,4,6,790,0,1948,1948,98118,47.553,122.27,1460,5150,67,0,3,2250,5940
1.53e+06,2014,258,4,2.25,4250,16940,1,0,2,4,9,2380,1870,1974,1974,98040,47.545,122.23,3460,17693,40,0,6.25,7710,21943
8.405e+05,2014,148,3,2,2520,5400,1,0,0,4,8,1410,1110,1906,1906,98119,47.636,122.36,1960,5400,108,0,5,4480,7920
3.55e+05,2014,237,3,3,1850,9600,1,0,0,3,7,1230,620,1981,1981,98028,47.772,122.25,1970,10000,33,0,6,3820,11850
2.2e+05,2014,125,4,1.5,1240,9600,1,0,0,3,7,1240,0,1971,1971,98023,47.321,122.4,1240,9592,43,0,5.5,2480,10832
4.325e+05,2015,399,4,1.75,1500,1856,1,0,0,5,7,750,750,1901,1901,98144,47.592,122.3,1220,1739,114,0,5.75,2720,3239
4.25e+05,2014,248,3,2.25,1630,10500,1,0,0,3,7,1100,530,1974,1974,98034,47.718,122.24,1640,9794,40,0,5.25,3270,11424
2.82e+05,2014,345,4,1.75,1660,10725,1,0,0,3,7,960,700,1956,1956,98168,47.503,122.3,1340,9023,58,0,5.75,3000,10683
2.199e+05,2014,160,3,1,970,7742,1,0,0,4,6,970,0,1967,1967,98003,47.317,122.33,970,7650,47,0,4,1940,8620
7.39e+05,2014,360,3,2.5,2750,16000,2,0,0,4,9,2560,190,1981,1981,98033,47.693,122.19,2370,11279,33,0,5.5,5120,14029
3.66e+05,2014,258,2,1,1210,3090,1,0,0,3,6,860,350,1926,1926,98118,47.553,122.28,1210,3348,88,0,3,2420,4558
8.17e+05,2014,298,3,1.5,2310,3360,1,0,0,3,8,1790,520,1926,1926,98119,47.643,122.36,1930,4320,88,0,4.5,4240,6630
4.4025e+05,2015,413,3,1.5,1850,8124,1,0,0,4,7,1850,0,1948,1948,98177,47.727,122.36,1530,8123,67,0,4.5,3380,9973
3.442e+05,2014,191,4,2.5,2490,5812,2,0,0,3,8,2490,0,2000,2000,98042,47.388,122.16,2690,6012,14,0,6.5,5180,8502
5.25e+05,2014,134,3,1.75,1600,6120,1,0,0,3,7,1600,0,1924,1924,98115,47.685,122.29,1670,4590,90,0,4.75,3270,6190
3.35e+05,2014,217,3,1.5,1900,7584,1,0,0,5,7,1900,0,1962,1962,98056,47.509,122.19,1410,7584,52,0,4.5,3310,9484
3.95e+05,2015,446,1,1,790,3000,1,0,0,3,6,790,0,1953,1953,98199,47.654,122.39,1110,4100,62,0,2,1900,4890
5.18e+05,2014,313,5,1,1590,5000,1,0,0,3,7,1190,400,1929,1929,98116,47.575,122.38,1590,5000,85,0,6,3180,6590
2.4e+06,2014,319,4,3.75,4090,24825,2,0,0,4,11,3400,690,1926,1926,98102,47.634,122.32,3910,11500,88,0,7.75,8000,15590
3.21e+05,2014,320,3,2.5,2020,4183,2,0,0,3,7,2020,0,2012,2012,98038,47.366,122.02,2030,4140,2,0,5.5,4050,6160
3.9e+05,2015,423,3,2.25,1490,4539,2,0,0,3,7,1490,0,2009,2009,98028,47.761,122.23,1750,4667,6,0,5.25,3240,6157
6.85e+05,2014,340,4,2.5,3320,38043,2,0,0,3,9,3320,0,1997,1997,98053,47.65,122,3170,42621,17,0,6.5,6490,45941
3.3e+05,2014,342,3,2.5,1676,18778,2,0,0,3,7,1676,0,1997,1997,98014,47.652,121.91,1410,18778,17,0,5.5,3086,20454
2.69e+05,2014,319,2,1.5,1010,6000,1,0,0,4,7,1010,0,1923,1923,98178,47.498,122.22,1290,6000,91,0,3.5,2300,7010
7.5999e+05,2014,300,4,2.5,2540,5760,2,0,0,3,9,2540,0,2009,2009,98029,47.541,121.99,2580,3600,5,0,6.5,5120,6140
1.575e+05,2015,439,3,1,1100,27008,1,0,0,3,6,960,140,1935,1935,98178,47.496,122.25,1280,8890,80,0,4,2380,9990
2.6e+05,2015,436,3,1,1300,10139,1,0,0,3,7,1300,0,1962,2007,98042,47.343,122.09,1260,10139,53,1,4,2560,11439
2.65e+05,2014,173,3,1,1620,9450,1,0,0,3,7,1620,0,1928,1928,98168,47.514,122.31,2070,11970,86,0,4,3690,13590
4.1175e+05,2015,401,3,2.5,1710,3795,2,0,0,3,7,1710,0,2009,2009,98053,47.697,122.02,1600,3821,6,0,5.5,3310,5531
4.78e+05,2014,231,2,1.75,1960,6000,1,0,0,4,7,980,980,1904,1904,98199,47.653,122.4,1650,6000,110,0,3.75,3610,7960
4.7e+05,2014,283,2,1,1190,5200,1,0,0,5,7,1190,0,1912,1912,98103,47.694,122.35,1550,5100,102,0,3,2740,6290
5.35e+05,2014,161,5,2.25,2520,49222,2,0,0,4,8,2520,0,1978,1978,98027,47.492,122.06,2780,55321,36,0,7.25,5300,57841
5.62e+05,2014,168,5,3,2795,15101,2,0,0,3,8,2795,0,1996,1996,98019,47.73,121.97,2750,14567,18,0,8,5545,17362
5.7e+05,2014,348,2,1,1100,4000,1,0,0,3,7,1100,0,1906,1906,98109,47.639,122.35,1590,4000,108,0,3,2690,5100
3.295e+05,2014,276,3,1,1080,5250,1,0,0,4,7,1080,0,1947,1947,98133,47.731,122.34,1100,5250,67,0,4,2180,6330
4.15e+05,2014,215,3,1.75,2000,8400,1,0,0,4,8,2000,0,1959,1959,98133,47.754,122.33,2000,8400,55,0,4.75,4000,10400
4.04e+05,2014,126,4,1.75,1840,10720,1,0,0,3,7,960,880,1958,1958,98008,47.607,122.13,1840,9044,56,0,5.75,3680,10884
2.07e+05,2014,269,3,1,920,5546,1,0,0,2,6,920,0,1928,1928,98125,47.711,122.28,1300,5546,86,0,4,2220,6466
2.9595e+05,2014,183,2,1,1190,6200,1,0,0,3,7,1190,0,1948,1948,98133,47.763,122.34,1470,7800,66,0,3,2660,8990
2.42e+05,2014,190,2,1,960,21850,1,0,0,3,6,960,0,1947,1947,98032,47.412,122.27,1020,21850,67,0,3,1980,22810
3.6e+05,2015,424,3,1,1280,3870,1,0,0,3,7,640,640,1945,1945,98122,47.616,122.29,1280,4800,70,0,4,2560,6080
2.18e+05,2014,297,4,1,1620,17500,1,0,0,3,7,1620,0,1962,1962,98023,47.302,122.39,2400,17394,52,0,5,4020,19014
1.381e+06,2014,147,4,3.75,3160,9525,2,0,0,3,10,3160,0,1997,1997,98040,47.562,122.22,2400,9525,17,0,7.75,5560,12685
2.1264e+05,2014,321,3,1,1570,9650,1,0,0,5,5,1570,0,1922,1922,98010,47.353,121.98,1330,9650,92,0,4,2900,11220
4.18e+05,2015,471,2,1,1040,6900,1,0,0,4,7,1040,0,1915,1915,98136,47.541,122.39,1620,6280,100,0,3,2660,7320
1.75e+05,2014,160,6,1.5,1930,8400,1,0,0,3,7,1030,900,1971,1971,98146,47.487,122.34,1780,9520,43,0,7.5,3710,11450
3.5e+05,2014,357,3,2.5,1860,21876,2,0,0,3,8,1860,0,1992,1992,98014,47.645,121.9,2450,21876,22,0,5.5,4310,23736
6.925e+05,2014,284,3,2.25,3420,9900,1,0,0,3,9,1710,1710,1963,2004,98028,47.741,122.26,2290,10700,51,1,5.25,5710,14120
6.79e+05,2014,189,4,2.75,2100,4480,1,0,0,4,7,1780,320,1928,1928,98105,47.669,122.29,2050,4480,86,0,6.75,4150,6580
3.15e+05,2014,321,2,1,900,8556,1,0,0,3,6,760,140,1941,1941,98136,47.515,122.39,1500,8556,73,0,3,2400,9456
2.74e+05,2014,218,4,1.75,1940,7500,1,0,0,4,7,1720,220,1966,1966,98030,47.374,122.22,2000,9000,48,0,5.75,3940,10940
5.95e+05,2015,400,3,1.75,1910,5753,1,0,3,3,8,1110,800,1941,1941,98115,47.69,122.33,1630,5580,74,0,4.75,3540,7490
1.057e+06,2014,262,4,2.75,4510,5000,2,0,2,3,8,3270,1240,1941,2000,98117,47.685,122.4,2010,5000,73,1,6.75,6520,9510
3.805e+05,2015,473,3,1,1410,7854,1,0,0,4,7,1410,0,1971,1971,98034,47.73,122.19,1460,7500,44,0,4,2870,8910
4.95e+05,2015,375,2,1.75,1280,4000,1,0,0,4,7,730,550,1929,1929,98116,47.58,122.38,2250,5382,86,0,3.75,3530,6662
5.4995e+05,2014,332,4,2.5,2720,13500,1,0,0,3,8,1510,1210,1969,1969,98007,47.619,122.14,2510,12350,45,0,6.5,5230,15070
1.655e+06,2014,147,4,3.5,3080,4815,2,0,3,3,10,2300,780,1937,2009,98199,47.642,122.41,2910,5350,77,1,7.5,5990,8430
4.05e+05,2014,149,5,1.75,1880,10000,1,0,0,3,7,960,920,1963,1963,98034,47.718,122.2,1580,10000,51,0,6.75,3460,11880
9.95e+05,2015,472,4,3.25,3530,20012,2,0,0,3,11,3530,0,1986,1986,98052,47.719,122.13,3850,20707,29,0,7.25,7380,24237
1.45e+06,2014,215,4,3.25,3100,3900,2,0,2,5,9,2090,1010,1923,1923,98109,47.639,122.35,2110,3900,91,0,7.25,5210,7000
4.75e+05,2015,483,3,1.75,1150,10240,1,0,0,3,6,1030,120,1918,1918,98106,47.522,122.36,1270,2566,97,0,4.75,2420,3716
3.54e+05,2014,263,4,2.5,2900,4762,2,0,0,3,8,2900,0,2005,2005,98042,47.366,122.13,2900,5173,9,0,6.5,5800,8073
5.69e+05,2014,189,3,3.25,2220,8227,1,0,0,5,8,1770,450,1929,1929,98108,47.566,122.32,1750,4800,85,0,6.25,3970,7020
5.05e+05,2014,318,2,1,1250,5040,1,0,0,3,7,950,300,1920,1920,98117,47.696,122.36,1290,5040,94,0,3,2540,6290
3.9e+05,2014,154,3,2.25,1250,7500,1,0,0,5,7,1250,0,1942,1942,98146,47.512,122.37,1280,7392,72,0,5.25,2530,8642
6e+05,2014,264,5,4.5,4440,9784,2,0,0,3,10,4440,0,2012,2012,98168,47.47,122.28,2720,10080,2,0,9.5,7160,14520
2.88e+05,2015,368,3,2.25,2090,7500,1,0,0,4,7,1280,810,1977,1977,98031,47.395,122.17,1800,7350,38,0,5.25,3890,9440
3.03e+05,2014,348,2,1.5,1000,1075,2,0,0,3,7,840,160,2007,2007,98144,47.571,122.29,1000,1083,7,0,3.5,2000,2083
5.5e+05,2014,334,4,3.5,3540,4750,2,0,0,3,10,3540,0,2003,2003,98055,47.473,122.19,3310,5655,11,0,7.5,6850,9195
4.79e+05,2014,188,3,1,1340,13750,1,0,0,4,7,1340,0,1955,1955,98006,47.577,122.15,1430,11400,59,0,4,2770,12740
6.4e+05,2014,311,5,2.5,3220,4759,2,0,0,3,8,3220,0,2003,2003,98075,47.596,122.03,2550,4759,11,0,7.5,5770,7979
4.35e+05,2014,223,3,2,1380,2500,1,0,0,3,7,750,630,1986,1986,98107,47.675,122.36,1630,3800,28,0,5,3010,5180
3.66e+05,2014,174,3,1.75,1840,11440,1,0,0,4,8,1340,500,1977,1977,98059,47.474,122.14,1940,11440,37,0,4.75,3780,13280
3.4e+06,2014,173,3,4.5,5230,17826,2,1,4,3,10,3740,1490,2005,2005,98040,47.535,122.24,3670,17826,9,0,7.5,8900,23056
6.65e+05,2014,208,4,2,2970,52567,2,0,0,3,8,2970,0,1924,1985,98072,47.733,122.13,3280,46676,90,1,6,6250,49646
1.1e+06,2014,245,4,2.75,3410,7750,1,0,4,5,8,1710,1700,1958,1958,98116,47.572,122.41,3080,8525,56,0,6.75,6490,11935
2e+05,2015,473,4,2.75,2210,13235,2,0,0,3,8,1730,480,1988,1988,98003,47.354,122.3,1750,7542,27,0,6.75,3960,9752
1.075e+06,2014,310,4,2.75,2580,8100,2,0,1,4,8,1780,800,1964,1964,98040,47.539,122.22,2840,10006,50,0,6.75,5420,12586
3.82e+05,2014,129,3,3.25,1410,1253,3,0,0,3,8,1410,0,2005,2005,98103,47.698,122.34,1410,1253,9,0,6.25,2820,2663
3.58e+05,2014,174,3,1.5,1810,1.0019e+05,1,0,0,5,7,1810,0,1969,1969,98022,47.218,122,1540,40415,45,0,4.5,3350,42225
2.817e+05,2015,472,3,1,1570,8316,1,0,0,3,7,1070,500,1962,1962,98031,47.394,122.2,2030,8295,53,0,4,3600,9865
3.3e+05,2015,460,3,2.5,2060,25046,1,0,0,4,8,1600,460,1980,1980,98022,47.184,121.96,2050,21255,35,0,5.5,4110,23315
3e+05,2015,432,3,2.75,1910,15508,1,0,0,3,8,1210,700,1984,1984,98023,47.313,122.34,2450,7989,31,0,5.75,4360,9899
3.3e+05,2015,365,4,2,1180,7275,1,0,0,3,7,1180,0,1965,1965,98034,47.73,122.2,1210,7275,50,0,6,2390,8455
2.675e+05,2015,416,3,2.25,1860,12000,1,0,0,4,7,1860,0,1976,1976,98092,47.294,122.19,1815,9604,39,0,5.25,3675,11464
1.75e+05,2014,148,2,1,830,2699,1,0,0,3,7,830,0,1996,1996,98038,47.384,122.04,1030,3574,18,0,3,1860,4404
3.616e+05,2014,197,2,1,760,6380,1,0,0,3,6,760,0,1941,1941,98115,47.691,122.31,1590,6380,73,0,3,2350,7140
3.56e+05,2014,134,3,3.5,2100,12384,2,0,0,3,9,2100,0,1980,1980,98188,47.469,122.26,2400,7776,34,0,6.5,4500,9876
7.463e+05,2014,230,3,1.75,2060,5721,1,0,2,3,9,1140,920,1964,1964,98136,47.527,122.39,2060,8124,50,0,4.75,4120,10184
4.3e+05,2014,163,3,2,1910,5040,1,0,0,3,8,1910,0,1971,1971,98074,47.631,122.06,1980,4275,43,0,5,3890,6185
1.13e+06,2015,477,5,2.5,4310,28008,2,0,0,3,10,4310,0,1988,1988,98053,47.666,122.06,3170,28559,27,0,7.5,7480,32869
2.66e+05,2015,471,2,1,700,5559,1,0,0,5,6,700,0,1949,1949,98155,47.749,122.31,1230,8100,66,0,3,1930,8800
2.017e+05,2015,446,3,1,1010,9576,1,0,0,4,7,1010,0,1967,1967,98001,47.296,122.27,1540,9576,48,0,4,2550,10586
2.55e+05,2014,246,2,1,940,9330,1,0,0,3,6,940,0,1941,1941,98118,47.544,122.27,1900,6145,73,0,3,2840,7085
2.577e+05,2014,303,4,2.25,1600,6202,2,0,0,4,7,1600,0,1986,1986,98038,47.378,122.05,1530,6298,28,0,6.25,3130,7898
3.065e+05,2015,487,2,1,1420,16400,1,0,0,4,6,1420,0,1943,1943,98023,47.322,122.34,1900,16400,72,0,3,3320,17820
4.75e+05,2014,210,3,1.75,1260,10065,1,0,0,3,7,1260,0,1954,2014,98006,47.573,122.14,1320,10278,60,1,4.75,2580,11538
3.5e+05,2014,256,3,2.75,3070,5280,2,0,1,3,7,2360,710,1950,1986,98166,47.449,122.35,2570,18983,64,1,5.75,5640,22053
3.5e+05,2014,128,4,1.75,2250,13515,1,0,0,4,8,2150,100,1940,1940,98030,47.379,122.23,2150,12508,74,0,5.75,4400,14758
6.8e+05,2015,437,4,2.5,2880,9202,1,0,0,3,8,1780,1100,1977,1977,98052,47.666,122.14,2500,10265,38,0,6.5,5380,13145
2.87e+05,2014,189,5,1.5,1730,9230,1,0,0,3,7,1010,720,1962,1962,98058,47.465,122.18,1730,9230,52,0,6.5,3460,10960
3e+05,2014,216,3,2.5,1260,3855,2,0,0,3,8,1260,0,1999,1999,98059,47.491,122.15,1310,3344,15,0,5.5,2570,4604
1.225e+06,2014,277,3,2.5,2860,4500,2,0,2,3,8,1980,880,1915,1915,98119,47.646,122.37,2310,4500,99,0,5.5,5170,7360
6e+05,2015,471,3,2,1460,2800,1,0,0,4,7,730,730,1921,1921,98105,47.67,122.3,1780,4560,94,0,5,3240,6020
2.49e+05,2014,285,4,1.75,1630,8410,1,0,0,5,7,1630,0,1943,1943,98188,47.454,122.29,1390,8410,71,0,5.75,3020,10040
4.5e+05,2014,335,4,2.25,1990,7320,1,0,0,4,7,1030,960,1965,1965,98126,47.524,122.38,1320,7320,49,0,6.25,3310,9310
2e+05,2015,389,2,1,1400,9600,1,0,0,4,6,1400,0,1941,1941,98022,47.211,121.99,1230,9600,74,0,3,2630,11000
8.46e+05,2014,211,4,3.25,2720,4000,2,0,1,3,10,2070,650,2014,2014,98118,47.555,122.27,1450,4000,0,0,7.25,4170,6720
8.3e+05,2014,311,5,3.5,3700,5400,2,0,0,3,9,2890,810,2011,2011,98053,47.709,122.12,3620,5460,3,0,8.5,7320,9160
1.95e+05,2014,145,3,1.75,1570,8459,1,0,0,3,7,1570,0,1991,1991,98022,47.202,122.01,1650,8844,23,0,4.75,3220,10414
2.95e+06,2014,242,4,3.25,3890,25470,2,1,3,5,10,3030,860,1923,1923,98105,47.661,122.27,4140,19281,91,0,7.25,8030,23171
4.85e+05,2014,139,3,1,1500,4100,1,0,0,3,7,1370,130,1926,1926,98107,47.669,122.37,1500,4100,88,0,4,3000,5600
4.25e+05,2014,203,3,2,1540,8011,1,0,0,3,7,1540,0,1988,1988,98011,47.734,122.2,1630,7141,26,0,5,3170,8681
9.96e+05,2014,262,3,3.25,3620,8131,2,0,0,4,10,2730,890,1988,1988,98040,47.578,122.21,2040,3776,26,0,6.25,5660,7396
4.9e+05,2014,318,4,2.25,2020,4960,2,0,0,3,7,1710,310,1938,1938,98117,47.687,122.37,1590,4550,76,0,6.25,3610,6570
3.13e+05,2015,369,2,1.5,870,747,2,0,0,3,8,800,70,2004,2004,98103,47.697,122.34,1710,1280,11,0,3.5,2580,2150
1.135e+06,2014,126,4,2.75,3370,8103,1,0,3,3,9,1970,1400,1970,2014,98136,47.523,122.38,2120,6360,44,1,6.75,5490,9730
4.5e+05,2014,300,4,2.25,1710,7000,1,0,0,4,7,1040,670,1972,1972,98034,47.719,122.22,1780,6500,42,0,6.25,3490,8210
4.197e+05,2014,245,3,2.25,1450,1486,2,0,0,3,8,1160,290,2006,2006,98116,47.569,122.39,1370,1437,8,0,5.25,2820,2887
1.9e+05,2015,437,2,1,670,3101,1,0,0,4,6,670,0,1948,1948,98118,47.555,122.27,1660,4100,67,0,3,2330,4770
1.1225e+06,2014,343,4,3.25,4750,62365,2,0,0,3,11,4750,0,1988,1988,98052,47.715,122.1,3300,31866,26,0,7.25,8050,36616
1.6205e+06,2015,368,3,2.5,3490,9362,1,0,3,5,9,1770,1720,1960,1960,98105,47.66,122.27,3640,7425,55,0,5.5,7130,10915
3.1e+05,2014,176,4,2.5,2430,5499,2,0,0,3,8,2430,0,2002,2002,98042,47.378,122.13,2890,5190,12,0,6.5,5320,7620
3.9e+05,2014,304,3,1.5,1650,8676,1,0,0,4,8,1130,520,1979,1979,98133,47.747,122.35,1400,8499,35,0,4.5,3050,10149
3.245e+05,2015,488,2,1,1300,6617,1,0,0,3,7,1300,0,1986,1986,98125,47.724,122.3,1820,7800,29,0,3,3120,9100
2.79e+05,2014,347,4,2,1980,10051,1,0,0,3,7,1980,0,1969,2003,98092,47.323,122.1,1520,10125,45,1,6,3500,12105
1.45e+06,2015,414,3,3.5,4110,15720,1,0,1,3,10,2230,1880,2000,2000,98034,47.7,122.23,2500,15400,15,0,6.5,6610,19510
3.25e+05,2014,273,3,1.5,1270,1067,3,0,0,3,8,1270,0,2009,2009,98133,47.724,122.35,1090,1118,5,0,4.5,2360,2388
1.565e+06,2014,229,4,2.75,2810,8570,2,0,0,3,10,2810,0,1993,1993,98004,47.616,122.21,2810,9621,21,0,6.75,5620,12431
4.8e+05,2014,324,4,2.5,2870,35757,2,0,0,4,9,2870,0,1977,1977,98077,47.757,122.05,2700,41221,37,0,6.5,5570,44091
3.38e+05,2015,393,3,2.5,2470,4948,2,0,0,3,8,2470,0,2003,2003,98038,47.344,122.04,2500,4993,12,0,5.5,4970,7463
2.3e+05,2014,128,3,1,1390,16000,1,0,0,4,6,1390,0,1960,1960,98001,47.29,122.25,1420,10000,54,0,4,2810,11390
4.6e+05,2015,449,2,1,850,4650,1,0,0,3,7,850,0,1975,1975,98117,47.693,122.36,980,4700,40,0,3,1830,5550
3.49e+05,2014,304,3,1.75,1690,5080,1,0,0,3,7,1190,500,1976,1976,98106,47.531,122.35,1300,5080,38,0,4.75,2990,6770
5.13e+05,2015,473,3,1.75,1710,5000,1,0,0,4,7,1110,600,1944,1944,98107,47.669,122.37,920,5000,71,0,4.75,2630,6710
7.15e+05,2014,183,3,4,2080,2250,3,0,4,3,8,2080,0,1997,1997,98103,47.66,122.36,2080,2250,17,0,7,4160,4330
5.25e+05,2014,196,5,2.25,2500,8621,1,0,0,4,7,2500,0,1968,1968,98034,47.738,122.19,1980,7395,46,0,7.25,4480,9895
6.53e+05,2014,155,3,2.5,2680,9750,1,0,0,4,8,1610,1070,1979,1979,98034,47.703,122.23,2480,8750,35,0,5.5,5160,11430
7.9e+05,2014,352,3,1.5,2390,4452,2,0,1,3,9,1790,600,1929,1929,98126,47.583,122.38,2610,5000,85,0,4.5,5000,7390
2.6864e+05,2015,485,4,2.25,1810,9240,2,0,0,3,7,1810,0,1961,1961,98055,47.436,122.19,1660,9240,54,0,6.25,3470,11050
3.5e+05,2015,422,2,1.5,1150,7552,1,0,1,3,7,1150,0,1944,1944,98125,47.73,122.29,1910,8145,71,0,3.5,3060,9295
3.259e+05,2014,128,4,2.5,2320,6270,2,0,0,3,8,2320,0,2004,2004,98042,47.35,122.14,2150,6270,10,0,6.5,4470,8590
2.2e+05,2015,450,4,2,2340,10507,1,0,0,4,6,2340,0,1959,1959,98030,47.358,122.18,990,10507,56,0,6,3330,12847
7.49e+05,2014,142,4,2.5,2930,18199,2,0,0,3,9,2930,0,1998,1998,98075,47.594,122.05,2930,33976,16,0,6.5,5860,36906
4.04e+05,2015,470,3,2.5,2370,4324,2,0,0,3,8,2370,0,2006,2006,98038,47.352,122,2370,4348,9,0,5.5,4740,6718
2.75e+05,2014,195,4,2.25,2670,10050,1,0,0,4,8,1420,1250,1962,1962,98032,47.379,122.28,2190,10050,52,0,6.25,4860,12720
1.83e+05,2014,160,3,1.75,1330,9200,1,0,0,4,7,1330,0,1973,1973,98092,47.292,122.19,1590,9200,41,0,4.75,2920,10530
4.1e+05,2014,324,3,1.75,1530,26642,1,0,0,3,7,1180,350,1988,1988,98072,47.742,122.1,1550,13566,26,0,4.75,3080,15096
2.36e+05,2014,347,3,1.75,1300,8976,1,0,0,3,7,1300,0,1967,1967,98003,47.336,122.31,1430,9750,47,0,4.75,2730,11050
4.6e+05,2014,360,3,1.75,1290,8580,1,0,0,4,7,1290,0,1962,1962,98033,47.671,122.17,1840,8580,52,0,4.75,3130,9870
2.91e+05,2014,231,4,2.5,1860,6325,2,0,0,4,7,1860,0,1991,1991,98038,47.349,122.03,1860,6449,23,0,6.5,3720,8309
7.6e+05,2015,380,4,2.25,2590,12600,2,0,0,3,9,2590,0,1979,1979,98006,47.557,122.16,2620,11050,36,0,6.25,5210,13640
3.9e+05,2014,266,4,2.5,2570,22215,2,0,0,5,7,2570,0,1958,1958,98059,47.483,122.16,2460,6533,56,0,6.5,5030,9103
1.125e+06,2014,294,5,3,3690,10260,1,0,4,4,9,2070,1620,1967,1967,98005,47.592,122.18,3160,14000,47,0,8,6850,17690
1.885e+05,2014,203,2,1.75,1240,2493,1,0,0,4,8,1240,0,1985,1985,98198,47.381,122.32,1270,4966,29,0,3.75,2510,6206
5.15e+05,2015,422,3,1.5,1660,5100,1,0,0,4,7,1210,450,1954,1954,98136,47.535,122.38,1440,5100,61,0,4.5,3100,6760
6e+05,2014,317,6,3,2600,9350,1,0,0,4,8,1340,1260,1963,1963,98008,47.62,122.11,2090,9102,51,0,9,4690,11702
9.375e+05,2015,444,3,1,1320,8500,1,0,0,4,7,1320,0,1954,1954,98039,47.619,122.23,2790,10800,61,0,4,4110,12120
3.785e+05,2014,188,3,2.5,2860,43821,2,0,0,4,9,2860,0,1990,1990,98092,47.316,122.14,2370,65340,24,0,5.5,5230,68200
3.3e+05,2015,460,3,3,2420,13959,1,0,0,4,8,1740,680,1988,1988,98028,47.749,122.23,2570,13300,27,0,6,4990,15720
4.525e+05,2015,402,4,2.5,2460,6454,2,0,0,3,7,2460,0,2006,2006,98065,47.538,121.89,2320,4578,9,0,6.5,4780,7038
5.645e+05,2015,471,4,2.75,3100,14568,2,0,0,3,8,3100,0,1995,1995,98019,47.73,121.97,2860,14396,20,0,6.75,5960,17496
3.48e+05,2015,464,3,1.5,1040,1824,1,0,0,3,6,1040,0,1925,1925,98115,47.679,122.3,1010,5100,90,0,4.5,2050,6140
2.59e+05,2015,416,3,2.5,2740,7980,2,0,0,4,7,2740,0,1964,1964,98168,47.473,122.3,1470,8611,51,0,5.5,4210,11351
6.98e+05,2014,249,3,2.75,2640,11957,1,0,0,3,9,2260,380,1978,1978,98052,47.649,122.12,2640,12641,36,0,5.75,5280,15281
6.27e+05,2014,352,4,2.5,2750,11830,2,0,0,3,9,2750,0,2014,2014,98059,47.47,122.12,2310,11830,0,0,6.5,5060,14580
1.95e+05,2015,485,3,1.5,1200,7800,1,0,0,4,7,1200,0,1958,1958,98002,47.314,122.21,1390,8415,57,0,4.5,2590,9615
3.55e+05,2014,148,2,1,1270,3200,1,0,0,4,7,960,310,1920,1920,98103,47.657,122.35,1410,1320,94,0,3,2680,2590
7.95e+05,2014,257,5,2.5,3040,9570,1,0,2,4,8,1640,1400,1966,1966,98006,47.565,122.16,2920,8800,48,0,7.5,5960,11840
2.65e+05,2014,163,4,1.75,1900,10588,1,0,0,5,6,1900,0,1958,1958,98002,47.289,122.21,1530,10587,56,0,5.75,3430,12487
3.25e+05,2015,453,4,2.5,1830,7762,2,0,0,3,8,1830,0,1993,1993,98003,47.267,122.31,2109,8966,22,0,6.5,3939,10796
5.507e+05,2015,418,2,1,1010,5000,1,0,0,4,6,1010,0,1908,1908,98105,47.669,122.3,1460,5000,107,0,3,2470,6010
1.855e+06,2014,285,5,3.25,5570,9600,2,0,0,5,9,3860,1710,1952,1952,98105,47.671,122.26,3170,10400,62,0,8.25,8740,15970
5.8e+05,2014,230,3,2.5,1740,1236,3,0,2,3,8,1740,0,2008,2008,98116,47.589,122.39,1740,1280,6,0,5.5,3480,3020
1.799e+05,2014,264,3,1.75,1230,12000,1,0,0,3,6,1230,0,1970,1970,98001,47.288,122.25,1550,12000,44,0,4.75,2780,13230
7.14e+05,2015,452,3,1.75,2260,11781,1,0,0,4,8,1520,740,1968,1968,98008,47.598,122.13,2530,10176,47,0,4.75,4790,12436
5.112e+05,2014,285,4,1.75,1480,7875,1,0,0,3,7,740,740,1927,1927,98199,47.643,122.4,1680,5851,87,0,5.75,3160,7331
5.8e+05,2015,463,3,1.75,1850,2797,1,0,0,3,8,1150,700,1977,1977,98103,47.687,122.34,1450,4599,38,0,4.75,3300,6449
5.44e+05,2015,380,4,2.5,2340,6973,2,0,0,3,8,1930,410,2005,2005,98065,47.545,121.88,2950,6908,10,0,6.5,5290,9248
6.35e+05,2015,472,5,2.75,2620,5500,1,0,0,3,7,1710,910,1911,1911,98117,47.681,122.39,1790,5500,104,0,7.75,4410,8120
5.4e+05,2015,372,3,1.75,1630,1404,2,0,0,3,8,1020,610,2014,2014,98107,47.665,122.37,1420,1670,1,0,4.75,3050,3300
3.08e+05,2015,443,4,2.5,1960,5642,2,0,0,3,7,1960,0,1998,1998,98092,47.317,122.19,1870,5250,17,0,6.5,3830,7210
2e+05,2014,156,2,1,1730,9610,1,0,0,3,7,1380,350,1962,1962,98001,47.296,122.28,1310,9812,52,0,3,3040,11542
2.4e+05,2014,311,3,1.75,1380,7500,1,0,0,3,7,1380,0,1988,1988,98038,47.363,122.05,1530,7500,26,0,4.75,2910,8880
5.75e+05,2015,486,3,2.5,1960,9535,2,0,0,3,8,1960,0,1989,1989,98011,47.737,122.22,2520,9206,26,0,5.5,4480,11166
5.5e+05,2014,156,3,1.5,1900,5000,1,0,0,3,7,1640,260,1926,1926,98115,47.678,122.29,2090,5000,88,0,4.5,3990,6900
6.11e+05,2014,338,3,1,1850,5000,1,0,0,3,7,1850,0,1922,1922,98103,47.673,122.35,1850,5000,92,0,4,3700,6850
2.8e+05,2014,154,2,1,960,4920,1,0,0,3,6,960,0,1942,1942,98117,47.695,122.36,1010,5040,72,0,3,1970,6000
7.18e+05,2015,414,4,2.75,2930,4408,1,0,0,5,8,1660,1270,1939,1939,98144,47.584,122.3,2200,4000,76,0,6.75,5130,6930
5.65e+05,2015,432,3,2.25,1540,1005,3,0,0,3,8,1540,0,2008,2008,98103,47.683,122.35,1510,1501,7,0,5.25,3050,3041
6.65e+05,2014,341,3,1,1650,5102,1,0,0,4,8,1300,350,1953,1953,98199,47.652,122.4,1440,5102,61,0,4,3090,6752
5.94e+05,2015,439,4,1.75,2140,8000,1,0,0,4,8,1410,730,1965,1965,98007,47.622,122.14,2080,8000,50,0,5.75,4220,10140
3.65e+05,2014,266,3,2.5,1780,1754,3,0,0,3,8,1780,0,2007,2007,98126,47.548,122.37,1780,1607,7,0,5.5,3560,3387
4.955e+05,2015,445,3,2.5,2010,57934,1,0,0,3,7,2010,0,1978,1978,98014,47.626,121.96,2040,55527,37,0,5.5,4050,57537
2.475e+05,2015,445,3,1,1660,11060,1,0,0,4,7,1110,550,1962,1962,98003,47.331,122.33,1890,11060,53,0,4,3550,12720
3.2e+06,2015,369,3,3.25,4560,13363,1,0,4,3,11,2760,1800,1995,1995,98004,47.62,122.21,4060,13362,20,0,6.25,8620,17922
9e+05,2014,224,4,2.5,3690,11468,2,0,0,3,11,3690,0,1987,1987,98027,47.57,122.09,3370,10751,27,0,6.5,7060,14441
6.05e+05,2014,356,4,2.25,2260,11900,2,0,0,3,9,2260,0,1976,1976,98074,47.642,122.06,2470,11900,38,0,6.25,4730,14160
3.36e+05,2015,392,3,3,1790,13350,1,0,0,3,7,1190,600,1988,1988,98178,47.496,122.26,1740,10624,27,0,6,3530,12414
5.75e+05,2014,194,5,2.5,2990,7500,1,0,2,3,9,1800,1190,1972,1972,98177,47.771,122.37,2800,9860,42,0,7.5,5790,12850
2.1e+05,2014,310,3,1,1040,8125,1,0,0,3,7,1040,0,1956,1956,98003,47.317,122.32,1200,9375,58,0,4,2240,10415
3.75e+05,2014,160,4,2.5,2210,9427,2,0,0,3,7,2210,0,1999,1999,98148,47.432,122.33,1770,8770,15,0,6.5,3980,10980
5.49e+05,2014,236,3,2,1560,5130,1,0,0,5,7,1150,410,1915,1915,98103,47.691,122.33,1560,4500,99,0,5,3120,6060
7.4e+05,2014,347,4,3.5,3060,4777,2,0,0,3,9,3060,0,2007,2007,98029,47.555,122,3060,4935,7,0,7.5,6120,7995
1.98e+06,2014,211,4,4,4360,12081,2,0,0,3,10,4360,0,2007,2007,98004,47.638,122.22,2180,10800,7,0,8,6540,15160
8.8e+05,2014,346,3,1.75,3860,9000,1,0,2,3,9,1930,1930,1970,1970,98155,47.743,122.29,2960,9000,44,0,4.75,6820,12860
4.5325e+05,2014,132,3,2.5,2010,2287,2,0,0,3,8,1390,620,2014,2014,98029,47.552,122,1690,1662,0,0,5.5,3700,3672
5.9e+05,2015,467,4,3.5,3100,15842,2,0,0,3,8,2400,700,1996,1996,98028,47.747,122.24,2200,19400,19,0,7.5,5300,22500
4.8068e+05,2014,264,3,2.5,1730,4924,2,0,0,3,8,1730,0,1996,1996,98029,47.567,122,1610,4313,18,0,5.5,3340,6043
2.44e+05,2014,239,3,1.75,1540,8885,1,0,0,4,7,1440,100,1980,1980,98031,47.403,122.2,1540,12734,34,0,4.75,3080,14274
3.54e+05,2014,198,5,1.75,1830,7986,1,0,0,4,7,1060,770,1962,1962,98106,47.521,122.35,1410,7260,52,0,6.75,3240,9090
3.38e+05,2014,339,3,2.5,1690,1760,2,0,0,3,8,1410,280,2014,2014,98106,47.539,122.37,1740,1760,0,0,5.5,3430,3450
5.22e+05,2014,252,3,1,1150,7080,1,0,0,3,7,1150,0,1952,1952,98125,47.711,122.29,1490,7921,62,0,4,2640,9071
3.125e+05,2014,345,3,3.25,1480,983,2,0,0,3,8,1180,300,2013,2013,98106,47.556,122.36,1330,1062,1,0,6.25,2810,2542
2.25e+05,2014,265,3,1,900,6099,1,0,0,3,6,790,110,1944,1944,98168,47.481,122.29,1240,6099,70,0,4,2140,6999
3.6e+05,2014,205,5,1.75,1550,5225,1,0,0,4,7,1550,0,1941,1941,98108,47.554,122.31,1220,5225,73,0,6.75,2770,6775
4.58e+05,2014,163,3,2,2020,8555,1,0,0,4,7,1220,800,1957,1957,98125,47.728,122.29,1600,8148,57,0,5,3620,10168
8.74e+05,2014,356,4,2.75,2860,6867,1,0,1,5,7,1560,1300,1946,1946,98115,47.672,122.26,2290,5350,68,0,6.75,5150,8210
4.9e+05,2014,237,3,2.25,2550,8588,1,0,4,3,9,2550,0,1989,1989,98011,47.771,122.19,3050,8588,25,0,5.25,5600,11138
1.395e+05,2015,444,2,1.5,1230,1561,2,0,0,3,7,1230,0,1983,1983,98042,47.377,122.15,1660,2243,32,0,3.5,2890,3473
5.3e+05,2015,492,4,2.25,1940,8270,2,0,0,5,7,1940,0,1962,1962,98133,47.757,122.33,1800,7743,53,0,6.25,3740,9683
4.3e+05,2014,148,3,3.75,3890,7140,1,0,2,3,8,2390,1500,1943,2007,98178,47.507,122.24,1820,7320,71,1,6.75,5710,11210
9.6806e+05,2014,229,4,2.5,2620,16200,1,0,2,4,7,1570,1050,1950,1993,98033,47.662,122.2,3050,11875,64,1,6.5,5670,14495
2.75e+05,2015,436,3,1.5,1350,7800,1,0,0,3,7,1350,0,1959,1959,98059,47.48,122.16,1510,8040,56,0,4.5,2860,9390
6.25e+05,2014,189,3,1.75,3160,76230,1,0,0,4,8,2160,1000,1978,1978,98001,47.274,122.29,1990,45789,36,0,4.75,5150,48949
4.475e+05,2014,303,3,1.75,1950,6504,1,0,0,3,8,1530,420,1953,1953,98115,47.693,122.33,1660,6552,61,0,4.75,3610,8502
2.5e+05,2014,135,3,1,1230,10350,1,0,0,4,7,1230,0,1957,1957,98055,47.428,122.2,1510,10427,57,0,4,2740,11657
5.5e+05,2014,188,3,3.5,2490,3582,2,0,0,3,8,1720,770,2005,2005,98027,47.534,122.07,1445,1590,9,0,6.5,3935,4080
2.2e+05,2015,375,3,1,1090,6320,1,0,0,3,6,890,200,1954,1954,98146,47.498,122.35,1460,7080,61,0,4,2550,8170
1.456e+05,2015,451,3,1,1170,7560,1,0,0,3,6,1170,0,1958,1958,98058,47.451,122.18,1170,7560,57,0,4,2340,8730
6.9e+05,2014,127,3,2,1760,6428,1,0,0,4,7,980,780,1942,1942,98199,47.639,122.4,1760,6004,72,0,5,3520,7764
5.75e+05,2015,466,3,2,2500,30056,1,0,0,5,8,1840,660,1954,1954,98166,47.447,122.34,2500,30000,61,0,5,5000,32500
4.41e+05,2015,448,2,1,1150,3000,1,0,0,3,6,780,370,1915,1915,98118,47.562,122.29,1150,5000,100,0,3,2300,6150
1.025e+06,2015,473,3,2.75,2780,4000,2,0,2,5,8,1960,820,1904,1904,98103,47.657,122.36,1490,4800,111,0,5.75,4270,7580
4.1e+05,2014,190,3,1,1470,6500,1,0,0,4,7,1470,0,1953,1953,98166,47.473,122.36,1470,9300,61,0,4,2940,10770
2.67e+05,2015,416,4,1.75,2000,7350,1,0,0,3,7,1100,900,1963,1963,98003,47.343,122.3,1720,7350,52,0,5.75,3720,9350
1.025e+06,2014,277,5,3.5,5050,16500,2,0,2,3,11,5050,0,2001,2001,98075,47.586,121.97,4570,16500,13,0,8.5,9620,21550
2.55e+05,2015,474,2,1.5,1480,9660,1,0,0,3,7,1480,0,1949,1949,98188,47.458,122.29,1990,9660,66,0,3.5,3470,11140
3.3575e+05,2015,413,3,3,2400,7260,1,0,0,3,7,1440,960,1955,1955,98178,47.505,122.25,1060,7200,60,0,6,3460,9600
7.28e+05,2014,286,3,1.5,1940,4000,1,0,0,3,8,1310,630,1915,1915,98112,47.62,122.29,1940,4000,99,0,4.5,3880,5940
3.329e+05,2015,436,3,1.5,1190,11996,1,0,0,4,7,1190,0,1969,1969,98077,47.756,122.07,1190,9756,46,0,4.5,2380,10946
3.8495e+05,2014,150,3,2.5,1860,3690,2,0,0,3,7,1860,0,2000,2000,98028,47.776,122.24,1870,4394,14,0,5.5,3730,6254
5.85e+05,2015,473,3,2.5,2290,5089,2,0,0,3,9,2290,0,2001,2001,98006,47.544,122.17,2290,7984,14,0,5.5,4580,10274
1.008e+06,2014,288,3,2.5,2240,41339,1,0,0,4,9,2240,0,1945,1992,98005,47.648,122.16,2900,45738,69,1,5.5,5140,47978
3.5e+05,2015,491,3,2.5,1640,10424,2,0,0,3,7,1640,0,1988,1988,98019,47.734,121.98,1560,10101,27,0,5.5,3200,11741
1.8e+05,2014,331,3,1,1960,9583,2,0,0,2,5,1960,0,1908,1908,98056,47.505,122.17,1850,8324,106,0,4,3810,10284
4.4995e+05,2014,155,3,2.5,2170,4912,2,0,0,3,7,2170,0,2003,2003,98028,47.777,122.24,2010,4395,11,0,5.5,4180,6565
4.6e+05,2014,341,2,1.75,1390,4160,1,0,0,5,6,790,600,1916,1916,98105,47.668,122.32,1090,4160,98,0,3.75,2480,5550
3e+05,2014,310,5,1.75,2110,8500,1,0,0,3,7,1100,1010,1962,1962,98133,47.774,122.35,2020,8500,52,0,6.75,4130,10610
2.795e+05,2014,202,3,1.5,1200,8040,1,0,0,4,7,1200,0,1959,1959,98146,47.49,122.34,1450,9315,55,0,4.5,2650,10515
4.172e+05,2015,409,2,1,1000,4000,1,0,0,3,6,1000,0,1910,1910,98107,47.674,122.4,1490,5000,105,0,3,2490,6000
6.2e+05,2014,297,4,2.5,1900,9775,1,0,0,5,7,1900,0,1967,1967,98033,47.686,122.17,1990,10500,47,0,6.5,3890,12400
3.366e+05,2015,425,3,2.25,1654,8464,2,0,0,3,7,1654,0,1995,1995,98038,47.362,122.03,1975,8515,20,0,5.25,3629,10169
8.5e+05,2014,203,4,1,2500,35802,1,0,0,3,7,2500,0,1955,1955,98005,47.649,122.15,2880,40510,59,0,5,5380,43010
3.5e+05,2015,480,4,1,1510,7200,1,0,0,4,7,1510,0,1955,1955,98155,47.761,122.31,1950,10656,60,0,5,3460,12166
6.25e+05,2014,228,2,1.5,1490,5750,1,0,0,4,7,1190,300,1900,1900,98116,47.587,122.39,1590,4025,114,0,3.5,3080,5515
4.15e+05,2015,432,4,2.5,2400,7292,1,0,0,3,8,1530,870,1980,1980,98133,47.775,122.34,1710,7909,35,0,6.5,4110,10309
1.97e+05,2014,126,3,1.75,1690,7735,1,0,0,4,7,1060,630,1976,1976,98001,47.332,122.28,1580,7503,38,0,4.75,3270,9193
3.45e+05,2015,471,2,1.5,830,920,2,0,0,3,7,830,0,2005,2005,98144,47.6,122.31,830,1200,10,0,3.5,1660,2030
3.165e+05,2015,425,3,2.5,1770,3873,2,0,0,3,7,1770,0,2005,2005,98058,47.465,122.14,2280,4330,10,0,5.5,4050,6100
4.549e+05,2015,416,3,1.75,2130,9775,1,0,0,4,8,1430,700,1973,1973,98027,47.533,122.05,2130,11250,42,0,4.75,4260,13380
1.238e+06,2014,205,4,3.5,4670,6000,2,0,3,3,11,3820,850,2007,2007,98027,47.541,121.99,4310,6000,7,0,7.5,8980,10670
1.18e+06,2014,228,4,3,2570,4000,2,0,0,3,8,1750,820,1909,2014,98115,47.674,122.31,1970,4000,105,1,7,4540,6570
4.97e+05,2014,198,3,2.25,1870,9315,1,0,0,3,7,1350,520,1975,1975,98034,47.705,122.2,2230,9579,39,0,5.25,4100,11449
5.48e+05,2015,478,5,1.5,1700,7200,1,0,0,3,7,1700,0,1937,1937,98011,47.761,122.2,1460,7194,78,0,6.5,3160,8894
4.23e+05,2014,140,4,1.75,1940,6909,1,0,0,4,7,970,970,1941,1941,98133,47.711,122.35,1460,6906,73,0,5.75,3400,8846
4.05e+05,2015,453,4,2.5,2620,9359,2,0,0,3,9,2620,0,1987,1987,98058,47.438,122.15,2580,7433,28,0,6.5,5200,10053
7.15e+05,2015,479,5,3,3490,6091,2,0,0,3,9,3490,0,2009,2009,98011,47.774,122.22,2870,5932,6,0,8,6360,9422
4e+05,2014,352,3,1,1300,14138,1,0,0,4,7,1300,0,1943,1943,98005,47.593,122.17,2440,12196,71,0,4,3740,13496
3.17e+05,2015,435,3,1,1270,8925,1,0,0,5,7,1270,0,1955,1955,98056,47.512,122.17,1270,8996,60,0,4,2540,10266
1.94e+05,2014,285,3,1,1180,6050,1,0,0,3,6,820,360,1944,1944,98178,47.495,122.25,1070,6050,70,0,4,2250,7230
1.975e+05,2014,135,3,1,980,3090,1,0,0,3,6,980,0,1903,1903,98118,47.553,122.28,980,3090,111,0,4,1960,4070
3.85e+05,2014,173,4,2.75,2700,37011,2,0,0,3,9,2700,0,1984,1984,98042,47.35,122.09,2700,37457,30,0,6.75,5400,40157
2.7e+05,2015,414,4,1.5,1730,8505,1,0,0,4,7,1730,0,1961,1961,98146,47.49,122.35,1510,8505,54,0,5.5,3240,10235
8.2e+05,2015,430,5,2.5,3160,8000,1,0,0,4,7,1580,1580,1960,1960,98040,47.574,122.21,2440,8079,55,0,7.5,5600,11239
1.57e+05,2015,431,3,1,1080,6250,1,0,0,2,5,1080,0,1950,1950,98168,47.505,122.33,1070,6250,65,0,4,2150,7330
4.28e+05,2014,272,3,1.75,2120,9350,1,0,0,3,7,1280,840,1979,1979,98072,47.756,122.14,2200,9000,35,0,4.75,4320,11120
2.175e+05,2015,432,3,1,1040,9750,1,0,0,3,7,1040,0,1959,1959,98188,47.455,122.27,1510,11100,56,0,4,2550,12140
4.35e+05,2015,453,2,1,750,2786,1,0,0,5,7,750,0,1947,1947,98117,47.689,122.39,1700,4653,68,0,3,2450,5403
5.6445e+05,2015,452,3,2.5,2710,6174,2,0,0,3,9,2710,0,1998,1998,98056,47.512,122.17,2730,7266,17,0,5.5,5440,9976
5.25e+05,2015,436,3,1.75,1330,8136,1,0,0,4,7,1330,0,1977,1977,98033,47.7,122.17,1330,8136,38,0,4.75,2660,9466
7.65e+05,2015,367,3,3.25,3190,5283,2,0,0,3,9,3190,0,2007,2007,98029,47.553,122,2950,5198,8,0,6.25,6140,8388
4.25e+05,2015,471,5,2,2500,7804,1,0,0,3,7,1570,930,1921,1921,98146,47.503,122.35,1170,7676,94,0,7,3670,10176
5.083e+05,2015,439,3,1,1160,5969,1,0,0,3,7,880,280,1930,1930,98115,47.684,122.31,1550,5120,85,0,4,2710,6280
4.5e+05,2014,181,3,1.75,1400,13775,1,0,0,3,8,1400,0,1963,1963,98028,47.741,122.26,2200,10450,51,0,4.75,3600,11850
5.63e+05,2015,472,3,2,1380,5000,1,0,0,4,7,1380,0,1917,1917,98117,47.681,122.37,1350,5000,98,0,5,2730,6380
1.4e+06,2014,341,5,3.75,3700,7920,3,0,4,3,9,2900,800,1983,1983,98115,47.687,122.27,2860,6360,31,0,8.75,6560,10060
5.775e+05,2015,483,2,1,1640,5515,1,0,0,4,7,940,700,1926,1926,98103,47.691,122.33,2054,5515,89,0,3,3694,7155
5.695e+05,2014,210,4,2.5,2340,8248,2,0,0,3,8,2340,0,1989,1989,98074,47.631,122.03,2140,9963,25,0,6.5,4480,12303
4.65e+05,2014,312,3,3.25,1510,1850,2,0,2,3,8,1230,280,2001,2001,98107,47.668,122.36,1540,1840,13,0,6.25,3050,3350
2.25e+06,2014,205,3,4.25,5150,7800,2,0,2,3,11,4170,980,1954,1954,98112,47.629,122.28,4270,7800,60,0,7.25,9420,12950
5.25e+05,2015,444,3,1,1640,6180,1,0,0,4,7,1640,0,1946,1946,98118,47.568,122.28,1540,6180,69,0,4,3180,7820
4.14e+05,2014,197,5,3,3045,5030,2,0,0,3,8,3045,0,1999,1999,98058,47.439,122.13,3045,5322,15,0,8,6090,8367
3.5e+05,2014,298,4,2.25,2390,13002,2,0,0,3,8,2390,0,1987,1987,98023,47.311,122.35,2450,11200,27,0,6.25,4840,13590
9.6e+05,2015,450,3,2.5,1730,4102,3,1,4,3,8,1730,0,1996,1996,98074,47.645,122.08,2340,16994,19,0,5.5,4070,18724
4.29e+05,2014,166,5,2.5,2340,4500,2,0,0,3,7,2340,0,2009,2009,98059,47.491,122.15,2190,4500,5,0,7.5,4530,6840
3.25e+05,2014,304,3,1,1160,9525,1,0,0,4,7,1160,0,1968,1968,98077,47.743,122.07,1160,10640,46,0,4,2320,11800
4.6e+05,2015,488,3,3,1520,7500,1,0,0,3,7,1180,340,1967,1967,98034,47.728,122.18,2080,8000,48,0,6,3600,9520
1.29e+06,2015,392,5,4,4360,8030,2,0,0,3,10,4360,0,2015,2015,98075,47.592,121.97,3570,6185,0,0,9,7930,10545
2.1075e+05,2015,451,4,1.5,1840,7076,1,0,0,3,7,1840,0,1957,1957,98106,47.519,122.34,1510,7320,58,0,5.5,3350,9160
6.55e+05,2014,278,4,2.5,2570,4412,2,0,0,3,9,2570,0,2001,2001,98034,47.708,122.23,2460,5470,13,0,6.5,5030,8040
4.15e+05,2014,125,3,2.25,1620,998,2,0,0,3,8,1540,80,2010,2010,98027,47.54,122.03,1620,1299,4,0,5.25,3240,2919
5.24e+05,2014,125,3,1.75,1560,5520,1,0,0,4,6,780,780,1944,1944,98199,47.651,122.4,1470,6000,70,0,4.75,3030,7560
6.0985e+05,2014,360,2,2.75,1910,1369,3,0,0,3,9,1910,0,2002,2002,98119,47.654,122.37,1910,1879,12,0,4.75,3820,3789
1.175e+06,2014,293,4,3.5,4150,49503,2,0,0,3,11,4150,0,2003,2003,98053,47.675,122.02,3330,60137,11,0,7.5,7480,64287
5.15e+05,2014,353,5,1.75,1880,48787,2,0,0,3,6,1880,0,1922,1922,98059,47.509,122.17,1690,8401,92,0,6.75,3570,10281
2.05e+05,2015,471,3,1,1300,9880,1,0,0,4,7,1300,0,1959,1959,98003,47.335,122.3,2140,9600,56,0,4,3440,10900
9.8999e+05,2014,286,4,3.5,3830,7150,2,0,0,3,9,3830,0,2014,2014,98052,47.705,122.13,3640,6055,0,0,7.5,7470,9885
2.4e+06,2014,154,5,3.25,3410,9088,2,0,3,3,9,2760,650,1912,1912,98119,47.629,122.36,3540,7100,102,0,8.25,6950,10510
5.45e+05,2014,156,4,2.5,2040,6034,2,0,0,3,7,2040,0,1990,1990,98115,47.695,122.32,1380,5986,24,0,6.5,3420,8026
3.99e+05,2014,325,2,1,700,3400,1,0,0,3,6,700,0,1946,1946,98112,47.621,122.3,1570,4512,68,0,3,2270,5212
9.35e+05,2015,382,5,3,2700,5001,2,0,0,3,10,2700,0,2009,2009,98115,47.681,122.29,1610,5191,6,0,8,4310,7891
3.3e+05,2014,163,3,2.5,1070,1155,2,0,0,3,7,720,350,2005,2005,98102,47.562,122.39,1120,2594,9,0,5.5,2190,3664
4.4e+05,2015,393,3,2.5,2160,3738,2,0,0,3,8,2160,0,1994,1994,98126,47.566,122.38,1500,4000,21,0,5.5,3660,6160
3e+05,2014,187,4,3,2200,10800,1,0,0,3,6,2200,0,1960,1960,98058,47.448,122.17,1430,10800,54,0,7,3630,13000
4.67e+05,2015,491,3,1,1220,8040,1,0,0,3,7,1220,0,1965,1965,98125,47.713,122.31,1360,8040,50,0,4,2580,9260
4.62e+05,2014,305,3,2.75,1890,2614,2,0,0,4,9,1890,0,1979,1979,98008,47.61,122.11,1800,2769,35,0,5.75,3690,4659
4.0995e+05,2014,242,4,3,2430,7163,2,0,0,3,8,2430,0,2003,2003,98038,47.356,122.01,2430,6028,11,0,7,4860,8458
4.36e+05,2014,339,3,2.25,1770,8000,1,0,0,4,7,1350,420,1976,1976,98072,47.736,122.17,1850,7875,38,0,5.25,3620,9645
4.05e+05,2015,459,4,2.5,2670,20894,2,0,0,3,9,2330,340,2002,2002,98155,47.773,122.28,2440,15815,13,0,6.5,5110,18485
4.1e+05,2014,177,3,1,2710,19000,2,0,3,4,7,2710,0,1950,1950,98166,47.446,122.36,2150,19000,64,0,4,4860,21710
3.78e+05,2014,166,5,2.5,2760,8015,1,0,0,4,8,1600,1160,1960,1960,98125,47.725,122.3,460,18000,54,0,7.5,3220,20760
2.445e+05,2014,280,2,1,910,9000,1,0,0,3,5,910,0,1923,1923,98065,47.526,121.81,1290,9000,91,0,3,2200,9910
3.3349e+05,2014,188,4,2.5,2250,3916,2,0,0,3,8,2250,0,2014,2014,98003,47.341,122.18,2156,3920,0,0,6.5,4406,6170
7.15e+05,2015,417,4,3.25,2630,7770,2,0,0,3,9,2630,0,2014,2014,98126,47.546,122.38,1370,7770,1,0,7.25,4000,10400
4.11e+05,2014,152,4,2.75,2150,9915,1,0,0,5,8,1240,910,1976,1976,98056,47.538,122.17,1980,9325,38,0,6.75,4130,11475
4.65e+05,2015,459,3,2.5,2050,15035,2,0,0,3,9,2050,0,2006,2006,98042,47.362,122.12,1300,15836,9,0,5.5,3350,17886
3.5e+05,2015,413,3,1,1080,7000,1,0,0,4,6,1080,0,1916,1916,98133,47.764,122.35,1410,7214,99,0,4,2490,8294
2.5e+05,2014,215,3,1,990,8100,1,0,0,3,6,990,0,1949,1949,98146,47.484,122.34,1210,8100,65,0,4,2200,9090
4.125e+05,2014,211,3,1.75,1530,6300,1,0,0,3,6,1530,0,1942,2004,98126,47.516,122.38,920,6300,72,1,4.75,2450,7830
4.05e+05,2014,147,3,1.75,1980,8100,1,0,0,4,7,1310,670,1949,1949,98133,47.735,122.33,1450,8212,65,0,4.75,3430,10192
5.75e+05,2014,244,5,1.75,2980,53578,1,0,0,4,9,2230,750,1976,1976,98027,47.491,122.06,2860,75546,38,0,6.75,5840,78526
4.7e+05,2014,266,3,2.75,2770,54707,1,0,0,3,8,2370,400,1938,1938,98155,47.755,122.29,1640,54707,76,0,5.75,4410,57477
7.47e+05,2015,484,2,1,990,4000,1,0,0,4,7,990,0,1911,1911,98103,47.659,122.34,1560,4000,104,0,3,2550,4990
1.5e+06,2015,439,5,3.25,2590,11500,1,0,2,4,9,2590,0,1968,1968,98040,47.545,122.23,2780,11989,47,0,8.25,5370,14579
2.9648e+05,2014,187,3,2.5,1520,4170,2,0,0,3,7,1520,0,2004,2004,98038,47.384,122.04,1560,4237,10,0,5.5,3080,5757
2.17e+05,2014,211,3,1,1000,12000,1,0,0,3,7,1000,0,1959,1959,98023,47.332,122.35,1490,14940,55,0,4,2490,15940
2.95e+05,2014,135,3,1.5,850,2500,1,0,0,3,7,850,0,1986,1986,98106,47.568,122.36,850,5000,28,0,4.5,1700,5850
2.08e+05,2015,393,3,1,1020,6120,1,0,0,4,7,1020,0,1967,1967,98002,47.278,122.2,1370,8000,48,0,4,2390,9020
4.28e+05,2015,408,4,2,1300,7200,1,0,0,3,7,1300,0,1958,1958,98122,47.617,122.29,1540,6600,57,0,6,2840,7900
7.08e+05,2015,479,2,1,1120,5250,1,0,0,3,7,950,170,1938,1938,98199,47.65,122.39,1510,5250,77,0,3,2630,6370
3.39e+05,2014,139,4,2.5,1830,8601,2,0,0,3,7,1830,0,2003,2003,98038,47.358,122.02,1830,5184,11,0,6.5,3660,7014
2.25e+05,2014,223,4,1,1150,6000,1,0,0,3,6,1150,0,1907,1907,98118,47.562,122.28,840,3030,107,0,5,1990,4180
3.82e+05,2014,196,3,1.75,1790,7679,1,0,0,4,7,1790,0,1953,1953,98133,47.744,122.34,1560,7680,61,0,4.75,3350,9470
3.98e+05,2014,204,4,2.5,2050,14724,2,0,0,3,7,2050,0,1989,1989,98019,47.73,121.97,1920,12841,25,0,6.5,3970,14891
2.1e+05,2014,313,3,1.75,1260,6223,1,0,0,3,7,820,440,1983,1983,98042,47.357,122.16,1260,6553,31,0,4.75,2520,7813
3.4495e+05,2014,263,4,1.75,2240,7500,1,0,0,4,7,1120,1120,1956,1956,98133,47.747,122.34,1440,7500,58,0,5.75,3680,9740
2.3e+05,2015,452,5,2,1210,12538,2,0,0,3,7,1210,0,1982,1982,98023,47.285,122.36,1510,7700,33,0,7,2720,8910
7.53e+05,2014,339,4,2.5,3060,8167,2,0,0,3,9,3060,0,2005,2005,98029,47.552,121.99,2930,4800,9,0,6.5,5990,7860
2.56e+05,2015,362,3,2.5,1570,5113,1,0,0,3,7,1090,480,1996,1996,98001,47.333,122.29,1570,5150,19,0,5.5,3140,6720
3.8e+05,2014,170,3,1.5,1520,4288,1,0,0,3,7,1020,500,1949,1949,98136,47.528,122.39,1660,4288,65,0,4.5,3180,5808
2.655e+05,2014,314,3,1,1860,9225,1,0,0,3,7,1860,0,1957,1957,98198,47.39,122.3,1740,12204,57,0,4,3600,14064
8.95e+05,2015,422,4,1.5,3390,6200,2,0,0,4,8,2530,860,1916,1916,98144,47.58,122.29,3080,6000,99,0,5.5,6470,9390
6.75e+05,2014,173,4,2.5,2810,11120,2,0,0,3,9,2810,0,1982,1982,98074,47.634,122.04,3100,12672,32,0,6.5,5910,15482
3.9e+05,2014,338,3,1.5,1000,13991,1,0,0,4,7,1000,0,1956,1956,98006,47.564,122.14,1520,11465,58,0,4.5,2520,12465
2.26e+06,2015,399,3,3.5,3110,14872,1,0,0,3,10,3110,0,2003,2003,98004,47.618,122.21,3110,12433,12,0,6.5,6220,15543
3.9e+05,2015,431,3,2.5,2480,53250,2,0,0,3,9,2480,0,1990,1990,98042,47.332,122.08,2510,36549,25,0,5.5,4990,39029
9.075e+05,2014,154,4,2.5,2770,8642,2,0,0,4,9,2770,0,1987,1987,98007,47.66,122.15,2670,9000,27,0,6.5,5440,11770
3.125e+05,2015,381,3,1.75,1490,9493,1,0,0,4,8,1490,0,1976,1976,98058,47.451,122.13,2440,9600,39,0,4.75,3930,11090
5.5575e+05,2015,406,3,1,1060,4880,1,0,0,2,6,910,150,1913,1913,98118,47.554,122.29,1200,4880,102,0,4,2260,5940
3.8e+05,2015,461,3,3.25,2090,51212,1,0,0,3,8,1510,580,1989,1989,98092,47.31,122.1,2690,40820,26,0,6.25,4780,42910
4.753e+05,2014,149,3,1,2110,10005,1,0,0,5,7,1110,1000,1924,1924,98033,47.688,122.17,1360,9827,90,0,4,3470,11937
6.05e+05,2014,183,4,2.5,2800,10786,1,0,0,3,8,1420,1380,1970,1970,98008,47.596,122.12,2140,10788,44,0,6.5,4940,13588
4.1e+05,2014,236,3,2,1740,9300,1,0,0,4,7,1740,0,1952,1952,98166,47.453,122.36,1540,9638,62,0,5,3280,11378
5.65e+05,2014,341,3,2.25,2560,8040,1,0,0,3,8,1510,1050,1958,1958,98125,47.712,122.3,1980,8040,56,0,5.25,4540,10600
3.05e+05,2015,427,3,1,910,8008,1,0,0,3,7,910,0,1971,1971,98034,47.726,122.22,1480,7404,44,0,4,2390,8314
4.3e+05,2015,362,3,2.5,1950,4949,2,0,0,3,7,1950,0,2009,2009,98065,47.516,121.87,2200,5740,6,0,5.5,4150,7690
7.8e+05,2014,191,3,3.5,3190,6776,2,0,0,3,10,3190,0,1998,1998,98074,47.635,122.06,3230,7189,16,0,6.5,6420,10379
2.72e+05,2014,215,3,1.5,1380,11760,1,0,0,4,7,1380,0,1963,1963,98055,47.424,122.2,1650,9855,51,0,4.5,3030,11235
6.5e+05,2014,183,3,1.5,1380,4500,1,0,0,5,7,1380,0,1960,1960,98040,47.587,122.25,1590,9000,54,0,4.5,2970,10380
2.5e+05,2015,374,3,1,1040,8000,1,0,0,4,7,1040,0,1956,1956,98166,47.471,122.35,1170,9450,59,0,4,2210,10490
2.6e+05,2014,175,5,2.5,2025,7760,2,0,0,3,7,2025,0,2007,2007,98001,47.267,122.26,1664,9000,7,0,7.5,3689,11025
7e+05,2014,189,3,1,1410,7200,2,0,0,4,6,1410,0,1901,1901,98144,47.592,122.3,1640,7200,113,0,4,3050,8610
2.55e+05,2014,202,4,2.75,1760,9222,1,0,0,3,7,1140,620,1971,1971,98023,47.31,122.36,1800,9222,43,0,6.75,3560,10982
2.94e+05,2015,452,3,1,1250,9427,1,0,0,3,6,1250,0,1931,1931,98034,47.725,122.17,1590,8250,84,0,4,2840,9500
4.598e+05,2014,318,3,2,1690,16061,1,0,0,3,7,1690,0,1984,1984,98074,47.636,122.03,1280,12436,30,0,5,2970,14126
2.75e+05,2014,307,4,1.5,1610,6923,1,0,0,3,6,1010,600,1969,1969,98198,47.375,122.31,1320,7684,45,0,5.5,2930,9294
4.3e+05,2014,341,4,2.25,2020,4840,1,0,0,5,8,1200,820,1925,1925,98126,47.558,122.38,1410,4840,89,0,6.25,3430,6860
5.8e+05,2015,367,5,2,2600,3750,1,0,0,4,6,1400,1200,1914,1914,98105,47.669,122.3,1700,3750,101,0,7,4300,6350
4.9e+05,2014,195,4,2.25,2800,10800,1,0,0,3,8,1680,1120,1977,1977,98011,47.745,122.18,2260,9800,37,0,6.25,5060,12600
5.63e+05,2014,181,4,1,1410,3376,1,0,0,5,7,1410,0,1911,1911,98107,47.661,122.36,1040,3600,103,0,5,2450,5010
2.75e+05,2015,388,4,2.5,2120,6754,2,0,0,3,7,2120,0,1998,1998,98030,47.363,122.18,2120,6937,17,0,6.5,4240,9057
2.95e+05,2014,317,4,2,1810,42981,1,0,0,4,7,1810,0,1973,1973,98024,47.56,121.85,1980,1.1369e+05,41,0,6,3790,1.155e+05
9e+05,2014,290,4,2,1190,8190,1,0,0,3,7,1190,0,1945,1945,98117,47.691,122.4,1190,1567,69,0,6,2380,2757
1.285e+06,2014,210,4,3.5,4080,14450,2,0,2,3,12,3210,870,1998,1998,98006,47.552,122.11,4080,12114,16,0,7.5,8160,16194
6.35e+05,2014,306,4,2.5,2410,7069,2,0,0,3,9,2410,0,1993,1993,98034,47.709,122.23,2240,7184,21,0,6.5,4650,9594
7.18e+05,2015,470,5,2.75,3250,8100,2,0,0,3,8,3250,0,2014,2014,98125,47.713,122.31,1270,8100,1,0,7.75,4520,11350
5.25e+05,2014,280,4,1.75,1820,6600,1,0,0,5,7,1820,0,1960,1960,98007,47.606,122.14,1430,8800,54,0,5.75,3250,10620
4.58e+05,2014,292,3,2.25,2150,9900,1,0,0,3,8,1450,700,1977,1977,98052,47.665,122.15,2170,9500,37,0,5.25,4320,11650
3.75e+05,2015,452,3,2.5,2340,10005,1,0,0,4,8,1460,880,1978,1978,98058,47.443,122.13,2250,8162,37,0,5.5,4590,10502
5.1e+05,2014,181,3,1.75,1750,7020,2,0,0,3,7,1750,0,1934,1978,98010,47.326,122.04,1170,9546,80,1,4.75,2920,11296
2.659e+05,2014,183,3,2,1180,7793,1,0,0,4,7,1180,0,1992,1992,98031,47.405,122.18,1720,7793,22,0,5,2900,8973
4.85e+05,2014,215,3,1.75,2590,8384,1,0,0,4,8,1590,1000,1971,1971,98011,47.774,122.2,2590,8800,43,0,4.75,5180,11390
7.55e+05,2015,477,2,2.5,2170,6361,1,0,2,3,8,2170,0,2009,2009,98053,47.711,122.02,2310,7419,6,0,4.5,4480,9589
9.05e+05,2015,451,3,2.5,3450,48787,2,0,0,3,10,3450,0,1987,1987,98072,47.739,122.13,2810,41040,28,0,5.5,6260,44490
4.65e+05,2014,340,5,1.5,1830,9000,1,0,2,3,7,1030,800,1955,1955,98155,47.749,122.29,2610,11175,59,0,6.5,4440,13005
2.6e+05,2014,181,2,1,770,7906,1,0,0,4,6,770,0,1948,1948,98155,47.766,122.32,990,7906,66,0,3,1760,8676
4.35e+05,2014,156,2,1,1260,4080,1,0,0,5,7,1260,0,1926,1926,98115,47.687,122.32,1720,4080,88,0,3,2980,5340
4.71e+05,2015,464,4,2.5,2040,21781,2,0,0,3,8,2040,0,1994,1994,98014,47.646,121.9,2410,21781,21,0,6.5,4450,23821
2.35e+05,2014,236,2,1,820,5100,1,0,0,4,6,820,0,1954,1954,98056,47.517,122.2,2270,5100,60,0,3,3090,5920
3.67e+05,2015,417,4,1,1820,5500,1,0,0,3,6,1820,0,1947,1947,98106,47.519,122.36,1140,5500,68,0,5,2960,7320
5.19e+05,2014,154,2,1,830,2820,1,0,0,4,7,830,0,1920,1920,98103,47.689,122.35,1460,3150,94,0,3,2290,3980
2.99e+05,2014,325,4,2.5,1820,7575,1,0,0,3,7,1220,600,1975,1975,98058,47.434,122.17,1840,7650,39,0,6.5,3660,9470
3.9e+05,2015,412,4,2.5,2610,7227,2,0,0,3,9,2610,0,2011,2011,98010,47.314,122.02,2630,7421,4,0,6.5,5240,10031
1.525e+05,2014,356,4,1,1730,7350,1,0,0,4,6,1730,0,1970,1970,98003,47.347,122.31,1440,7752,44,0,5,3170,9482
2.16e+05,2014,287,3,2,1260,4125,1,0,0,3,6,1260,0,1998,1998,98188,47.44,122.28,1300,9091,16,0,5,2560,10351
6.1e+05,2014,183,3,2,2300,13418,1,0,0,3,8,1430,870,1955,1955,98004,47.608,122.2,2140,9380,59,0,5,4440,11680
2.9995e+05,2014,155,4,1.75,1560,31299,1,0,0,4,7,1560,0,1965,1965,98092,47.338,122.16,2460,44907,49,0,5.75,4020,46467
5.2e+05,2014,182,3,1.75,1490,1036,2,0,0,3,10,1090,400,2008,2008,98199,47.659,122.4,1460,1206,6,0,4.75,2950,2696
1.655e+06,2015,485,4,2.25,3530,5500,2,0,0,3,8,2860,670,1940,1940,98105,47.662,122.27,2840,5500,75,0,6.25,6370,9030
5.125e+05,2014,305,3,3,2260,2400,2,0,0,3,7,2260,0,1909,1972,98122,47.609,122.31,1320,2790,105,1,6,3580,5050
3.8e+05,2014,256,4,1.75,1790,10186,1,0,0,4,8,1790,0,1965,1965,98177,47.777,122.38,1790,9142,49,0,5.75,3580,10932
3.9e+05,2014,194,3,2.25,1640,2875,2,0,0,3,6,1240,400,1983,1983,98118,47.569,122.29,1500,3960,31,0,5.25,3140,5600
9.7e+05,2014,188,5,2.75,3500,5040,2,0,2,3,9,2950,550,1927,2007,98126,47.553,122.38,1450,5040,87,1,7.75,4950,8540
2.1495e+05,2015,480,3,1.75,1290,8688,1,0,0,4,7,1290,0,1980,1980,98042,47.365,122.08,1750,9090,35,0,4.75,3040,10380
2.4695e+05,2014,299,3,3.5,1790,1682,2,0,0,3,7,1480,310,2006,2006,98108,47.542,122.32,1150,4000,8,0,6.5,2940,5790
7.05e+05,2014,243,4,3,3150,9318,2,0,0,3,9,3150,0,2001,2001,98075,47.596,122.02,3150,9318,13,0,7,6300,12468
3.04e+05,2014,273,3,1.75,1720,6000,1,0,2,3,7,1000,720,1954,1954,98178,47.5,122.22,1690,6000,60,0,4.75,3410,7720
4.5e+05,2014,255,2,2,1510,4908,1,0,0,3,8,1510,0,2006,2006,98053,47.72,122.02,1440,3921,8,0,4,2950,5431
3.6e+05,2014,132,4,2,1730,5500,1,0,0,5,7,1010,720,1943,1943,98106,47.53,122.35,1080,4900,71,0,6,2810,6630
1.45e+06,2014,283,3,3,4380,6320,2,0,3,5,10,3580,800,1952,1952,98199,47.645,122.41,3080,7680,62,0,6,7460,12060
7.68e+05,2014,214,3,2.5,2660,10928,2,0,0,3,9,1830,830,1988,1988,98006,47.544,122.14,2800,10025,26,0,5.5,5460,12685
5.75e+05,2014,261,5,2.5,2760,4000,1,0,0,3,8,1730,1030,1926,2014,98122,47.607,122.3,1680,4000,88,1,7.5,4440,6760
7.75e+05,2014,217,4,3.5,3390,3960,2,0,0,3,10,3390,0,2008,2008,98027,47.541,122,2990,3400,6,0,7.5,6380,6790
2.7669e+05,2014,299,4,1,1190,8875,1,0,0,4,7,1190,0,1946,1946,98155,47.749,122.3,1190,8875,68,0,5,2380,10065
5.4e+05,2014,141,3,2,1470,1691,2,0,0,3,8,1000,470,2007,2007,98115,47.674,122.32,1660,4000,7,0,5,3130,5470
4.25e+05,2015,409,3,1.75,2120,5992,1,0,0,3,7,1060,1060,1947,1947,98125,47.708,122.31,1840,11000,68,0,4.75,3960,13120
5.5e+05,2014,205,3,1,1120,6600,1,0,0,3,7,1120,0,1943,1943,98105,47.671,122.27,1300,6600,71,0,4,2420,7720
1.8695e+05,2014,148,2,2,1390,1302,2,0,0,3,7,1390,0,1986,1986,98003,47.309,122.33,1390,1302,28,0,4,2780,2692
5.7e+05,2014,191,4,2,1790,7800,1,0,0,5,8,1790,0,1972,1972,98008,47.627,122.1,2150,7838,42,0,6,3940,9628
4.42e+05,2014,291,2,1,990,4313,1,0,2,4,6,990,0,1917,1917,98126,47.568,122.38,1480,5750,97,0,3,2470,6740
9.75e+05,2014,224,6,3,3420,22421,1,0,0,5,9,2270,1150,1948,1948,98006,47.551,122.19,2430,15560,66,0,9,5850,18980
4.299e+05,2015,410,4,3.25,2880,5929,2,0,0,3,8,2880,0,2014,2014,98023,47.275,122.35,2880,5846,1,0,7.25,5760,8726
4.87e+05,2015,458,3,2,2590,14052,1,0,0,5,8,1720,870,1948,1948,98133,47.736,122.33,1570,8162,67,0,5,4160,10752
6.56e+05,2014,197,3,1.75,1480,7475,1,0,0,3,8,1480,0,1943,1943,98115,47.673,122.27,2120,7216,71,0,4.75,3600,8696
1.755e+06,2014,183,3,2,2360,4800,2,0,0,3,9,2360,0,1909,2014,98112,47.632,122.31,2260,4800,105,1,5,4620,7160
6e+05,2014,251,5,3.5,3150,10542,1,0,0,5,9,1620,1530,1974,1974,98011,47.747,122.22,3150,11807,40,0,8.5,6300,14957
3.15e+05,2014,214,3,1.75,1970,8200,1,0,0,3,7,1270,700,1964,1964,98168,47.473,122.33,1890,8348,50,0,4.75,3860,10318
6.4e+05,2014,230,3,1.5,1960,4080,1,0,0,3,7,1960,0,1915,1915,98115,47.677,122.31,1880,4080,99,0,4.5,3840,6040
2.804e+05,2015,473,4,1.75,1730,7210,1,0,0,4,7,1010,720,1968,1968,98003,47.354,122.31,1620,7210,47,0,5.75,3350,8940
1.05e+06,2014,176,4,3.5,3450,7832,2,0,0,3,10,3450,0,2007,2007,98006,47.564,122.12,3220,8567,7,0,7.5,6670,12017
7.5e+05,2014,177,4,2.25,3190,11597,2,0,0,3,10,2300,890,1984,1984,98074,47.632,122.04,2990,10679,30,0,6.25,6180,13869
9.2e+05,2014,236,4,2.75,3140,7258,2,0,1,3,10,3140,0,2006,2006,98034,47.706,122.23,2990,13600,8,0,6.75,6130,16740
3.89e+05,2014,298,4,2.5,2420,9147,2,0,0,3,10,2420,0,1998,1998,98003,47.322,122.32,1400,7200,16,0,6.5,3820,9620
1.85e+05,2014,244,1,1,720,5000,1,0,0,4,6,720,0,1908,1908,98118,47.529,122.27,1170,5000,106,0,2,1890,5720
4.38e+05,2014,335,5,2.5,1990,6840,2,0,0,4,7,1990,0,1974,1974,98034,47.716,122.17,1990,7150,40,0,7.5,3980,9140
6.2e+05,2015,458,3,2.25,1990,6256,1,0,0,3,7,1390,600,1960,1960,98033,47.69,122.21,2080,9300,55,0,5.25,4070,11290
3.55e+05,2015,379,4,2.25,2200,3404,2,0,0,3,8,2200,0,2005,2005,98038,47.389,122.03,2200,3449,10,0,6.25,4400,5649
2.21e+05,2014,169,3,2.25,1640,7350,1,0,0,3,7,1140,500,1984,1984,98003,47.263,122.3,1480,8041,30,0,5.25,3120,9681
4.7495e+05,2014,301,3,3,1530,1568,3,0,0,3,8,1530,0,2012,2012,98117,47.7,122.37,1460,1224,2,0,6,2990,2754
5.39e+05,2014,156,3,2,2260,9568,1,0,0,3,8,1780,480,1985,1985,98074,47.646,122.06,2250,9744,29,0,5,4510,12004
2.466e+05,2015,461,4,1,1340,8400,1,0,0,5,7,1340,0,1966,1966,98023,47.331,122.34,1120,8400,49,0,5,2460,9740
4.15e+05,2014,319,3,1,1630,8146,1,0,0,3,7,1630,0,1952,1952,98125,47.729,122.29,1480,8146,62,0,4,3110,9776
1.95e+05,2015,426,3,1.5,1430,7560,1,0,0,5,6,1430,0,1958,1958,98058,47.452,122.18,1150,7560,57,0,4.5,2580,8990
3e+05,2014,187,4,2.5,2090,5195,2,0,0,3,7,2090,0,2007,2007,98031,47.399,122.17,2090,5236,7,0,6.5,4180,7326
1.065e+06,2014,189,4,3.75,4260,9800,2,0,0,3,10,4260,0,2008,2008,98033,47.674,122.17,1950,8970,6,0,7.75,6210,13230
7.7e+05,2014,168,3,2.25,2910,10204,2,0,0,3,9,2910,0,1990,1990,98052,47.69,122.1,2700,13992,24,0,5.25,5610,16902
2.775e+05,2015,392,3,2.5,1690,5171,2,0,0,3,8,1690,0,2003,2003,98023,47.278,122.35,2550,5025,12,0,5.5,4240,6715
4.4595e+05,2014,249,3,1.75,1300,7800,1,0,0,5,7,1300,0,1968,1968,98034,47.732,122.19,1520,7344,46,0,4.75,2820,8644
3.965e+05,2014,174,3,2.5,2590,18980,1,0,0,4,10,2590,0,1976,1976,98042,47.384,122.15,3110,14652,38,0,5.5,5700,17242
1.65e+06,2014,211,4,2.75,3190,14904,1,0,3,4,9,1940,1250,1949,1992,98004,47.618,122.21,2600,11195,65,1,6.75,5790,14385
7.8e+05,2014,346,4,2.5,3090,12511,2,0,0,4,10,3090,0,1998,1998,98075,47.593,121.98,3100,10882,16,0,6.5,6190,13972
1.9e+05,2014,287,3,1,1260,10900,1,0,0,4,6,1260,0,1943,1943,98056,47.491,122.19,1090,8137,71,0,4,2350,9397
7.4995e+05,2014,139,4,2.5,3430,64441,2,0,0,3,8,3430,0,2013,2013,98077,47.769,122.06,3580,64441,1,0,6.5,7010,67871
3.499e+05,2015,438,4,2.5,2290,8796,2,0,0,3,8,2290,0,1994,1994,98198,47.376,122.32,2130,8796,21,0,6.5,4420,11086
5.35e+05,2014,244,3,1,1330,40259,1,0,0,4,7,1330,0,1977,1977,98024,47.552,121.89,1710,34787,37,0,4,3040,36117
8.3e+05,2015,474,5,3.5,2880,3750,2,0,2,3,8,2270,610,2001,2001,98144,47.59,122.29,2060,4000,14,0,8.5,4940,6880
1e+06,2015,425,4,3.5,3180,12528,2,0,1,4,9,2060,1120,1979,1979,98177,47.706,122.38,2850,11410,36,0,7.5,6030,14590
2.29e+05,2015,479,1,1,600,3720,1,0,0,3,6,600,0,1920,1920,98106,47.556,122.36,1480,4800,95,0,2,2080,5400
2.7e+05,2014,224,4,1.75,1850,7730,1,0,0,5,7,1100,750,1956,1956,98133,47.748,122.36,2260,8581,58,0,5.75,4110,10431
6.84e+05,2014,306,4,3.5,3040,8414,2,0,0,3,9,2420,620,2010,2010,98059,47.522,122.16,3470,8066,4,0,7.5,6510,11106
3.7e+05,2014,215,4,2.5,2190,17600,1,0,0,4,7,1110,1080,1966,1966,98059,47.471,122.11,1820,17600,48,0,6.5,4010,19790
3.125e+05,2014,135,2,1,880,6345,1,0,0,3,7,880,0,1919,1919,98106,47.534,122.36,1440,6345,95,0,3,2320,7225
4.52e+05,2014,251,3,2.75,2300,5090,2,0,0,3,8,1700,600,2007,2007,98106,47.545,122.36,1530,9100,7,0,5.75,3830,11400
7.0301e+05,2014,271,2,1,1370,5922,1,0,2,3,8,1130,240,1941,1941,98199,47.647,122.41,2460,6759,73,0,3,3830,8129
3.5e+05,2014,293,2,1,830,5100,1,0,0,4,7,830,0,1942,1942,98126,47.526,122.38,1220,5100,72,0,3,2050,5930
4.662e+05,2015,400,3,1.5,1340,8856,1,0,0,4,7,1340,0,1959,1959,98008,47.609,122.13,1850,8740,56,0,4.5,3190,10080
3.73e+05,2014,310,3,1,1290,8974,1,0,0,5,7,1290,0,1976,1976,98072,47.74,122.17,1540,7500,38,0,4,2830,8790
2.5e+05,2014,232,3,1,1640,26127,2,0,0,3,6,1640,0,1975,1975,98019,47.766,121.91,1620,25788,39,0,4,3260,27428
2.1e+05,2014,149,3,1.75,1590,7617,2,0,0,3,7,1590,0,1986,1986,98198,47.382,122.31,1490,7450,28,0,4.75,3080,9040
2.5e+05,2015,432,4,1,1320,11212,1,0,0,5,6,1320,0,1914,1914,98002,47.31,122.21,1060,6766,101,0,5,2380,8086
5.15e+05,2014,319,3,1.75,1810,5733,1,0,0,4,7,1010,800,1926,1926,98116,47.571,122.39,1260,4680,88,0,4.75,3070,6490
2.49e+05,2014,136,3,2.25,1440,7673,1,0,0,3,7,940,500,1982,1982,98031,47.403,122.18,1440,8418,32,0,5.25,2880,9858
3.34e+05,2015,488,4,1.5,1680,7620,1,0,0,4,7,1180,500,1965,1965,98166,47.458,122.35,1460,7620,50,0,5.5,3140,9300
5.955e+05,2015,436,4,2.5,2490,6537,2,0,0,3,8,2490,0,2013,2013,98065,47.519,121.88,2520,5848,2,0,6.5,5010,8338
8.4e+05,2014,148,4,2.5,3420,8405,2,0,0,3,10,3420,0,2000,2000,98074,47.633,122.06,3230,8460,14,0,6.5,6650,11880
4.66e+05,2014,332,4,2.25,2170,8050,1,0,0,3,7,1220,950,1976,1976,98072,47.735,122.17,1820,7700,38,0,6.25,3990,9870
2.695e+05,2014,339,4,2.25,1700,7056,2,0,0,3,7,1700,0,1999,1999,98001,47.339,122.26,1650,6025,15,0,6.25,3350,7725
84000,2015,480,2,1,700,20130,1,0,0,3,6,700,0,1949,1949,98168,47.475,122.27,1490,18630,66,0,3,2190,19330
8.3722e+05,2014,156,5,2.75,3030,7679,2,0,0,3,9,3030,0,2014,2014,98074,47.593,122.06,3080,6341,0,0,7.75,6110,9371
4.55e+05,2014,156,4,2.25,1740,8449,1,0,0,4,7,1170,570,1958,1958,98008,47.608,122.12,1980,11175,56,0,6.25,3720,12915
5.96e+05,2015,380,2,1,1040,4880,1,0,0,3,7,1040,0,1910,1975,98115,47.681,122.31,1500,4590,105,1,3,2540,5630
6.39e+05,2014,198,4,2.5,2500,8540,2,0,0,3,9,2500,0,1990,1990,98029,47.576,121.99,2560,8475,24,0,6.5,5060,10975
3.5e+05,2015,464,4,2.5,2530,10155,2,0,0,3,8,2530,0,1998,1998,98042,47.351,122.15,2330,7205,17,0,6.5,4860,9735
2.8e+05,2015,477,3,2.5,1020,2217,2,0,0,3,7,720,300,2004,2004,98106,47.534,122.35,1060,1524,11,0,5.5,2080,2544
6e+05,2015,480,2,2,1270,5000,1,0,0,3,6,1270,0,1944,1944,98107,47.673,122.36,2190,5000,71,0,4,3460,6270
2.2e+05,2014,317,3,1,1000,6020,1,0,0,3,6,1000,0,1944,1944,98166,47.479,122.35,1300,8640,70,0,4,2300,9640
7e+05,2014,201,4,2.5,2440,7491,2,0,0,4,10,2440,0,1988,1988,98029,47.561,122.02,2490,8580,26,0,6.5,4930,11020
3.05e+05,2015,451,4,2.5,1620,4000,2,0,0,3,7,1620,0,2008,2008,98038,47.366,122.02,1580,3780,7,0,6.5,3200,5400
2.788e+05,2015,400,4,2.5,2440,7797,1,0,0,3,8,1560,880,1965,1965,98031,47.389,122.22,2090,8100,50,0,6.5,4530,10540
4.36e+05,2014,352,3,2.5,1150,1193,2,0,0,3,8,1020,130,2006,2006,98107,47.668,122.36,1450,1640,8,0,5.5,2600,2790
5.5e+05,2015,438,6,4.5,4520,40164,2,0,0,3,9,3580,940,1953,2008,98031,47.407,122.22,2870,13068,62,1,10.5,7390,17588
3.75e+05,2014,257,4,1.5,1770,6650,1,0,0,3,7,1770,0,1958,1958,98008,47.601,122.12,1600,7000,56,0,5.5,3370,8770
6.3e+05,2015,466,4,2.5,2330,31705,2,0,0,4,8,2330,0,1980,1980,98052,47.647,122.03,2460,36600,35,0,6.5,4790,38930
4.5225e+05,2014,256,4,2.25,2550,10000,1,0,0,4,7,1560,990,1979,1979,98028,47.77,122.26,2440,10000,35,0,6.25,4990,12550
2.75e+05,2014,356,3,2,1340,9764,1,0,0,3,7,1340,0,1944,1944,98052,47.679,122.16,1310,9764,70,0,5,2650,11104
3e+05,2015,437,3,2.5,1741,5701,2,0,0,3,8,1741,0,2012,2012,98030,47.379,122.18,2002,5700,3,0,5.5,3743,7441
2.2e+05,2015,438,3,1.5,1280,7742,1,0,0,4,7,1280,0,1962,1962,98031,47.395,122.2,1450,8316,53,0,4.5,2730,9596
6.9e+05,2014,214,4,3.75,3210,7054,2,0,0,4,8,3210,0,1985,1985,98052,47.727,122.1,2350,8020,29,0,7.75,5560,11230
4.15e+05,2015,410,3,1,1360,73616,1,0,0,3,7,1360,0,1971,1971,98072,47.753,122.12,2040,50965,44,0,4,3400,52325
2.47e+05,2014,139,3,2.25,1580,7941,2,0,0,4,7,1580,0,1986,1986,98023,47.284,122.36,1730,8051,28,0,5.25,3310,9631
1.275e+06,2014,140,4,2,2850,7861,1,0,4,4,10,1450,1400,1970,1970,98117,47.7,122.4,2810,8087,44,0,6,5660,10937
1e+06,2015,457,3,1.75,2610,6360,2,0,2,3,8,2130,480,1924,1924,98109,47.629,122.35,3010,6000,91,0,4.75,5620,8610
2.65e+05,2014,342,3,2.25,1630,10969,2,0,0,3,7,1630,0,1991,1991,98001,47.331,122.28,1410,7920,23,0,5.25,3040,9550
1.16e+06,2015,409,5,1.75,2870,9680,1,0,4,5,9,1440,1430,1966,1966,98008,47.612,122.11,2940,9729,49,0,6.75,5810,12599
4.6e+05,2014,342,4,2.5,4190,7504,2,0,0,3,7,4190,0,2004,2004,98058,47.439,122.11,2480,6727,10,0,6.5,6670,10917
4.9e+05,2014,150,3,1.75,1920,5405,1,0,2,4,7,960,960,1947,1947,98126,47.558,122.38,1190,5405,67,0,4.75,3110,7325
1.6013e+05,2014,356,3,1.5,1190,10116,1,0,0,3,7,1190,0,1968,1968,98042,47.385,122.08,1190,9905,46,0,4.5,2380,11095
6.575e+05,2014,161,4,2.75,4140,24190,2,0,0,3,11,4140,0,2002,2002,98092,47.306,122.15,3950,24190,12,0,6.75,8090,28330
4.025e+05,2014,293,4,1,1270,3630,1,0,0,3,7,1270,0,1903,1903,98122,47.614,122.31,1420,4848,111,0,5,2690,6118
6.51e+05,2014,133,4,2.5,2740,7140,2,0,0,3,8,2740,0,1993,1993,98074,47.633,122.02,2260,7035,21,0,6.5,5000,9775
2.1e+05,2014,287,3,1,1700,11390,1,0,0,4,7,1700,0,1967,1967,98003,47.327,122.32,1350,8164,47,0,4,3050,9864
4.38e+05,2015,429,3,1.75,1780,9660,1,0,0,3,7,1780,0,1962,1962,98034,47.717,122.19,1200,9660,53,0,4.75,2980,11440
3.89e+05,2015,491,3,2,2080,12972,1,0,0,4,7,1250,830,1981,1981,98070,47.373,122.43,1530,10089,34,0,5,3610,12169
5.24e+05,2014,198,4,2.75,2310,5000,1,0,0,5,8,1480,830,1908,1908,98118,47.55,122.27,1100,5000,106,0,6.75,3410,7310
4.2225e+05,2015,460,2,1.5,1280,1256,2,0,0,3,8,1200,80,1998,1998,98107,47.674,122.38,1390,1256,17,0,3.5,2670,2536
6.7e+05,2015,492,3,1.5,1220,4080,1,0,0,5,7,1220,0,1914,1914,98144,47.575,122.29,1320,4080,101,0,4.5,2540,5300
7.25e+05,2014,174,4,2.5,2650,18295,2,0,0,3,8,2650,0,1986,1986,98005,47.608,122.15,2230,19856,28,0,6.5,4880,22506
2.95e+05,2014,166,3,1.75,1770,8235,1,0,0,3,7,1030,740,1960,1960,98148,47.432,122.33,1560,8918,54,0,4.75,3330,10688
5e+05,2014,256,4,1.5,1330,5750,1,0,2,3,7,1330,0,1915,1915,98116,47.568,122.38,1360,5750,99,0,5.5,2690,7080
6.725e+05,2015,465,4,2.5,2650,11108,2,0,0,3,10,2650,0,1987,1987,98074,47.63,122.05,2650,11585,28,0,6.5,5300,14235
8.85e+05,2015,477,3,2.5,2880,11443,2,0,0,4,9,2880,0,1986,1986,98006,47.563,122.11,2840,12530,29,0,5.5,5720,15410
2.76e+05,2014,353,3,1.5,1820,8750,1,0,0,4,7,1200,620,1958,1958,98198,47.421,122.32,1500,8000,56,0,4.5,3320,9820
2.25e+05,2014,237,4,1,1410,7000,1,0,0,3,7,1410,0,1963,1963,98032,47.377,122.29,1540,7000,51,0,5,2950,8410
8.95e+05,2014,252,4,2.75,2640,4000,2,0,0,5,8,1730,910,1925,1925,98115,47.673,122.3,1530,3740,89,0,6.75,4170,6380
5.5e+05,2014,159,4,2.5,2700,5100,1,0,0,4,8,1440,1260,1968,1968,98136,47.533,122.38,1880,5100,46,0,6.5,4580,7800
3.53e+05,2014,250,4,2.5,2210,13721,2,0,0,3,8,2210,0,2009,2009,98042,47.312,122.04,1850,12951,5,0,6.5,4060,15161
4.1e+05,2015,450,4,2,2010,9474,2,0,0,3,7,2010,0,1953,2003,98166,47.423,122.34,2140,10164,62,1,6,4150,12174
7.6e+05,2014,285,4,1.75,2770,8521,1,0,0,4,7,1470,1300,1953,1953,98004,47.626,122.2,1910,9380,61,0,5.75,4680,12150
1.93e+05,2014,153,3,1.5,1180,9048,1,0,0,3,7,1180,0,1960,1960,98148,47.433,122.33,1460,8942,54,0,4.5,2640,10122
2.85e+05,2014,286,3,1.5,1780,12231,1,0,0,4,8,1780,0,1956,1956,98003,47.335,122.32,2460,12663,58,0,4.5,4240,14443
4.3e+05,2014,346,4,2.5,2010,16020,1,0,0,5,8,2010,0,1962,1962,98059,47.482,122.11,1420,16020,52,0,6.5,3430,18030
3.7e+05,2014,332,3,2.75,1250,1655,2,0,0,3,7,830,420,2006,2006,98136,47.555,122.38,1520,3001,8,0,5.75,2770,4251
5.7e+05,2015,485,3,2.5,1910,4941,2,0,0,3,8,1910,0,1999,1999,98075,47.599,122.02,1910,4941,16,0,5.5,3820,6851
3e+05,2014,181,4,2.5,2303,3826,2,0,0,3,8,2303,0,2006,2006,98092,47.326,122.17,2516,4500,8,0,6.5,4819,6803
7.5995e+05,2014,166,3,2.5,3100,23790,2,0,0,3,9,3100,0,2002,2002,98075,47.588,122.01,2250,40854,12,0,5.5,5350,43954
2.606e+05,2014,214,2,1,810,4560,1,0,0,3,7,810,0,1928,1928,98126,47.542,122.38,1490,4560,86,0,3,2300,5370
3.12e+05,2014,228,2,1,1170,5150,1,0,0,3,6,980,190,1907,1907,98118,47.55,122.28,1660,5150,107,0,3,2830,6320
2.92e+06,2014,191,4,4.75,4575,24085,2,0,2,5,10,3905,670,1926,1926,98112,47.626,122.28,3900,9687,88,0,8.75,8475,14262
2.48e+05,2015,374,3,2.5,1870,4046,2,0,0,3,7,1870,0,2007,2007,98042,47.342,122.06,2130,4800,8,0,5.5,4000,6670
4.4e+05,2014,197,3,2,1550,2401,2,0,0,3,7,1550,0,1996,1996,98103,47.654,122.35,1550,3446,18,0,5,3100,4996
3.4629e+05,2014,209,4,2.75,2690,9240,2,0,0,3,8,2690,0,1998,1998,98022,47.19,122.01,2640,9240,16,0,6.75,5330,11930
3.76e+05,2014,312,3,2.25,1470,9140,2,0,2,3,7,1470,0,1982,1982,98133,47.716,122.35,1400,8204,32,0,5.25,2870,9674
6.38e+05,2015,472,4,1.75,1470,4236,1,0,0,4,7,1470,0,1946,1946,98107,47.669,122.4,1480,5400,69,0,5.75,2950,6870
2.3e+05,2014,293,3,2,1160,1174,2,0,0,3,7,790,370,2007,2007,98106,47.523,122.36,1160,994,7,0,5,2320,2154
2.49e+05,2014,348,3,2.5,1850,7200,1,0,0,3,7,1500,350,1979,1979,98023,47.306,122.38,2140,7500,35,0,5.5,3990,9350
8.909e+05,2014,205,4,2.5,3420,6233,2,0,0,3,9,3420,0,2006,2006,98027,47.542,122,3350,5000,8,0,6.5,6770,8420
3.3e+05,2014,235,4,2.5,2510,8580,2,0,0,4,8,2510,0,1991,2012,98023,47.295,122.37,2290,7809,23,1,6.5,4800,10319
3.75e+05,2014,204,3,2.75,1890,3930,2,0,0,3,8,1890,0,1999,1999,98065,47.534,121.87,2100,4259,15,0,5.75,3990,6149
2.12e+05,2015,485,1,1,620,7620,1,0,0,3,6,620,0,1926,1926,98166,47.47,122.35,1160,7620,89,0,2,1780,8240
1.06e+06,2014,360,3,2.75,2700,22343,1,0,1,4,10,2700,0,1977,1977,98040,47.571,122.21,3390,15682,37,0,5.75,6090,18382
5.39e+05,2015,424,3,2.25,1540,5338,1,0,0,5,7,770,770,1954,1954,98115,47.694,122.3,1680,6525,61,0,5.25,3220,8065
5.2e+05,2014,196,3,2.25,1850,10855,1,0,0,3,8,1370,480,1985,1985,98029,47.57,122.02,1850,8209,29,0,5.25,3700,10059
4.39e+05,2014,342,3,2.25,1830,13477,1,0,3,4,7,1170,660,1981,1981,98034,47.724,122.21,1960,11344,33,0,5.25,3790,13174
4.9e+05,2015,466,3,1,1600,6380,1,0,0,3,7,1400,200,1939,1939,98125,47.702,122.32,1760,6380,76,0,4,3360,7980
3.58e+05,2014,314,4,2,2200,3060,1,0,0,3,7,1100,1100,1908,2000,98118,47.565,122.28,1410,5100,106,1,6,3610,7300
1e+06,2014,235,5,3,3350,9450,2,0,0,5,8,2180,1170,1912,1980,98103,47.67,122.34,2660,4500,102,1,8,6010,7850
9.72e+05,2014,334,4,3.25,4010,13797,2,0,0,3,11,4010,0,2003,2003,98059,47.523,122.15,3980,12120,11,0,7.25,7990,16130
2.45e+05,2015,472,3,2.25,1700,8100,1,0,0,3,7,1200,500,1980,1980,98038,47.36,122.05,1700,8100,35,0,5.25,3400,9800
2.2995e+05,2014,348,4,1.5,1570,6717,1,0,0,5,6,1570,0,1911,1911,98002,47.307,122.22,1140,6716,103,0,5.5,2710,8286
3.25e+05,2015,365,3,2,1260,5612,1,0,0,4,7,1260,0,1972,1972,98034,47.736,122.18,1640,4745,43,0,5,2900,6005
4.27e+05,2014,147,2,1,920,3780,1,0,0,3,6,920,0,1910,1910,98103,47.658,122.35,1570,2640,104,0,3,2490,3560
4.75e+05,2015,479,3,1.75,1340,2805,1,0,0,3,7,1340,0,1919,1919,98144,47.592,122.3,1650,2805,96,0,4.75,2990,4145
5.55e+05,2014,176,5,3,3640,6930,2,0,0,3,8,3640,0,2004,2004,98038,47.352,122.01,3740,7182,10,0,8,7380,10822
2.03e+05,2014,306,2,1,1080,9067,1,0,0,3,6,1080,0,1951,1951,98168,47.481,122.33,1080,6647,63,0,3,2160,7727
4.2495e+05,2015,392,2,1.5,1000,1188,3,0,0,3,8,1000,0,2005,2005,98115,47.682,122.33,2300,3500,10,0,3.5,3300,4500
4.23e+05,2014,135,4,1.75,1880,7303,1,0,0,3,7,1010,870,1976,1976,98034,47.713,122.2,1710,7200,38,0,5.75,3590,9080
1.195e+06,2015,368,4,4,4050,9517,2,0,0,3,11,3360,690,1990,1990,98040,47.577,122.22,3330,9436,25,0,8,7380,13486
4.76e+05,2015,394,4,1.75,2340,17541,1,0,0,4,7,1360,980,1956,1956,98028,47.745,122.23,2250,9212,59,0,5.75,4590,11552
3.7e+05,2014,148,3,1,800,2296,1,0,0,4,6,800,0,1908,1908,98103,47.655,122.36,1480,1472,106,0,4,2280,2272
4.95e+05,2014,225,4,3,2740,2811,2,0,0,3,8,2240,500,2003,2003,98072,47.774,122.16,2740,3596,11,0,7,5480,6336
3.849e+05,2014,125,5,2.5,3090,12750,1,0,0,3,8,1750,1340,1968,1968,98023,47.341,122.33,1760,25919,46,0,7.5,4850,29009
5.595e+05,2015,459,4,1.75,1650,7088,1,0,0,3,8,1650,0,1973,1973,98027,47.569,122.09,1850,7523,42,0,5.75,3500,9173
5.4e+05,2014,215,3,2.5,1380,1021,2,0,0,3,8,1160,220,2008,2008,98122,47.615,122.31,1440,1021,6,0,5.5,2820,2401
6.17e+05,2014,280,3,2.5,1880,5500,2,0,0,4,7,1880,0,1947,2007,98199,47.657,122.39,1230,5500,67,1,5.5,3110,7380
1.05e+06,2015,477,4,3.25,2930,25020,2,0,0,3,9,2930,0,2013,2013,98029,47.551,122.02,2400,32374,2,0,7.25,5330,35304
2.48e+05,2014,180,3,1,950,9400,1,0,0,4,7,950,0,1954,1954,98006,47.575,122.14,1260,9400,60,0,4,2210,10350
5.85e+05,2014,162,3,2.5,1910,1501,2,0,0,3,8,1530,380,2007,2007,98199,47.644,122.39,1760,1750,7,0,5.5,3670,3660
2.85e+05,2014,153,3,1.75,2880,18296,1,0,0,3,8,1580,1300,1958,1958,98168,47.488,122.28,1380,9592,56,0,4.75,4260,12472
4.53e+05,2014,235,3,2,1430,9583,1,0,0,4,7,1430,0,1964,1964,98034,47.721,122.2,1890,11100,50,0,5,3320,12530
8.5e+05,2015,484,3,1,2280,4600,1,0,2,3,8,1250,1030,1936,1936,98119,47.638,122.37,1910,4000,79,0,4,4190,6280
3.47e+05,2014,173,3,1,1270,8400,1,0,0,3,7,1270,0,1955,1955,98011,47.76,122.2,1390,8400,59,0,4,2660,9670
5.25e+05,2015,437,3,1.5,1940,5625,1,0,0,4,7,1440,500,1941,1941,98117,47.682,122.39,1460,5500,74,0,4.5,3400,7440
3.89e+05,2014,278,3,1,1380,6591,1,0,0,4,7,1380,0,1947,1947,98133,47.716,122.35,1610,6594,67,0,4,2990,7974
8.64e+05,2014,195,4,1.75,2260,6600,1,0,0,5,8,1220,1040,1948,1948,98115,47.675,122.28,2240,6600,66,0,5.75,4500,8860
5.838e+05,2014,208,3,2.5,2480,6600,2,0,0,3,8,2480,0,2002,2002,98053,47.631,122.01,2310,6656,12,0,5.5,4790,9136
4.77e+05,2014,242,3,1,960,3600,1,0,0,4,7,960,0,1906,1906,98117,47.676,122.37,1580,5000,108,0,4,2540,5960
6.17e+05,2014,263,3,2.5,1910,4488,2,0,0,3,8,1910,0,1998,1998,98007,47.618,122.14,1530,3696,16,0,5.5,3440,5606
4.9e+05,2014,280,3,2.5,3080,7363,2,0,0,3,9,3080,0,2006,2006,98055,47.447,122.2,2860,5273,8,0,5.5,5940,8353
5e+05,2014,237,4,2,2100,12620,1,0,0,4,7,2100,0,1972,1972,98034,47.724,122.17,1720,7840,42,0,6,3820,9940
3.25e+05,2014,283,2,1,990,15120,1,0,0,4,6,990,0,1953,1953,98011,47.767,122.21,1300,11500,61,0,3,2290,12490
2.5e+05,2014,208,3,2.5,1530,2890,2,0,0,3,7,1530,0,2001,2001,98108,47.543,122.29,1540,2890,13,0,5.5,3070,4420
6.08e+05,2015,443,3,3.5,1660,2298,2,0,0,3,8,1260,400,2009,2009,98116,47.581,122.4,1500,2198,6,0,6.5,3160,3858
3.35e+05,2015,480,3,1.75,1260,17000,1,0,0,3,7,1260,0,1994,1994,98146,47.511,122.36,1540,7213,21,0,4.75,2800,8473
1.62e+06,2014,236,4,3.25,3820,8114,2,0,0,3,10,3820,0,2005,2005,98004,47.584,122.19,2440,9195,9,0,7.25,6260,13015
4.8e+05,2014,318,3,2.5,2360,9005,1,0,0,5,7,1340,1020,1929,1929,98133,47.708,122.34,1520,9005,85,0,5.5,3880,11365
1.334e+05,2014,250,3,1,900,2550,1,0,0,4,6,900,0,1978,1978,98023,47.304,122.36,1120,2550,36,0,4,2020,3450
1.29e+05,2014,163,2,1,1150,30184,1,0,0,3,6,1150,0,1950,1950,98055,47.449,122.2,1670,19684,64,0,3,2820,20834
5.48e+05,2014,239,2,2,1370,1878,3,0,0,3,8,1370,0,2004,2004,98107,47.672,122.39,1280,1878,10,0,4,2650,3248
2.19e+05,2014,280,2,1,1050,9000,1,0,0,4,7,1050,0,1984,1984,98003,47.289,122.3,1550,9600,30,0,3,2600,10650
2.85e+05,2014,353,4,2.25,1960,10400,1,0,0,4,8,1220,740,1985,1985,98023,47.32,122.39,1650,8660,29,0,6.25,3610,10620
8.15e+05,2015,368,3,2,2310,6000,2,0,1,4,9,1560,750,1926,1926,98199,47.648,122.39,2000,6000,89,0,5,4310,8310
5.88e+05,2014,139,3,2.25,2030,7350,1,0,0,4,7,1190,840,1977,1977,98052,47.694,122.13,1950,7350,37,0,5.25,3980,9380
3.9e+05,2014,255,4,1,1280,4840,1,0,0,3,7,940,340,1950,1950,98136,47.548,122.39,1360,4840,64,0,5,2640,6120
3.37e+05,2015,387,3,2.5,2235,43560,1,0,0,5,7,990,1245,1975,1975,98010,47.333,122.05,1460,29621,40,0,5.5,3695,31856
1.003e+06,2014,248,4,2.5,2230,3600,2,0,0,5,8,1630,600,1906,1906,98112,47.63,122.31,2410,4800,108,0,6.5,4640,7030
2.05e+05,2014,188,3,1,1180,8240,1,0,0,4,7,1180,0,1967,1967,98003,47.333,122.32,1180,7840,47,0,4,2360,9020
3.15e+05,2014,324,4,1.75,1850,8580,1,0,0,3,7,1140,710,1960,1960,98178,47.488,122.24,2210,9240,54,0,5.75,4060,11090
1.125e+06,2014,311,5,1.75,1910,5640,2,0,0,4,9,1910,0,1906,1906,98112,47.625,122.31,2050,5400,108,0,6.75,3960,7310
6.98e+05,2014,198,4,2.5,2990,7231,2,0,0,3,9,2990,0,2001,2001,98075,47.562,122.03,3160,8339,13,0,6.5,6150,11329
3.5e+05,2015,431,4,3,1780,4228,1,0,0,3,7,1780,0,1953,1953,98118,47.549,122.29,1730,5304,62,0,7,3510,7084
4.4e+05,2014,122,2,1,800,4850,1,0,0,4,7,800,0,1944,1944,98107,47.664,122.36,1150,4365,70,0,3,1950,5165
4.8e+05,2014,260,3,2.5,2410,4656,2,0,0,3,7,2410,0,2009,2009,98065,47.52,121.87,2410,4840,5,0,5.5,4820,7250
2.04e+05,2015,417,3,1.5,1460,7140,1,0,0,4,7,980,480,1980,1980,98031,47.395,122.19,1400,8572,35,0,4.5,2860,10032
6.99e+05,2014,162,4,2.5,3280,27441,2,0,0,3,9,3280,0,1996,1996,98053,47.671,122.01,3200,26960,18,0,6.5,6480,30240
4.4257e+05,2014,223,3,1.75,1780,7567,1,0,0,3,7,1290,490,1980,1980,98034,47.731,122.22,1910,8645,34,0,4.75,3690,10425
5.45e+05,2015,445,4,2.5,2755,11612,2,0,0,3,8,2755,0,2001,2001,98019,47.739,121.97,2820,12831,14,0,6.5,5575,15586
3.95e+05,2014,155,3,1.75,1460,22651,1,0,0,4,7,1460,0,1961,1961,98027,47.486,122.03,2030,49222,53,0,4.75,3490,50682
6.45e+05,2015,480,3,1.75,1840,4255,1,0,0,3,7,940,900,1907,2005,98116,47.58,122.39,1600,4255,108,1,4.75,3440,6095
1.81e+05,2015,416,2,1.5,720,5120,1,0,0,3,6,720,0,1954,1954,98106,47.522,122.36,1150,2566,61,0,3.5,1870,3286
4.3319e+05,2015,473,3,2.5,1650,2787,2,0,0,3,8,1650,0,2014,2014,98065,47.534,121.84,1760,2787,1,0,5.5,3410,4437
3.155e+05,2014,270,3,1,1160,10500,1,0,0,4,7,1160,0,1966,1966,98034,47.727,122.23,1520,10500,48,0,4,2680,11660
5.39e+05,2014,346,3,2,2070,9195,1,0,0,3,8,1220,850,1982,1982,98074,47.649,122.06,2080,9551,32,0,5,4150,11621
3.72e+05,2014,195,4,1.75,1890,10550,1,0,0,5,7,1010,880,1969,1969,98056,47.515,122.19,1930,7291,45,0,5.75,3820,9181
3.95e+05,2014,312,2,1.5,1010,3060,1,0,0,4,7,1010,0,1918,1918,98103,47.69,122.35,1160,4080,96,0,3.5,2170,5090
2.01e+05,2014,278,3,1,980,9682,1,0,0,3,7,980,0,1969,1969,98031,47.414,122.21,1580,9682,45,0,4,2560,10662
5.48e+05,2014,181,4,2.5,2440,11005,2,0,0,3,9,2440,0,1994,1994,98056,47.532,122.18,2590,14754,20,0,6.5,5030,17194
7.96e+05,2014,249,4,3.25,2110,3000,2,0,0,3,8,2110,0,2001,2001,98115,47.677,122.33,1780,4000,13,0,7.25,3890,6110
3.99e+05,2014,318,3,2.5,1430,1250,3,0,0,3,7,1430,0,2007,2007,98103,47.69,122.34,1360,1269,7,0,5.5,2790,2699
3.19e+05,2014,321,4,2.25,2380,7400,1,0,0,4,8,1760,620,1979,1979,98042,47.355,122.15,1940,7400,35,0,6.25,4320,9780
4.9995e+05,2014,243,3,1.5,1360,11250,1,0,0,4,7,1360,0,1955,1955,98006,47.57,122.18,1440,11250,59,0,4.5,2800,12610
1.1875e+06,2015,450,3,2.25,2860,10625,1,0,4,3,10,1920,940,1976,1976,98115,47.691,122.27,2860,8075,39,0,5.25,5720,10935
2.1995e+05,2014,339,3,1,1210,8000,1,0,0,3,6,1210,0,1954,1954,98198,47.421,122.31,1430,8000,60,0,4,2640,9210
5.3e+05,2014,203,4,2.5,2370,9601,1,0,0,3,8,1570,800,1976,1976,98027,47.533,122.05,2550,10500,38,0,6.5,4920,12870
3.18e+05,2015,403,3,1.5,1240,983,3,0,0,3,8,1240,0,2009,2009,98133,47.724,122.35,1240,1026,6,0,4.5,2480,2266
3.39e+05,2014,132,3,1,1080,8100,1,0,0,4,7,1080,0,1955,1955,98155,47.777,122.31,1080,8100,59,0,4,2160,9180
1.17e+06,2014,167,4,2.5,2570,6251,2,0,0,3,9,2570,0,2000,2000,98004,47.593,122.2,2570,9588,14,0,6.5,5140,12158
3e+05,2014,347,2,1,1220,75794,1,0,0,4,7,1220,0,1963,1963,98038,47.422,122.01,2010,98010,51,0,3,3230,99230
6.75e+05,2014,222,3,2.5,2250,4134,2,0,0,3,9,2250,0,2004,2004,98052,47.665,122.08,2390,4134,10,0,5.5,4640,6384
2.7995e+05,2014,297,3,2.25,1340,7202,2,0,0,4,7,1340,0,1989,1989,98038,47.356,122.04,1470,7395,25,0,5.25,2810,8735
7.98e+05,2014,291,3,2.5,2849,9588,2,0,0,3,10,2849,0,2001,2001,98074,47.649,122.08,3190,8897,13,0,5.5,6039,11746
5.4e+05,2015,485,3,2.5,2400,5817,2,0,0,3,8,2400,0,1998,1998,98065,47.537,121.87,2420,5817,17,0,5.5,4820,8217
4.4e+05,2015,415,2,1,1090,4128,1,0,0,3,7,1090,0,1948,1948,98115,47.696,122.31,1090,5413,67,0,3,2180,6503
5.6995e+05,2014,190,4,1,1140,5940,1,0,2,3,7,1140,0,1916,1916,98103,47.679,122.35,1630,4000,98,0,5,2770,5140
3.04e+05,2014,147,3,1,900,7500,1,0,0,4,7,900,0,1972,1972,98034,47.731,122.24,1960,7500,42,0,4,2860,8400
4.275e+05,2015,460,3,1.75,1430,16200,1,0,0,4,7,1430,0,1967,1967,98027,47.522,122.04,1690,13125,48,0,4.75,3120,14555
4.825e+05,2014,245,6,4.5,2940,7500,1,0,0,4,8,2940,0,1966,1966,98034,47.721,122.18,2010,7500,48,0,10.5,4950,10440
5.125e+05,2015,488,4,1.75,1620,4240,1,0,0,5,7,1620,0,1916,1916,98144,47.575,122.31,1450,4240,99,0,5.75,3070,5860
4.944e+05,2014,142,2,1.75,1560,1750,1,0,0,4,6,780,780,1904,1904,98109,47.635,122.36,1850,3600,110,0,3.75,3410,5160
3.9995e+05,2015,437,4,2.5,2350,5100,2,0,0,3,8,2350,0,2003,2003,98038,47.351,122.01,2190,5100,12,0,6.5,4540,7450
4.48e+05,2014,162,2,1.5,1630,3780,1,0,0,4,7,890,740,1940,1940,98107,47.671,122.4,1770,6400,74,0,3.5,3400,8030
8.95e+05,2014,160,5,2.5,2550,20875,1,0,0,4,9,1610,940,1953,1953,98004,47.634,122.19,2510,21673,61,0,7.5,5060,24223
2.15e+05,2014,189,4,1.5,1860,5040,1,0,0,5,8,1860,0,1920,1920,98022,47.208,121.99,1680,5800,94,0,5.5,3540,7660
3.25e+05,2014,276,3,2.25,2480,8755,2,0,0,3,8,2480,0,1979,1979,98058,47.454,122.13,2280,9940,35,0,5.25,4760,12420
5.35e+05,2014,345,2,1,1520,3360,1,0,0,4,7,830,690,1927,1927,98117,47.681,122.38,1470,3774,87,0,3,2990,5294
1.69e+05,2014,196,3,1,890,7110,1,0,0,3,6,890,0,1957,1957,98178,47.497,122.26,1100,8375,57,0,4,1990,9265
5.6e+05,2014,125,3,2.5,1900,8744,2,0,0,3,8,1900,0,1987,1987,98074,47.62,122.04,2030,8744,27,0,5.5,3930,10644
2.3995e+05,2014,305,3,2.25,1560,8280,2,0,0,4,7,1560,0,1979,1979,98001,47.339,122.26,1920,8120,35,0,5.25,3480,9680
4.25e+05,2014,181,3,1.5,1300,19163,1,0,0,3,7,1300,0,1964,1964,98052,47.669,122.15,1590,9744,50,0,4.5,2890,11044
2.5e+05,2014,208,3,1,1460,10914,1,0,0,4,7,1460,0,1959,1959,98058,47.451,122.17,1490,8314,55,0,4,2950,9774
5.44e+05,2014,152,3,1.5,1790,8203,1,0,1,3,7,1790,0,1910,1910,98116,47.577,122.4,1960,6047,104,0,4.5,3750,7837
1.511e+05,2014,304,3,1,840,4495,1,0,0,3,6,840,0,1921,1921,98146,47.496,122.35,1260,7434,93,0,4,2100,8274
4.75e+05,2014,163,3,2.25,1580,12177,1,0,0,3,7,1200,380,1981,1981,98074,47.625,122.05,1660,11374,33,0,5.25,3240,12954
5.35e+05,2014,210,4,1.5,1580,5000,1,0,0,3,7,1390,190,1945,1945,98107,47.673,122.39,1580,5000,69,0,5.5,3160,6580
6.15e+05,2015,426,3,2.5,2980,43301,1,0,0,4,8,1930,1050,1978,1978,98077,47.763,122.09,2890,35915,37,0,5.5,5870,38895
4e+05,2014,149,4,2,1670,12056,1,0,0,3,7,1670,0,1955,1955,98028,47.742,122.24,1860,12056,59,0,6,3530,13726
1.191e+06,2015,401,5,2.5,2710,14989,1,0,0,3,8,1720,990,1959,1959,98004,47.641,122.21,3180,16624,56,0,7.5,5890,19334
4.38e+05,2014,239,3,1,1200,4000,1,0,0,4,6,1200,0,1923,1923,98144,47.588,122.3,1390,4000,91,0,4,2590,5200
3.85e+05,2014,294,4,1.75,2080,8215,2,0,0,4,7,2080,0,1948,1948,98155,47.737,122.31,1550,8215,66,0,5.75,3630,10295
3.29e+05,2015,438,4,2,1850,9126,1,0,0,5,7,1850,0,1963,1963,98059,47.501,122.16,1730,9110,52,0,6,3580,10960
8.377e+05,2014,167,5,2.75,3010,12611,2,0,0,3,10,3010,0,1994,1994,98052,47.696,122.1,2890,9456,20,0,7.75,5900,12466
5.61e+05,2014,262,3,2.25,1640,7200,2,0,0,4,8,1640,0,1985,1985,98007,47.595,122.15,1830,8372,29,0,5.25,3470,10012
5.13e+05,2014,300,2,1,1840,4322,1,0,0,4,7,1160,680,1914,1914,98144,47.576,122.29,1750,4322,100,0,3,3590,6162
7.75e+05,2014,190,6,2.75,2980,5000,1,0,0,3,7,2480,500,1916,1916,98103,47.668,122.33,1470,5000,98,0,8.75,4450,7980
6.64e+05,2014,265,4,2.5,2390,8432,2,0,0,3,9,2390,0,1998,1998,98074,47.603,122.02,2710,7417,16,0,6.5,5100,9807
6.761e+05,2014,265,4,1.5,2270,6010,1,0,0,3,8,1290,980,1954,1954,98115,47.674,122.27,2120,5987,60,0,5.5,4390,8257
5.32e+05,2015,486,3,2.25,1910,35015,1,0,0,4,8,1430,480,1977,1977,98027,47.467,122.01,2340,36680,38,0,5.25,4250,38590
4.7e+05,2014,169,3,2,1730,38884,1,0,0,3,8,1730,0,1997,1997,98038,47.416,121.95,2130,91040,17,0,5,3860,92770
5.67e+05,2015,470,3,1.75,1630,4275,1,0,3,3,7,1630,0,1908,1908,98115,47.685,122.32,1800,4275,107,0,4.75,3430,5905
3.2e+05,2014,298,2,1,1210,7040,1,0,0,3,7,1210,0,1952,1952,98155,47.745,122.3,1210,7205,62,0,3,2420,8415
5.75e+05,2015,413,3,2,1520,5000,1,0,0,3,7,1140,380,1945,1945,98107,47.673,122.39,1530,4650,70,0,5,3050,6170
3.58e+05,2015,467,4,2.75,2580,11900,1,0,0,4,7,1620,960,1967,1967,98058,47.447,122.16,1570,9375,48,0,6.75,4150,11955
3.92e+05,2014,160,4,2.75,1940,6555,2,0,0,3,8,1940,0,1990,1990,98038,47.37,122.04,1840,6912,24,0,6.75,3780,8852
2.76e+05,2014,146,3,1,1140,5000,1,0,0,3,7,1140,0,1960,1960,98106,47.553,122.36,1140,5000,54,0,4,2280,6140
3.76e+05,2014,359,3,2,1540,1827,2,0,0,3,8,1540,0,2005,2005,98029,47.548,122,1560,2058,9,0,5,3100,3598
4.5e+05,2015,393,4,2,1960,5008,1,0,0,3,6,980,980,1900,1988,98144,47.596,122.3,1175,2315,115,1,6,3135,4275
6.97e+05,2014,338,4,2.5,3220,6399,2,0,0,3,9,3220,0,2004,2004,98075,47.588,121.99,2850,6399,10,0,6.5,6070,9619
7.6e+05,2014,313,4,2.5,2850,11000,2,0,0,3,8,2850,0,1998,1998,98052,47.676,122.16,1720,11000,16,0,6.5,4570,13850
4.4995e+05,2014,232,4,2.5,2070,7312,1,0,0,4,7,1230,840,1977,1977,98052,47.696,122.12,1770,7668,37,0,6.5,3840,9738
5.02e+05,2014,159,3,1.75,1300,8800,1,0,0,4,8,1300,0,1963,1963,98008,47.62,122.12,1350,8800,51,0,4.75,2650,10100
4.02e+05,2014,176,2,1,620,2475,1,0,0,5,6,620,0,1911,1911,98107,47.666,122.37,1290,2475,103,0,3,1910,3095
6.9e+05,2014,243,3,1.75,1600,4400,1,0,0,3,7,1030,570,1941,1941,98112,47.635,122.28,2150,4000,73,0,4.75,3750,5600
6.05e+05,2015,458,3,3,1760,2114,2,0,0,3,7,1400,360,2008,2008,98107,47.667,122.37,1300,1500,7,0,6,3060,3260
5.0999e+05,2015,383,3,2,1440,4859,2,0,0,2,6,1440,0,1921,1921,98118,47.55,122.28,1360,4558,94,0,5,2800,5998
4.99e+05,2015,447,4,3,2030,12675,2,0,0,3,7,2030,0,1982,1982,98177,47.769,122.38,1990,7705,33,0,7,4020,9735
3.43e+05,2014,332,2,1,1180,9261,1,0,0,4,7,940,240,1957,1957,98118,47.549,122.27,1700,6325,57,0,3,2880,7505
7.75e+05,2014,208,4,2.5,3090,7112,2,0,0,3,9,3090,0,2001,2001,98052,47.705,122.12,3050,6000,13,0,6.5,6140,9090
3e+05,2014,162,3,2.5,1970,7500,2,0,0,3,8,1970,0,1988,1988,98092,47.266,122.22,1950,8220,26,0,5.5,3920,10190
2.575e+05,2014,197,3,1.5,1210,12500,1,0,0,3,7,1210,0,1962,1962,98146,47.503,122.35,1210,12500,52,0,4.5,2420,13710
3.25e+05,2014,148,2,2.5,1050,1609,2,0,0,3,7,1050,0,2005,2005,98144,47.585,122.31,1120,1693,9,0,4.5,2170,2743
2.945e+05,2014,334,3,2.5,1760,2688,2,0,0,3,7,1760,0,2005,2005,98059,47.49,122.17,1760,2329,9,0,5.5,3520,4089
1.63e+05,2015,414,3,1.75,1290,4811,1,0,0,3,7,1290,0,1996,1996,98032,47.391,122.23,1310,4811,19,0,4.75,2600,6101
4.468e+05,2014,287,4,2,2410,8712,1,0,0,3,7,1260,1150,1958,1958,98144,47.573,122.3,2220,6038,56,0,6,4630,8448
4.15e+05,2014,250,1,1,1230,3774,1,0,0,4,6,830,400,1924,1924,98103,47.689,122.35,1300,3774,90,0,2,2530,5004
2.6e+05,2014,273,2,1,1410,5650,1,0,0,3,6,1410,0,1918,1918,98118,47.516,122.26,1430,5650,96,0,3,2840,7060
3.3e+05,2014,170,3,2.25,1860,11227,2,0,0,3,7,1860,0,1995,1995,98038,47.388,122.03,1820,8800,19,0,5.25,3680,10660
5.2e+05,2015,440,4,2.75,2020,7357,1,0,0,3,7,1350,670,1986,1986,98034,47.715,122.22,1690,7804,29,0,6.75,3710,9824
5.05e+05,2014,325,4,2.5,2420,5006,2,0,0,3,8,2420,0,2013,2013,98059,47.48,122.13,2750,5471,1,0,6.5,5170,7891
5.5e+05,2014,319,3,1.75,1880,45738,1,0,0,4,8,1410,470,1980,1980,98072,47.766,122.11,2340,38556,34,0,4.75,4220,40436
2.7e+05,2014,238,3,2.5,1870,5000,2,0,0,3,7,1870,0,2009,2009,98042,47.334,122.06,2170,5399,5,0,5.5,4040,7269
5.75e+05,2014,187,4,2.5,2400,6137,2,0,0,3,8,2400,0,1990,1990,98074,47.619,122.04,2120,7468,24,0,6.5,4520,9868
4e+05,2014,125,2,1,840,5510,1,0,0,3,7,840,0,1955,1955,98136,47.525,122.39,1630,5510,59,0,3,2470,6350
5.8e+05,2014,126,4,3.25,3569,8327,2,0,0,3,10,3569,0,2013,2013,98055,47.459,122.21,2550,5251,1,0,7.25,6119,8820
9e+05,2015,451,4,2.5,3510,6745,2,0,0,3,10,3510,0,1998,1998,98075,47.602,122.07,3320,8370,17,0,6.5,6830,11880
4.15e+05,2015,466,4,2.5,2670,8279,2,0,0,3,7,2670,0,1999,1999,98148,47.429,122.33,2290,7504,16,0,6.5,4960,10174
9.111e+05,2014,231,4,3.25,3330,33826,2,0,0,5,8,3330,0,1924,1924,98155,47.76,122.28,2580,28707,90,0,7.25,5910,32037
7.5e+05,2015,452,5,2.75,3330,12408,1,0,0,3,10,1740,1590,1976,1976,98074,47.632,122.06,2780,12000,39,0,7.75,6110,15330
6.8e+05,2014,287,3,2.5,1800,4400,1,0,0,5,7,1350,450,1970,1970,98199,47.66,122.4,1920,4400,44,0,5.5,3720,6200
1.7e+05,2014,180,2,1,1200,24792,2,0,0,2,7,1200,0,1976,1976,98053,47.634,121.96,2150,24792,38,0,3,3350,25992
2.8e+05,2014,332,3,1,940,7913,1,0,0,3,6,940,0,1948,1948,98155,47.766,122.32,940,7913,66,0,4,1880,8853
3.695e+05,2014,163,3,1.5,1650,9957,1,0,0,4,7,1100,550,1961,1961,98125,47.73,122.3,1650,7957,53,0,4.5,3300,9607
8e+05,2015,372,4,3.5,2370,3302,2,0,0,3,8,1610,760,1926,2014,98103,47.684,122.34,2170,3800,89,1,7.5,4540,6170
3.35e+05,2015,481,3,2.25,1870,5876,2,0,0,3,7,1870,0,1986,1986,98038,47.378,122.05,1670,6203,29,0,5.25,3540,8073
5.46e+05,2014,304,2,1,1657,5031,2,0,0,3,7,1657,0,1910,1910,98116,47.57,122.39,2050,6201,104,0,3,3707,7858
1.52e+05,2014,190,3,1,920,4875,1,0,0,4,7,920,0,1978,1978,98042,47.362,122.09,1160,4875,36,0,4,2080,5795
9.92e+05,2015,423,3,2.25,2950,15207,1,0,0,4,10,2070,880,1966,1966,98040,47.557,122.22,2950,22000,49,0,5.25,5900,24950
1.9e+05,2014,320,2,1,880,6900,1,0,0,3,6,880,0,1943,1943,98056,47.49,122.19,1060,8000,71,0,3,1940,8880
3.85e+05,2014,133,3,2,1480,6600,1,0,2,3,7,740,740,1943,1943,98146,47.508,122.39,1250,7300,71,0,5,2730,8780
5.8e+05,2014,214,4,2.5,2150,5000,2,0,0,3,8,2150,0,2001,2001,98115,47.696,122.31,2030,6380,13,0,6.5,4180,8530
1.05e+06,2014,142,4,2.5,3030,12590,1,0,0,4,10,3030,0,1988,1988,98004,47.581,122.19,2980,11635,26,0,6.5,6010,14665
5.45e+05,2015,380,4,2.25,2050,9720,2,0,0,3,8,2050,0,1967,1967,98008,47.591,122.12,2310,9680,48,0,6.25,4360,11730
3.45e+05,2014,173,3,1.5,1420,1192,2,0,0,3,8,1140,280,2008,2008,98144,47.588,122.3,1340,1213,6,0,4.5,2760,2633
4.4252e+05,2015,392,4,2.5,2930,4875,2,0,0,3,9,2930,0,2014,2014,98030,47.342,122.18,2815,4900,1,0,6.5,5745,7830
3.42e+05,2014,177,3,1.75,1780,10409,1,0,0,3,7,1280,500,1981,1981,98058,47.463,122.17,1780,7415,33,0,4.75,3560,9195
8.65e+05,2015,382,4,3.5,3380,11270,2,0,1,3,9,2160,1220,2007,2007,98074,47.612,122.06,2910,11214,8,0,7.5,6290,14594
4.15e+05,2014,239,3,1.5,1860,9003,1,0,0,3,7,1490,370,1955,1955,98028,47.762,122.26,2090,11574,59,0,4.5,3950,13434
7e+05,2014,243,3,1.75,2600,7668,1,0,0,4,8,1300,1300,1968,1968,98010,47.34,122.05,1980,13664,46,0,4.75,4580,16264
3.9995e+05,2014,278,3,1,1720,8910,1,0,0,4,7,1720,0,1954,1954,98155,47.774,122.3,1870,8640,60,0,4,3590,10360
3.8925e+05,2014,156,2,1.5,1490,4080,1,0,0,3,7,930,560,1956,1956,98126,47.534,122.38,1320,4080,58,0,3.5,2810,5570
7.8e+05,2015,438,5,1.5,1940,4800,2,0,0,3,8,1940,0,1905,1905,98103,47.684,122.33,1750,4800,110,0,6.5,3690,6740
3.4995e+05,2014,135,3,2.5,1700,7496,2,0,0,3,8,1700,0,1994,1994,98055,47.432,122.19,2280,7496,20,0,5.5,3980,9196
4.71e+05,2014,156,3,2.5,2030,2805,2,0,0,3,8,1720,310,2001,2001,98027,47.531,122.05,1670,2898,13,0,5.5,3700,4928
4.08e+05,2015,393,3,1,1420,8000,1,0,4,3,7,1420,0,1950,1950,98118,47.517,122.25,1780,8295,65,0,4,3200,9715
1.99e+05,2014,141,4,2,2030,8120,2,0,0,3,7,2030,0,1950,1950,98178,47.499,122.26,1520,9440,64,0,6,3550,11470
7.6e+05,2014,353,4,2.5,3580,97574,2,0,0,3,9,3580,0,2004,2004,98038,47.39,122.07,2510,27068,10,0,6.5,6090,30648
5e+05,2014,242,2,1,930,3750,1,0,0,4,7,930,0,1909,1909,98115,47.673,122.3,1740,4300,105,0,3,2670,5230
4.25e+05,2014,264,2,2.5,1340,1263,3,0,0,3,8,1340,0,2008,2008,98117,47.679,122.39,1510,1260,6,0,4.5,2850,2600
5.15e+05,2015,473,3,1.75,1300,5120,1,0,0,4,6,1300,0,1925,1925,98116,47.559,122.39,1090,5124,90,0,4.75,2390,6424
1.999e+05,2014,197,5,1.75,1798,11232,1,0,0,3,7,1798,0,1967,1967,98001,47.327,122.29,1300,15582,47,0,6.75,3098,17380
3.15e+05,2014,291,3,1.75,1680,7250,1,0,0,3,7,930,750,1952,1952,98133,47.72,122.35,1340,7250,62,0,4.75,3020,8930
5.21e+05,2014,324,4,1.75,2020,36400,1,0,0,4,8,1550,470,1976,1976,98077,47.763,122.08,2520,38255,38,0,5.75,4540,40275
5.15e+05,2014,221,3,2.5,2610,5845,2,0,0,3,8,2610,0,2005,2005,98059,47.482,122.14,2810,5000,9,0,5.5,5420,7610
3.15e+05,2014,320,3,2.5,1410,1325,2,0,0,3,7,1180,230,2007,2007,98106,47.558,122.36,1270,1282,7,0,5.5,2680,2692
7.992e+05,2014,133,6,3,2890,2370,2,0,0,3,7,2290,600,1906,1906,98102,47.623,122.32,2180,2460,108,0,9,5070,5350
3.399e+05,2014,191,4,2.5,2340,9748,1,0,1,3,8,1610,730,1981,1981,98003,47.336,122.33,2070,8241,33,0,6.5,4410,10581
2.3e+05,2014,236,3,1,880,7500,1,0,0,3,7,880,0,1978,1978,98198,47.384,122.31,880,7500,36,0,4,1760,8380
7.01e+05,2015,491,4,2.5,3340,5314,2,0,0,3,10,3340,0,2010,2010,98065,47.517,121.89,3220,5500,5,0,6.5,6560,8840
1.695e+05,2014,211,2,1,790,7450,1,0,0,4,6,790,0,1944,1944,98058,47.474,122.17,800,7450,70,0,3,1590,8240
3.5e+05,2015,453,3,2.5,1970,3655,2,0,0,3,7,1970,0,2003,2003,98019,47.745,121.98,1970,2952,12,0,5.5,3940,4922
4.3e+05,2015,433,2,1,950,6426,1,0,0,3,7,950,0,1949,1949,98126,47.565,122.37,1360,2550,66,0,3,2310,3500
4.161e+05,2014,190,4,1.75,2320,5490,1,0,3,3,8,1160,1160,1956,1956,98178,47.509,122.24,2240,7200,58,0,5.75,4560,9520
3.2995e+05,2014,176,3,1,1750,7800,1,0,0,4,7,1150,600,1956,1956,98166,47.46,122.34,1750,7560,58,0,4,3500,9310
2.6e+05,2015,488,3,2.25,1610,7423,2,0,0,4,7,1610,0,1990,1990,98042,47.371,122.09,1530,8102,25,0,5.25,3140,9712
3.12e+05,2014,126,4,2,1300,7054,1,0,0,3,7,1300,0,1950,2013,98146,47.507,122.37,1560,7100,64,1,6,2860,8400
8.24e+05,2015,444,4,2.25,2490,9864,1,0,0,4,8,1290,1200,1961,1961,98004,47.605,122.19,2360,9864,54,0,6.25,4850,12354
3.12e+05,2014,298,2,1,1460,6000,1,0,0,2,7,1260,200,1925,1925,98115,47.701,122.32,1580,6380,89,0,3,3040,7840
3.36e+05,2014,194,4,2.25,2210,11700,2,0,0,4,8,2210,0,1967,1967,98032,47.365,122.28,2040,9000,47,0,6.25,4250,11210
4.24e+05,2014,269,3,1.75,1140,3395,1,0,0,5,7,620,520,1925,1925,98107,47.671,122.39,1480,3500,89,0,4.75,2620,4640
3.16e+05,2015,456,3,2.5,2550,8170,2,0,0,3,8,2550,0,1985,1985,98023,47.311,122.34,1840,8823,30,0,5.5,4390,11373
4e+05,2015,383,4,3,2320,13068,2,0,2,3,8,2320,0,1998,1998,98198,47.35,122.32,2220,25265,17,0,7,4540,27585
5.195e+05,2015,410,4,2,1540,17859,1,0,0,3,6,1540,0,1964,1964,98027,47.533,122.03,1390,9688,51,0,6,2930,11228
3.95e+05,2014,283,4,2.5,2740,8336,2,0,0,4,9,2740,0,1990,1990,98031,47.39,122.18,2460,9189,24,0,6.5,5200,11929
2.8e+05,2014,170,3,2,1470,8089,1,0,0,3,7,1470,0,1987,1987,98198,47.388,122.32,1530,7721,27,0,5,3000,9191
2.15e+05,2014,258,4,1,1130,7400,1,0,0,4,7,1130,0,1969,1969,98003,47.344,122.32,1540,7379,45,0,5,2670,8509
8e+05,2015,453,4,2.25,2120,9921,2,0,0,3,8,2120,0,1981,1981,98027,47.559,122.08,1890,7845,34,0,6.25,4010,9965
4.05e+05,2014,211,3,2.25,1590,7267,1,0,0,4,7,1100,490,1976,1976,98133,47.746,122.33,2060,8336,38,0,5.25,3650,9926
5.3e+05,2015,444,4,2.25,2180,10754,1,0,0,5,7,1100,1080,1954,1954,98133,47.771,122.34,1810,6929,61,0,6.25,3990,9109
4.966e+05,2014,320,4,2.25,2020,8400,1,0,0,4,8,1350,670,1961,1961,98006,47.549,122.17,2060,8400,53,0,6.25,4080,10420
3.38e+05,2014,348,3,1.5,2400,8215,1,0,0,3,7,1200,1200,1961,1961,98146,47.5,122.34,1460,8217,53,0,4.5,3860,10617
3.389e+05,2014,198,4,2.5,1830,5612,2,0,0,3,7,1830,0,2003,2003,98038,47.357,122.02,1830,5998,11,0,6.5,3660,7828
5.15e+05,2014,242,4,2.5,2280,14810,1,0,0,5,8,1500,780,1977,1977,98056,47.539,122.19,2690,12196,37,0,6.5,4970,14476
7.605e+05,2014,154,3,2,1990,3990,1,0,0,5,7,1130,860,1912,1912,98103,47.657,122.33,1710,4000,102,0,5,3700,5990
6.65e+05,2015,374,3,1.75,2700,5040,1,0,2,3,8,1560,1140,1947,1947,98144,47.583,122.29,3010,5000,68,0,4.75,5710,7700
6.41e+05,2015,456,5,2.75,3710,8674,2,0,0,3,9,3710,0,1996,1996,98056,47.514,122.18,3250,8678,19,0,7.75,6960,12388
1.9e+06,2015,445,4,2.25,3020,11489,1,1,3,5,10,2110,910,1916,1988,98040,47.539,122.21,3890,11489,99,1,6.25,6910,14509
3.8995e+05,2015,486,2,1,820,4234,1,0,1,3,6,820,0,1951,1951,98136,47.529,122.39,1550,4236,64,0,3,2370,5056
2.37e+05,2014,215,3,2,1710,7920,1,0,0,3,8,1260,450,1968,1968,98003,47.347,122.31,1760,8120,46,0,5,3470,9830
5.4e+05,2014,158,4,2.5,1780,4169,2,0,0,3,8,1780,0,1994,1994,98029,47.569,122.01,1830,4164,20,0,6.5,3610,5944
3.3e+05,2015,437,4,2.5,2310,6320,2,0,0,3,8,2310,0,1997,1997,98092,47.329,122.17,1850,6181,18,0,6.5,4160,8491
5.1025e+05,2014,148,3,1.75,1400,4000,1,0,0,3,7,870,530,1951,1951,98117,47.691,122.38,1400,4000,63,0,4.75,2800,5400
7.3e+05,2014,326,4,2.75,3660,1.5028e+05,2,0,0,3,10,3660,0,1990,1990,98053,47.681,122.05,3090,53578,24,0,6.75,6750,57238
4.85e+05,2014,127,3,2,1610,4160,1,0,0,4,7,1010,600,1917,1917,98136,47.542,122.39,1040,4400,97,0,5,2650,6010
4.165e+05,2014,306,4,2,2280,39848,2,0,0,4,8,2280,0,1991,1991,98070,47.5,122.47,1900,38472,23,0,6,4180,40752
4.12e+05,2014,333,3,2.5,2210,7000,2,0,0,4,8,2210,0,1985,1985,98058,47.438,122.13,2260,7224,29,0,5.5,4470,9434
4.65e+05,2014,265,4,2.5,3050,32450,1,0,0,4,8,1550,1500,1983,1983,98030,47.363,122.21,2350,15390,31,0,6.5,5400,18440
5.3495e+05,2014,222,3,2.25,2130,12286,2,0,0,3,8,2130,0,1977,1977,98052,47.647,122.11,2130,10158,37,0,5.25,4260,12288
4.2e+05,2014,251,3,1,1440,5623,1,0,0,4,6,720,720,1922,1922,98115,47.696,122.32,1280,5623,92,0,4,2720,7063
1.5325e+06,2014,127,5,4.5,4270,8076,2,0,0,3,11,3400,870,2007,2007,98033,47.699,122.21,4100,10631,7,0,9.5,8370,14901
4.25e+05,2014,235,3,2.25,1570,7475,1,0,0,4,7,1200,370,1983,1983,98034,47.722,122.17,1700,7230,31,0,5.25,3270,8800
4.435e+05,2015,396,2,1,940,6804,1,0,0,3,7,940,0,1949,1949,98177,47.705,122.37,1150,6930,66,0,3,2090,7870
4.65e+05,2014,161,4,1.75,1470,5350,1,0,0,3,7,980,490,1955,1955,98125,47.705,122.31,1970,6138,59,0,5.75,3440,7608
4.3e+05,2015,414,2,1.75,1840,14874,1,0,2,3,8,1300,540,1952,1952,98166,47.438,122.35,2920,15084,63,0,3.75,4760,16924
4.63e+05,2015,393,3,2,1590,5009,2,0,0,4,6,1590,0,1985,1985,98125,47.701,122.32,1730,6380,30,0,5,3320,7970
3.6e+05,2015,432,2,1,2320,11250,2,0,0,4,6,2320,0,1942,1942,98146,47.504,122.36,1620,11250,73,0,3,3940,13570
7.2e+05,2015,417,4,2.75,3370,7634,1,0,2,5,8,2110,1260,1977,1977,98056,47.526,122.2,2460,7634,38,0,6.75,5830,11004
2.675e+05,2014,149,3,1.75,1590,11914,1,0,2,3,7,1090,500,1957,1957,98188,47.443,122.27,1630,9052,57,0,4.75,3220,10642
2.8e+05,2014,153,3,1.75,1590,27200,1,0,0,4,6,1590,0,1926,1926,98038,47.424,122.05,1820,74052,88,0,4.75,3410,75642
4.35e+05,2014,122,4,1,1450,8800,1,0,0,4,7,1450,0,1954,1954,98006,47.575,122.14,1260,8942,60,0,5,2710,10392
5.87e+05,2014,341,4,2.75,3190,8737,2,0,0,3,9,3190,0,2006,2006,98065,47.523,121.88,3240,7131,8,0,6.75,6430,10321
4.44e+05,2014,264,3,2,1460,2610,2,0,0,3,8,1460,0,1987,1987,98103,47.686,122.34,1320,3000,27,0,5,2780,4460
3.65e+05,2014,202,2,1,980,5110,1,0,0,4,7,780,200,1939,1939,98115,47.7,122.31,1430,5110,75,0,3,2410,6090
2.55e+05,2014,135,4,2.5,2070,7800,2,0,0,3,8,2070,0,1989,1989,98003,47.349,122.31,1950,7815,25,0,6.5,4020,9885
5.65e+05,2014,196,4,1,1540,2452,1,0,0,4,7,1540,0,1906,1906,98103,47.652,122.35,1290,3360,108,0,5,2830,4900
6.9e+05,2014,168,3,3.25,1540,1428,3,0,0,3,9,1540,0,2013,2013,98103,47.665,122.35,1660,3300,1,0,6.25,3200,4840
6.45e+05,2014,346,4,2.25,2070,8720,1,0,0,5,8,1360,710,1974,1974,98033,47.668,122.18,2180,8510,40,0,6.25,4250,10580
2e+05,2014,190,4,2,2090,6630,1,0,0,3,7,1070,1020,1974,1974,98178,47.508,122.27,1550,7980,40,0,6,3640,10070
2.85e+05,2015,408,4,3,1900,7194,2,0,0,4,7,1900,0,1988,1988,98042,47.377,122.12,1690,7194,27,0,7,3590,9094
3.75e+05,2014,331,3,3.25,1370,1227,3,0,0,3,8,1370,0,2007,2007,98103,47.696,122.34,1370,1236,7,0,6.25,2740,2606
9.6e+05,2015,474,4,3.5,4610,11676,2,0,0,3,10,4610,0,2000,2000,98075,47.601,121.98,3900,11164,15,0,7.5,8510,15774
4.425e+05,2014,231,2,2.25,1510,7280,2,0,0,3,7,1510,0,1987,1987,98074,47.626,122.06,1510,8120,27,0,4.25,3020,9630
2.4995e+05,2015,401,3,1.75,1120,15210,1,0,0,5,7,1120,0,1976,1976,98042,47.366,122.11,1710,8470,39,0,4.75,2830,9590
3.25e+05,2015,464,2,1.75,1670,10725,1,0,0,3,7,1670,0,1965,1965,98178,47.489,122.23,1600,10725,50,0,3.75,3270,12395
3.735e+05,2014,142,2,1,800,3330,1,0,0,3,7,800,0,1918,1918,98107,47.657,122.36,1300,4320,96,0,3,2100,5120
6.25e+05,2015,445,4,2.75,2390,6979,2,0,0,3,8,2390,0,1993,1993,98029,47.57,122,2090,6321,22,0,6.75,4480,8711
5.4e+05,2014,294,4,2.25,2850,7453,2,0,0,3,9,2850,0,1991,1991,98072,47.744,122.17,2700,8468,23,0,6.25,5550,11318
6.65e+05,2014,143,3,2.75,1800,9550,1,0,0,4,7,1320,480,1966,1966,98006,47.568,122.18,1890,9902,48,0,5.75,3690,11702
3.7103e+05,2014,166,3,2,1530,8925,1,0,0,3,7,1530,0,1977,1977,98011,47.736,122.2,2040,8856,37,0,5,3570,10386
3.78e+05,2015,423,2,2,1300,3850,1,0,0,3,7,800,500,1963,1963,98136,47.539,122.39,950,5500,52,0,4,2250,6800
6.94e+05,2015,467,2,2.5,2320,9311,1,0,0,3,8,2320,0,2007,2007,98053,47.723,122.03,1680,4765,8,0,4.5,4000,7085
3.65e+06,2015,471,6,4.75,5480,19401,1,1,4,5,11,3910,1570,1936,1936,98105,47.651,122.28,3510,15810,79,0,10.75,8990,21290
6.361e+05,2014,271,3,1,1010,6000,1,0,0,3,7,1010,0,1919,1977,98119,47.644,122.36,1960,4000,95,1,4,2970,5010
2.65e+05,2014,166,3,1,1000,9150,1,0,0,3,7,1000,0,1969,1969,98059,47.483,122.12,1490,10647,45,0,4,2490,11647
4.2424e+05,2014,232,3,2,2080,12094,2,0,0,4,8,2080,0,1982,1982,98052,47.703,122.16,2230,12204,32,0,5,4310,14284
4.0932e+05,2014,140,3,2.5,1800,3168,2,0,0,3,8,1800,0,2014,2014,98065,47.534,121.84,1800,3393,0,0,5.5,3600,5193
7.7e+05,2014,320,4,2.25,2730,5000,1,0,0,5,7,1460,1270,1955,1955,98116,47.584,122.39,2010,5000,59,0,6.25,4740,7730
6.35e+05,2014,152,3,2.5,1960,7200,1,0,0,4,8,980,980,1940,1940,98118,47.566,122.27,1440,7200,74,0,5.5,3400,9160
3.99e+05,2014,218,3,2,1940,16300,1,0,0,3,7,1140,800,1978,1978,98155,47.774,122.28,1940,11250,36,0,5,3880,13190
4.75e+05,2015,466,2,2.25,1060,925,2,0,0,3,8,980,80,2006,2006,98199,47.639,122.39,1020,4000,9,0,4.25,2080,5060
5.46e+05,2015,401,2,1,1200,12856,1,0,0,4,6,1200,0,1948,1948,98027,47.532,122.03,1740,6098,67,0,3,2940,7298
4.85e+05,2014,162,4,2.5,2470,35073,2,0,0,3,9,2470,0,1989,1989,98092,47.306,122.11,2990,35259,25,0,6.5,5460,37729
3.97e+05,2015,414,2,1,1030,12350,1,0,0,3,7,1030,0,1942,1942,98115,47.698,122.32,1790,6900,73,0,3,2820,7930
5.1e+05,2014,310,5,1.5,1550,9750,1,0,0,4,7,1550,0,1966,1966,98033,47.681,122.17,1970,9750,48,0,6.5,3520,11300
3.34e+05,2015,381,3,1.75,1400,7405,1,0,0,3,7,1400,0,1961,1961,98133,47.757,122.33,1820,7440,54,0,4.75,3220,8840
1.25e+06,2014,189,4,2.5,2920,5500,1,0,3,3,10,2030,890,1957,1957,98199,47.641,122.41,3790,5500,57,0,6.5,6710,8420
4.525e+05,2014,232,3,1.75,2040,15695,1,0,0,4,8,2040,0,1959,1959,98166,47.416,122.34,2280,14400,55,0,4.75,4320,16440
2.79e+05,2014,156,5,2.5,2690,5557,2,0,0,3,7,2690,0,2012,2012,98178,47.491,122.25,2090,10500,2,0,7.5,4780,13190
2.75e+05,2014,298,3,2.25,1820,9766,1,0,0,4,7,1450,370,1987,1987,98031,47.397,122.2,1860,8236,27,0,5.25,3680,10056
3.23e+05,2014,224,5,2.5,2500,13034,1,0,0,3,7,1300,1200,1962,1962,98092,47.334,122.19,2440,13300,52,0,7.5,4940,15800
5.37e+05,2015,447,3,2,1550,27003,1,0,0,3,8,1550,0,1982,1982,98074,47.606,122.06,2400,27003,33,0,5,3950,28553
5.7e+05,2015,481,3,1.75,2390,9000,1,0,0,3,8,1500,890,1975,1975,98052,47.681,122.11,2040,9000,40,0,4.75,4430,11390
6.95e+05,2014,255,5,3,3290,14134,1,0,0,3,7,1870,1420,2004,2004,98052,47.671,122.14,1970,11470,10,0,8,5260,14760
4.25e+05,2015,493,3,2.75,3370,13929,2,0,0,3,9,2650,720,1986,1986,98092,47.341,122.2,2150,14048,29,0,5.75,5520,17418
3.45e+05,2014,148,2,1,1080,4000,1,0,0,3,7,1080,0,1940,1940,98117,47.69,122.39,1530,4240,74,0,3,2610,5320
2.66e+05,2014,340,4,2.25,1860,12693,1,0,0,3,8,1140,720,1978,1978,98023,47.311,122.39,1950,8740,36,0,6.25,3810,10600
4.4e+05,2014,255,4,3.5,3180,4869,2,0,0,3,8,2390,790,2007,2007,98055,47.448,122.21,2850,4500,7,0,7.5,6030,7680
2.4e+05,2014,150,3,2,1330,6000,1,0,0,4,7,630,700,1900,1900,98108,47.526,122.33,1140,6000,114,0,5,2470,7330
3.52e+05,2014,175,4,1,1530,8890,1,0,0,3,7,980,550,1925,1925,98106,47.531,122.35,1100,5203,89,0,5,2630,6733
5.4e+05,2014,243,2,1.25,1230,1569,2,0,0,3,9,1050,180,2009,2009,98112,47.619,122.3,1100,1230,5,0,3.25,2330,2460
5.42e+05,2014,264,2,1,890,3060,1,0,0,3,7,770,120,1910,1910,98105,47.666,122.33,1760,4080,104,0,3,2650,4970
6.07e+05,2014,270,3,2.75,2810,12813,2,0,0,3,8,2040,770,1988,1988,98052,47.68,122.11,1890,10336,26,0,5.75,4700,13146
5.5e+05,2014,133,7,4,3440,8100,2,0,0,3,7,3440,0,1970,1970,98103,47.698,122.35,1420,1560,44,0,11,4860,5000
3.1889e+05,2014,283,4,1.75,2320,12000,1,0,0,4,8,2270,50,1973,1973,98032,47.364,122.28,2120,9880,41,0,5.75,4440,12200
7.7e+05,2014,203,5,2.75,3360,12080,2,0,0,3,9,3360,0,2014,2014,98011,47.776,122.17,3360,9724,0,0,7.75,6720,13084
4.85e+05,2015,409,3,2,2410,50654,1,0,0,3,7,2410,0,1995,1995,98070,47.415,122.46,1900,36300,20,0,5,4310,38710
2.95e+05,2014,238,4,3,2120,7650,2,0,0,3,8,2120,0,1964,1964,98007,47.621,122.14,2260,7885,50,0,7,4380,10005
4.0038e+05,2014,331,4,1.75,1690,7680,1,0,0,5,6,890,800,1946,1946,98126,47.53,122.38,1060,7680,68,0,5.75,2750,9370
6.785e+05,2015,431,3,2.75,1210,3600,1,0,2,5,7,1210,0,1910,1910,98103,47.68,122.35,1630,3910,105,0,5.75,2840,5120
3.1e+05,2014,244,4,2.5,2440,7093,2,0,0,3,7,2440,0,1999,1999,98030,47.382,122.2,1860,6072,15,0,6.5,4300,8512
2.53e+05,2014,167,3,1.5,880,6600,1,0,0,5,6,880,0,1945,1945,98178,47.5,122.25,1020,6600,69,0,4.5,1900,7480
5.988e+05,2015,401,6,4,4470,17877,3,0,3,3,9,3230,1240,2013,2013,98188,47.451,122.27,1790,18260,2,0,10,6260,22730
1.795e+05,2014,349,3,1,1180,32214,1,0,0,3,7,1180,0,1952,1952,98092,47.331,122.2,2300,13714,62,0,4,3480,14894
3.11e+05,2015,388,4,2.5,1975,8734,2,0,0,3,7,1975,0,1996,1996,98038,47.363,122.03,1975,8538,19,0,6.5,3950,10513
1.69e+05,2014,215,3,1.5,1570,6450,1,0,0,4,6,1570,0,1931,1931,98022,47.202,122,1400,6450,83,0,4.5,2970,8020
5e+05,2014,172,4,2.5,2040,8400,1,0,0,3,8,1420,620,1963,1963,98006,47.551,122.17,2540,8925,51,0,6.5,4580,10965
5.38e+05,2014,294,2,1.75,1850,3060,1,0,0,3,7,1060,790,1929,1992,98115,47.682,122.31,1850,4080,85,1,3.75,3700,5930
7.49e+05,2014,256,4,2.5,1710,9627,1,0,0,3,9,1440,270,1976,2014,98006,47.559,122.16,2140,9131,38,1,6.5,3850,10841
2.49e+05,2015,433,3,1.75,1400,5648,1,0,0,5,6,1400,0,1917,1917,98056,47.513,122.2,2320,9420,98,0,4.75,3720,10820
3.85e+05,2014,290,4,1.75,2360,7620,1,0,0,4,7,1180,1180,1955,1955,98106,47.528,122.34,1910,7620,59,0,5.75,4270,9980
3.13e+05,2014,147,3,1.75,1320,6205,1,0,0,5,7,1320,0,1948,1948,98133,47.741,122.34,1210,6205,66,0,4.75,2530,7525
1.18e+05,2014,291,1,1,670,7957,1,0,0,4,6,670,0,1978,1978,98038,47.359,122.06,1600,7957,36,0,2,2270,8627
1.405e+06,2014,139,4,3.5,3410,10769,2,0,0,3,10,3410,0,2008,2008,98004,47.608,122.2,2650,10058,6,0,7.5,6060,13468
2.76e+05,2015,388,3,1.75,2240,9200,1,0,0,4,7,1440,800,1968,1968,98001,47.264,122.28,1740,9600,47,0,4.75,3980,11840
3.57e+05,2014,332,3,1.5,1590,6750,1,0,0,3,7,1080,510,1976,1976,98034,47.73,122.19,1590,7400,38,0,4.5,3180,8990
3.65e+05,2014,258,4,2.5,2140,7350,2,0,0,3,8,2140,0,1985,1985,98058,47.448,122.12,2120,8395,29,0,6.5,4260,10535
4.75e+05,2015,471,3,2.25,1580,8659,1,0,0,4,7,1220,360,1961,1961,98011,47.76,122.22,1970,9650,54,0,5.25,3550,11230
7.05e+05,2014,284,4,2,2060,6000,1,0,1,4,8,1370,690,1954,1954,98136,47.524,122.38,2060,6600,60,0,6,4120,8660
3.1e+06,2014,235,3,3,3920,13085,2,1,4,4,11,3920,0,1996,1996,98040,47.572,122.2,3450,13287,18,0,6,7370,17207
3.625e+05,2015,365,3,1,1520,9507,1,0,0,3,7,1520,0,1954,1954,98125,47.716,122.32,1360,7219,61,0,4,2880,8739
6.875e+05,2014,255,3,1.75,2450,9377,1,0,2,4,8,1540,910,1962,1962,98125,47.73,122.28,2520,9725,52,0,4.75,4970,12175
5.5e+05,2014,263,4,2.5,2470,7539,2,0,0,3,9,2470,0,2006,2006,98028,47.741,122.23,2580,7539,8,0,6.5,5050,10009
9.35e+05,2014,230,4,3,3680,7105,2,0,2,3,10,2890,790,2008,2008,98115,47.696,122.31,1580,6815,6,0,7,5260,10495
5.07e+05,2014,208,4,2.25,1490,956,2,0,0,3,7,1020,470,2005,2005,98122,47.618,122.3,1510,1350,9,0,6.25,3000,2840
2.48e+05,2015,410,3,1,1180,6947,1,0,0,4,7,1180,0,1968,1968,98031,47.423,122.18,1760,8657,47,0,4,2940,9837
7.1e+05,2014,176,3,3.25,3740,1.3692e+05,2,0,0,3,11,3100,640,1990,1990,98166,47.455,122.36,2400,16104,24,0,6.25,6140,19844
6.081e+05,2015,477,3,2.5,2680,17707,2,0,1,3,9,2680,0,1983,1983,98034,47.703,122.22,2840,21743,32,0,5.5,5520,24423
3.18e+05,2014,280,3,2.25,1250,1017,3,0,0,3,8,1250,0,2008,2008,98133,47.71,122.33,1250,1017,6,0,5.25,2500,2267
2.85e+05,2014,159,3,2.25,1680,35127,2,0,0,3,7,1680,0,1987,1987,98092,47.303,122.07,1820,35166,27,0,5.25,3500,36846
3.63e+05,2015,402,3,2.5,2740,11872,2,0,0,3,9,2740,0,1990,1990,98023,47.308,122.39,2570,10377,25,0,5.5,5310,13117
3.27e+05,2014,277,3,3,1370,1001,3,0,0,3,8,1370,0,2009,2009,98133,47.73,122.36,1399,1151,5,0,6,2769,2521
1.575e+05,2014,148,2,1,740,9003,1,0,0,3,5,740,0,1949,1949,98031,47.422,122.2,1230,8050,65,0,3,1970,8790
7.18e+05,2015,475,5,3,3070,9804,1,0,0,4,9,1740,1330,1968,1968,98006,47.57,122.13,2550,9689,47,0,8,5620,12759
4.5e+05,2015,474,2,1,810,4368,1,0,0,3,6,810,0,1958,1958,98115,47.691,122.31,1890,5253,57,0,3,2700,6063
5.32e+05,2015,458,3,1,1820,5750,1,0,0,3,7,1120,700,1918,1918,98116,47.577,122.38,1500,5750,97,0,4,3320,7570
4.62e+05,2014,209,5,1.75,2840,10220,1,0,0,4,7,2210,630,1954,1954,98177,47.764,122.36,2000,9750,60,0,6.75,4840,12590
3.0695e+05,2014,279,1,1,730,5005,1,0,0,4,5,730,0,1945,1945,98117,47.699,122.36,1630,5667,69,0,2,2360,6397
2.86e+05,2014,251,4,2.5,1820,7930,2,0,0,5,7,1820,0,1989,1989,98038,47.359,122.05,1490,7930,25,0,6.5,3310,9750
4.075e+05,2014,122,3,2.5,1930,10460,2,0,0,3,8,1930,0,1996,1996,98059,47.494,122.16,2290,8228,18,0,5.5,4220,10158
9.2e+05,2014,266,4,2.5,3470,10045,2,0,0,3,10,3470,0,1993,1993,98027,47.554,122.09,4370,12359,21,0,6.5,7840,15829
5.8e+05,2015,430,3,2.25,2190,8188,2,0,0,3,8,1810,380,1978,1978,98052,47.688,122.11,2190,8374,37,0,5.25,4380,10564
2.55e+05,2014,334,3,1.5,1020,11410,1,0,0,3,7,1020,0,1959,1959,98059,47.481,122.16,1290,8400,55,0,4.5,2310,9420
2.55e+05,2014,280,3,2.75,1900,16117,1,0,0,4,7,1900,0,1958,1958,98001,47.314,122.28,1640,19166,56,0,5.75,3540,21066
8.575e+05,2015,387,4,2.75,2960,5040,2,0,3,3,9,2210,750,1952,1993,98116,47.575,122.41,2270,5500,63,1,6.75,5230,8460
3.92e+05,2015,443,4,2.5,2130,4000,2,0,0,3,8,2130,0,2014,2014,98146,47.511,122.36,1830,7217,1,0,6.5,3960,9347
5.66e+05,2015,438,3,2.5,2090,6294,2,0,0,3,9,2090,0,2004,2004,98052,47.686,122.09,2520,5735,11,0,5.5,4610,7825
3.13e+05,2014,298,2,1,1180,4900,1,0,0,5,6,1180,0,1954,1954,98027,47.532,122.03,1650,7121,60,0,3,2830,8301
5.47e+05,2015,407,2,1,1370,10038,1,0,0,4,7,1370,0,1922,1922,98133,47.719,122.34,1610,8822,93,0,3,2980,10192
7.16e+05,2014,204,3,2.5,2270,7866,1,0,0,4,10,2270,0,1988,1988,98029,47.562,122.02,2580,8132,26,0,5.5,4850,10402
6.2e+05,2015,431,5,1.75,2000,8713,1,0,2,3,7,1000,1000,1962,1962,98008,47.588,122.12,2040,8449,53,0,6.75,4040,10449
2.465e+05,2014,175,3,2.5,1620,7686,2,0,0,3,7,1620,0,1989,1989,98038,47.361,122.05,1370,7686,25,0,5.5,2990,9306
1.974e+05,2015,459,3,2,1610,7575,1,0,0,4,7,1110,500,1965,1965,98003,47.334,122.3,1920,8400,50,0,5,3530,10010
2.62e+05,2015,372,4,1.5,1840,9009,2,0,0,3,7,1840,0,1965,1965,98198,47.406,122.32,1390,8025,50,0,5.5,3230,9865
3.2995e+05,2015,466,4,1,2050,7590,1,0,0,3,7,1280,770,1957,1957,98178,47.492,122.22,2050,7800,58,0,5,4100,9850
2.09e+05,2014,361,2,1,1070,6120,1,0,0,3,6,1070,0,1962,1962,98168,47.499,122.32,1130,6120,52,0,3,2200,7190
4.75e+05,2014,248,3,2.5,1690,2890,2,0,0,3,7,1690,0,2004,2004,98053,47.68,122.03,1690,2730,10,0,5.5,3380,4420
6.01e+05,2015,445,3,1.75,1330,6743,1,0,0,3,8,1330,0,1958,2002,98125,47.701,122.29,2600,7350,57,1,4.75,3930,8680
3.04e+05,2014,166,4,2,1810,8750,1,0,0,2,7,1110,700,1967,1967,98058,47.431,122.17,1810,8750,47,0,6,3620,10560
3.5995e+05,2014,307,3,2.5,2210,6280,2,0,0,3,8,2210,0,2003,2003,98038,47.35,122.04,2250,5972,11,0,5.5,4460,8182
4.25e+05,2015,473,4,1.75,1820,6000,1,0,0,3,7,930,890,1942,1942,98115,47.687,122.3,1590,6000,73,0,5.75,3410,7820
2.23e+05,2014,326,3,2,1670,6824,1,0,0,3,7,1300,370,1990,1990,98042,47.367,122.08,1660,7586,24,0,5,3330,9256
4.95e+05,2014,162,3,2,1769,9300,1,0,0,4,7,1769,0,1955,2009,98166,47.441,122.34,1870,10226,59,1,5,3639,11995
5.7e+05,2014,287,2,1,1100,6240,1,0,0,4,7,1100,0,1941,1941,98199,47.645,122.4,1250,6240,73,0,3,2350,7340
4.29e+05,2014,229,3,2,1700,52826,1,0,0,3,7,1700,0,1991,1991,98058,47.416,122.09,2480,1.1473e+05,23,0,5,4180,1.1643e+05
1.1075e+06,2014,285,4,3.5,3660,4760,2,0,0,3,9,2840,820,2014,2014,98199,47.648,122.41,3210,4640,0,0,7.5,6870,8300
6.19e+05,2014,155,4,1.75,1660,3800,1,0,0,3,7,1660,0,1926,1926,98115,47.688,122.31,1660,3767,88,0,5.75,3320,5427
4.1e+05,2015,407,2,1,1560,10125,1,0,0,4,7,1130,430,1954,1954,98155,47.749,122.3,1680,10125,61,0,3,3240,11685
5.45e+05,2015,452,2,1.5,2340,13380,1,0,0,4,7,1280,1060,1954,1954,98146,47.502,122.38,1490,8100,61,0,3.5,3830,10440
3.15e+05,2014,263,4,2.5,2740,8400,1,0,2,3,8,2740,0,1993,1993,98022,47.195,122.01,2030,8638,21,0,6.5,4770,11378
1.1813e+05,2014,256,2,1,790,7153,1,0,0,4,6,790,0,1944,1944,98168,47.487,122.32,810,7128,70,0,3,1600,7918
5.55e+05,2015,450,4,2.5,2160,10987,1,0,0,4,8,1440,720,1981,2003,98074,47.633,122.03,1280,11617,34,1,6.5,3440,13777
8.95e+05,2015,456,5,2.5,2350,14197,1,0,0,4,8,1220,1130,1962,1962,98004,47.6,122.2,2470,11629,53,0,7.5,4820,13979
8.9388e+05,2015,463,6,2.5,2820,8600,1,0,0,5,8,1430,1390,1967,1967,98006,47.565,122.14,2070,8900,48,0,8.5,4890,11720
3.4e+05,2015,374,3,1,1580,8308,1,0,0,3,7,1580,0,1948,1948,98146,47.508,122.38,1200,8308,67,0,4,2780,9888
5.48e+05,2015,451,4,1.75,1690,7794,1,0,0,3,7,1090,600,1968,1968,98033,47.689,122.2,1380,7325,47,0,5.75,3070,9015
2.748e+05,2015,467,3,1.75,1410,1988,2,0,0,3,8,1410,0,2014,2014,98106,47.517,122.35,1410,1899,1,0,4.75,2820,3309
5.25e+05,2014,176,4,2.75,3030,6625,2,0,0,3,8,3030,0,2011,2011,98059,47.481,122.15,3030,9620,3,0,6.75,6060,12650
4.53e+05,2014,317,2,1.5,1160,1269,2,0,0,3,7,970,190,2005,2005,98103,47.661,122.33,1700,3150,9,0,3.5,2860,4310
5.37e+05,2015,366,3,1.75,1550,10050,1,0,0,5,7,1550,0,1957,1957,98008,47.635,122.12,1720,10050,58,0,4.75,3270,11600
5e+05,2014,262,3,1.75,1530,14633,1,0,0,3,7,1100,430,1977,1977,98052,47.695,122.12,1780,8100,37,0,4.75,3310,9630
6.615e+05,2014,177,5,2.5,2500,7200,1,0,0,4,7,1490,1010,1977,1977,98052,47.696,122.12,1960,8325,37,0,7.5,4460,10825
3.95e+05,2014,269,4,2.5,2130,11733,1,0,0,5,7,1330,800,1969,1969,98059,47.512,122.16,1800,9131,45,0,6.5,3930,11261
2.94e+05,2015,373,3,3,1670,4120,1,0,0,3,7,1140,530,1929,2012,98055,47.488,122.2,1010,4120,86,1,6,2680,5790
5.635e+05,2014,175,3,2.5,1400,1312,3,0,0,3,8,1400,0,2007,2007,98103,47.653,122.36,1350,1312,7,0,5.5,2750,2712
3.19e+05,2014,336,4,2.25,2390,7350,2,0,0,3,8,2390,0,1990,1990,98023,47.294,122.35,2390,7350,24,0,6.25,4780,9740
6.6e+05,2014,235,3,3,2260,1825,2,0,0,3,8,1660,600,2002,2002,98122,47.611,122.31,2260,1834,12,0,6,4520,4094
9.98e+05,2014,236,5,4.5,4130,10404,2,0,0,3,10,4130,0,2004,2004,98029,47.556,122.03,3890,11531,10,0,9.5,8020,15661
4.765e+05,2015,477,3,1,1200,6120,1,0,0,4,7,950,250,1945,1945,98115,47.693,122.29,1550,6120,70,0,4,2750,7320
8.5e+05,2014,345,2,2.75,2700,9854,1,0,0,3,9,2700,0,2012,2012,98053,47.719,122.02,1440,4168,2,0,4.75,4140,6868
2.49e+05,2014,230,3,1.5,1580,7200,1,0,0,4,7,1080,500,1976,1976,98092,47.276,122.15,1580,7470,38,0,4.5,3160,9050
5.6e+05,2014,304,3,2.25,2060,31400,2,0,0,3,8,2060,0,1984,1984,98074,47.622,122.06,2160,34500,30,0,5.25,4220,36560
8.89e+05,2014,224,4,3.5,3210,5000,3,0,0,3,9,3210,0,2014,2014,98136,47.52,122.39,1360,5000,0,0,7.5,4570,8210
7.75e+05,2014,263,4,3.5,3060,4573,2,0,0,3,9,2410,650,2012,2012,98029,47.552,122,3170,3634,2,0,7.5,6230,6694
3.28e+05,2014,335,2,2.25,1550,2079,2,0,0,3,8,1550,0,2008,2008,98106,47.54,122.37,1420,1977,6,0,4.25,2970,3527
3.4e+05,2015,417,4,1,1230,8316,1,0,0,3,7,1230,0,1963,1963,98034,47.727,122.24,1490,8316,52,0,5,2720,9546
3.6e+05,2014,340,4,2.5,2750,6259,2,0,0,3,9,2750,0,2002,2002,98092,47.33,122.18,2810,6824,12,0,6.5,5560,9574
5.525e+05,2015,425,3,1.75,2040,5775,1,0,0,3,7,1410,630,1958,1958,98199,47.659,122.39,1360,4400,57,0,4.75,3400,6440
1.229e+06,2014,175,4,3.5,3770,37034,2,0,0,3,10,2830,940,1989,1989,98007,47.646,122.15,3200,36342,25,0,7.5,6970,40112
4.05e+05,2014,334,3,2,1450,6081,1,0,0,4,7,1450,0,1969,1969,98155,47.752,122.28,1880,6000,45,0,5,3330,7450
8.4e+05,2015,464,4,3.25,3160,6327,2,0,0,3,9,2280,880,2004,2004,98027,47.536,122.07,3160,5946,11,0,7.25,6320,9106
3.3e+05,2015,450,3,1.75,1300,958,2,0,0,3,7,840,460,2011,2011,98108,47.568,122.31,1340,1254,4,0,4.75,2640,2554
4.46e+05,2014,136,4,2.25,2270,7800,1,0,0,3,7,1290,980,1977,1977,98034,47.728,122.19,1480,7280,37,0,6.25,3750,9550
4.5845e+05,2014,338,4,1,1330,9715,1,0,0,4,7,970,360,1957,1957,98008,47.604,122.12,1590,8400,57,0,5,2920,9730
3.9995e+05,2015,473,2,0.75,1330,2856,1,0,0,4,7,930,400,1916,1916,98126,47.567,122.37,1330,2856,99,0,2.75,2660,4186
3.35e+05,2014,166,3,1.5,2040,6000,1,0,0,3,7,1340,700,1957,1957,98118,47.522,122.29,1190,6000,57,0,4.5,3230,8040
5.25e+05,2014,154,3,2,1540,7800,1,0,0,3,8,1540,0,2004,2004,98125,47.704,122.29,1510,7800,10,0,5,3050,9340
3.65e+05,2015,424,3,2.25,2290,7350,2,0,0,3,8,2290,0,1988,1988,98058,47.429,122.16,2170,7529,27,0,5.25,4460,9819
1.0008e+06,2015,458,3,2.75,3070,10739,2,0,0,3,10,2440,630,1987,1987,98004,47.644,122.19,3490,11913,28,0,5.75,6560,14983
7.7e+05,2014,175,4,2.5,3920,12415,2,0,0,3,10,3920,0,1997,1997,98075,47.566,122.03,3639,12805,17,0,6.5,7559,16725
1.35e+06,2015,388,4,4.5,3420,7440,3,0,0,3,9,3420,0,2014,2014,98103,47.688,122.33,1360,5580,1,0,8.5,4780,9000
1.325e+06,2014,170,4,2.25,2870,6280,1,0,0,4,9,1980,890,1905,1905,98112,47.633,122.31,2370,4760,109,0,6.25,5240,7630
2.999e+05,2015,396,2,1,810,6150,1,0,0,3,7,810,0,1950,1950,98133,47.729,122.34,1080,7200,65,0,3,1890,8010
7.3235e+05,2014,305,4,2.5,2270,7665,2,0,0,3,9,2270,0,1986,1986,98052,47.661,122.15,2450,8706,28,0,6.5,4720,10976
8.135e+05,2014,203,4,2,2530,15520,1,0,0,5,8,2220,310,1964,1964,98005,47.613,122.17,2500,13300,50,0,6,5030,15830
2.25e+05,2014,341,4,2,1750,7245,1,0,0,4,7,1050,700,1974,1974,98092,47.316,122.2,1640,7245,40,0,6,3390,8995
2.5e+05,2014,236,3,2.5,2070,8400,2,0,0,4,8,2070,0,1990,1990,98002,47.31,122.21,2070,9239,24,0,5.5,4140,11309
3.9495e+05,2014,203,3,2.5,1090,7700,1,0,0,4,7,1090,0,1957,1957,98008,47.607,122.12,1740,7700,57,0,5.5,2830,8790
6.3e+05,2014,122,4,2.75,2710,37277,2,0,0,3,9,2710,0,2000,2000,98027,47.463,121.99,2390,39299,14,0,6.75,5100,42009
1.805e+05,2014,285,3,2.5,1800,8518,2,0,0,3,7,1800,0,1996,1996,98030,47.364,122.19,1770,7570,18,0,5.5,3570,9370
4.5e+05,2014,169,3,1.75,1610,11200,1,0,0,3,7,1610,0,1955,1955,98033,47.664,122.18,1610,11200,59,0,4.75,3220,12810
1.725e+05,2015,474,2,2,1510,20685,1,0,0,2,6,1250,260,1958,1958,98059,47.481,122.12,1490,29527,57,0,4,3000,31037
3.2e+05,2014,313,6,2.75,2410,10763,1,0,0,5,7,1310,1100,1957,1957,98188,47.443,122.28,1310,10746,57,0,8.75,3720,13156
7.3e+05,2015,362,6,2.25,2660,13579,2,0,0,3,7,2660,0,1937,1990,98125,47.714,122.29,1120,8242,78,1,8.25,3780,10902
4.64e+05,2015,486,2,2,1230,4800,2,0,0,3,7,1230,0,1952,2004,98133,47.715,122.35,1560,7200,63,1,4,2790,8430
4e+05,2014,153,3,2.25,1450,4706,2,0,0,3,7,1450,0,2009,2009,98028,47.761,122.23,1490,4667,5,0,5.25,2940,6117
2.8e+05,2014,292,3,2.25,1358,1141,3,0,0,3,7,1358,0,2007,2007,98133,47.705,122.35,1358,1196,7,0,5.25,2716,2554
6.57e+05,2014,142,4,1.75,2740,8520,1,0,2,3,8,1370,1370,1954,1954,98118,47.544,122.26,2740,9286,60,0,5.75,5480,12026
3.975e+05,2014,217,4,1.75,2220,4760,1,0,0,3,7,1320,900,1918,1918,98106,47.522,122.35,940,4760,96,0,5.75,3160,6980
6.895e+05,2015,478,4,2.5,2050,2772,2,0,0,3,8,2050,0,2013,2013,98029,47.543,122.01,1800,2886,2,0,6.5,3850,4936
2.09e+05,2015,488,2,1,840,5265,1,0,0,5,6,840,0,1969,1969,98042,47.364,122.08,920,5100,46,0,3,1760,5940
4.425e+05,2014,287,3,2.5,1690,3129,2,0,0,3,7,1690,0,2002,2002,98053,47.688,122.04,1690,3129,12,0,5.5,3380,4819
2.683e+05,2015,438,3,1,1190,9000,1,0,0,3,7,1190,0,1968,1968,98028,47.77,122.26,1960,7200,47,0,4,3150,8390
5.65e+05,2014,301,4,2.5,2620,10016,2,0,0,3,8,2620,0,1996,1996,98056,47.529,122.18,2620,10016,18,0,6.5,5240,12636
8.5351e+05,2014,252,3,2.5,2820,14890,1,0,4,3,9,1770,1050,1985,1985,98034,47.702,122.23,3740,14890,29,0,5.5,6560,17710
3.29e+05,2015,403,3,1,1200,5650,1,0,0,3,7,1200,0,1928,1928,98178,47.507,122.25,1610,5650,87,0,4,2810,6850
1.325e+06,2014,221,4,3.25,2850,4800,2,0,0,5,10,2700,150,1905,1905,98112,47.629,122.31,2850,4800,109,0,7.25,5700,7650
4.45e+05,2014,224,3,2.5,1550,930,2,0,0,3,8,1060,490,2006,2006,98144,47.586,122.31,1550,1301,8,0,5.5,3100,2851
1.905e+05,2014,222,3,2,1390,10155,1,0,0,3,7,1130,260,1980,1980,98003,47.258,122.31,1790,10155,34,0,5,3180,11545
3.44e+05,2015,430,3,1,1150,12402,1,0,0,4,6,1150,0,1969,1969,98072,47.742,122.1,1400,13600,46,0,4,2550,14750
2.9e+05,2014,235,3,1.5,1310,8100,1,0,0,3,7,1310,0,1965,1965,98034,47.733,122.2,1330,8100,49,0,4.5,2640,9410
4.52e+05,2014,215,3,2.25,2600,14810,1,0,2,4,8,1490,1110,1956,1956,98166,47.433,122.34,2450,16715,58,0,5.25,5050,19315
4.4373e+05,2014,229,3,1.75,1250,3880,1,0,0,4,7,750,500,1944,1944,98117,47.687,122.39,1240,3880,70,0,4.75,2490,5130
6.305e+05,2014,286,3,1,1180,3600,1,0,0,3,7,1180,0,1926,1926,98112,47.634,122.28,1900,3600,88,0,4,3080,4780
1.308e+06,2014,249,5,2.5,3200,7863,1,0,3,5,8,1600,1600,1959,1959,98199,47.64,122.39,2640,7680,55,0,7.5,5840,10880
3.965e+05,2014,222,3,1.5,1360,1488,2,0,0,3,7,1120,240,2003,2003,98199,47.653,122.38,1360,1573,11,0,4.5,2720,2933
2.95e+05,2015,437,2,2,1590,8000,1,0,0,3,7,910,680,1984,1984,98055,47.459,122.2,1590,8364,31,0,4,3180,9954
2.75e+05,2014,232,4,2.75,2060,7350,1,0,0,3,7,1210,850,1978,1978,98001,47.342,122.28,1940,7420,36,0,6.75,4000,9480
5.95e+05,2014,205,3,3.25,3130,28001,1,0,0,3,9,2210,920,1985,1985,98072,47.774,122.12,2710,34999,29,0,6.25,5840,38129
6.45e+05,2014,237,2,1.5,1995,1.1567e+05,1,0,1,4,8,1995,0,1991,1991,98070,47.402,122.46,2142,29375,23,0,3.5,4137,31370
3.5e+05,2014,133,3,2.5,2010,14298,2,0,0,3,7,2010,0,1977,1977,98070,47.507,122.47,2010,14298,37,0,5.5,4020,16308
3.09e+05,2014,237,3,2.5,1780,7859,2,0,0,3,7,1780,0,1988,1988,98038,47.377,122.05,1670,6618,26,0,5.5,3450,8398
1.249e+06,2015,464,5,3.25,3950,44431,1,0,0,3,10,2100,1850,1969,1969,98005,47.645,122.17,3860,45870,46,0,8.25,7810,49820
2.7e+05,2015,387,3,2,1350,6696,1,0,0,5,6,680,670,1944,1944,98056,47.492,122.19,1350,6700,71,0,5,2700,8050
2.35e+05,2014,235,3,1,1210,6000,1,0,0,3,7,1210,0,1930,1930,98178,47.498,122.22,1210,6000,84,0,4,2420,7210
3.1e+05,2014,272,3,2,1290,6150,1,0,1,5,6,1290,0,1950,1950,98118,47.518,122.26,1960,6150,64,0,5,3250,7440
3.7e+05,2014,286,3,2.5,2490,18525,2,0,3,3,8,2490,0,1995,1995,98022,47.212,122,1850,9516,19,0,5.5,4340,12006
7.8e+05,2014,204,3,2.75,1970,2600,2,0,0,3,8,1970,0,1924,1994,98103,47.663,122.33,1680,3120,90,1,5.75,3650,5090
3.35e+05,2014,197,3,3,1430,1249,3,0,0,3,8,1430,0,2003,2003,98103,47.697,122.34,1020,1112,11,0,6,2450,2542
3.981e+05,2015,473,3,2.5,2370,5321,2,0,0,3,8,2370,0,2014,2014,98038,47.37,122.02,2370,4357,1,0,5.5,4740,6727
5.84e+05,2014,278,3,2.5,1790,3962,2,0,0,3,8,1790,0,1992,1992,98117,47.689,122.39,1340,3960,22,0,5.5,3130,5750
3.5e+05,2015,380,3,2.25,1580,47916,1,0,0,3,7,1580,0,1979,1979,98024,47.558,121.85,1980,75358,36,0,5.25,3560,76938
1.9999e+05,2014,187,3,1,1100,8560,1,0,0,3,6,1100,0,1961,1961,98023,47.329,122.34,1120,8470,53,0,4,2220,9570
2.73e+05,2015,470,2,2,1384,1822,2,0,0,3,7,1384,0,1990,1990,98028,47.752,122.24,1078,1315,25,0,4,2462,2699
5.625e+05,2014,263,5,2.75,2920,6327,2,0,0,3,8,2920,0,2007,2007,98059,47.493,122.14,2520,5026,7,0,7.75,5440,7946
7.3e+05,2014,301,4,1,1870,4992,1,0,0,4,7,1670,200,1940,1940,98199,47.644,122.4,2160,5239,74,0,5,4030,7109
2.39e+05,2014,304,4,2,1980,10585,1,0,0,2,6,1980,0,1924,1924,98055,47.484,122.21,1360,7810,90,0,6,3340,9790
4.2e+05,2015,437,3,1,1060,6000,1,0,0,3,8,1060,0,1954,1954,98118,47.543,122.28,1240,7874,61,0,4,2300,8934
6.75e+05,2015,425,4,2.5,1770,9858,1,0,2,3,8,1770,0,1971,1971,98155,47.738,122.29,2470,9858,44,0,6.5,4240,11628
2.457e+05,2014,175,3,2.25,1640,8400,1,0,0,3,8,1180,460,1968,1968,98032,47.373,122.29,1600,8120,46,0,5.25,3240,9760
4.395e+05,2014,253,4,1,1360,5500,1,0,0,3,7,1360,0,1950,1950,98115,47.688,122.28,1530,5790,64,0,5,2890,7150
6.2e+05,2014,262,4,2.5,2500,8282,2,0,0,3,9,2500,0,2013,2013,98056,47.513,122.17,2500,8046,1,0,6.5,5000,10546
4.55e+05,2014,345,4,2,2120,9442,1,0,0,5,7,1060,1060,1968,1968,98011,47.767,122.23,1290,9600,46,0,6,3410,11720
5.55e+05,2014,306,2,1,1550,4600,1,0,0,4,7,1050,500,1941,1941,98117,47.686,122.38,1550,4600,73,0,3,3100,6150
6.7e+05,2014,216,4,2.75,3020,13530,1,0,0,4,8,1540,1480,1977,1977,98052,47.63,122.1,2230,11896,37,0,6.75,5250,14916
2.3e+05,2015,368,4,1,1870,14703,1,0,0,3,6,1090,780,1928,1928,98118,47.527,122.28,1650,6045,87,0,5,3520,7915
3.34e+05,2015,438,2,1.75,1680,8367,1,0,0,3,6,840,840,1914,1914,98115,47.698,122.29,1830,6720,101,0,3.75,3510,8400
6.16e+05,2015,477,3,3.25,2130,2306,2,0,1,5,7,1420,710,1924,1924,98136,47.542,122.39,1560,4500,91,0,6.25,3690,6630
9.72e+05,2014,180,4,1.75,2010,6300,1,0,2,5,8,1610,400,1937,1937,98199,47.646,122.41,3290,6300,77,0,5.75,5300,8310
1e+06,2014,235,4,3.25,3320,8587,3,0,0,3,11,2950,370,2008,2008,98103,47.691,122.34,1860,5668,6,0,7.25,5180,8988
1.075e+06,2014,155,5,4.75,5180,17811,2,0,2,3,11,4070,1110,2001,2001,98065,47.541,121.87,3960,15103,13,0,9.75,9140,20283
5.54e+05,2014,159,3,1.75,1760,10780,1,0,0,3,8,1760,0,1977,1977,98005,47.594,122.15,2090,10780,37,0,4.75,3850,12540
7.4e+05,2014,317,4,2.75,2560,6900,1,0,0,3,8,1480,1080,1959,1959,98115,47.686,122.3,2600,7200,55,0,6.75,5160,9760
1.795e+06,2014,160,5,3.25,5270,17232,2,0,1,3,10,4010,1260,1977,2003,98040,47.554,122.23,3550,13917,37,1,8.25,8820,19187
1.859e+05,2015,390,3,1,940,10890,1,0,0,4,5,940,0,1909,1909,98001,47.276,122.26,1370,10255,106,0,4,2310,11195
4.5e+05,2014,307,3,2.5,1990,3478,2,0,0,3,10,1520,470,1990,1990,98199,47.636,122.4,1710,6157,24,0,5.5,3700,8147
4.48e+05,2015,446,2,2,1670,7772,1,0,0,4,6,860,810,1919,1919,98126,47.546,122.38,1300,7770,96,0,4,2970,9440
9.5e+05,2014,324,4,1.75,2210,19025,1,0,0,4,7,1460,750,1952,1952,98004,47.593,122.2,2640,14999,62,0,5.75,4850,17209
1.104e+06,2015,382,4,3.5,2760,5040,2,0,2,3,9,2760,0,1955,2005,98117,47.676,122.4,2370,5760,60,1,7.5,5130,8520
4.055e+05,2014,183,2,2.75,1350,1252,2,0,0,3,8,1120,230,2006,2006,98136,47.522,122.39,1410,1265,8,0,4.75,2760,2615
2.8575e+05,2015,462,3,2.25,1960,17126,1,0,0,3,8,1400,560,1966,1966,98055,47.444,122.21,2060,11466,49,0,5.25,4020,13426
5.1999e+05,2015,380,4,3.25,1690,1321,2,0,0,3,8,1320,370,2014,2014,98052,47.678,122.12,3080,4558,1,0,7.25,4770,6248
3.43e+05,2014,248,3,1,1120,7250,1,0,0,4,7,1120,0,1972,1972,98034,47.714,122.21,1340,7302,42,0,4,2460,8422
8.9e+05,2015,479,4,2.25,2870,8393,1,0,0,4,8,1480,1390,1977,1977,98040,47.579,122.25,2930,9850,38,0,6.25,5800,12720
9.25e+05,2014,148,3,2.5,2690,7000,2,0,0,5,7,1840,850,1943,1943,98115,47.678,122.28,1800,6435,71,0,5.5,4490,9125
5.7e+05,2014,168,4,2.5,2290,6738,2,0,0,3,8,2290,0,1996,1996,98029,47.571,122,2100,6261,18,0,6.5,4390,8551
5.65e+05,2014,149,4,2.5,2440,22594,2,0,0,3,8,2440,0,1996,1996,98053,47.633,121.97,2560,33341,18,0,6.5,5000,35781
5.83e+05,2015,375,4,2.5,3390,10519,2,0,2,3,10,3390,0,1990,1990,98003,47.332,122.33,2830,10519,25,0,6.5,6220,13909
2.9495e+05,2015,431,2,1,1060,7868,1,0,0,3,7,1060,0,1952,1952,98155,47.741,122.3,1530,10728,63,0,3,2590,11788
2.6995e+05,2014,232,3,2.25,1660,7003,2,0,0,3,7,1660,0,1996,1996,98030,47.36,122.19,1840,6680,18,0,5.25,3500,8340
5.099e+05,2014,187,3,2.5,3030,9053,2,0,0,3,8,3030,0,2009,2009,98059,47.495,122.15,3010,6026,5,0,5.5,6040,9056
4.85e+05,2015,447,4,2.25,1850,9911,1,0,0,4,7,1850,0,1957,1957,98008,47.602,122.12,1650,8670,58,0,6.25,3500,10520
2.65e+05,2014,180,2,2,1860,10856,1,0,0,3,8,1260,600,1952,1952,98178,47.499,122.27,1250,10008,62,0,4,3110,11868
5.7595e+05,2014,340,3,2.25,1640,12000,1,0,0,3,7,1180,460,1967,1967,98008,47.625,122.1,1620,12000,47,0,5.25,3260,13640
8.05e+05,2015,479,4,2.25,2440,9889,1,0,0,3,7,1540,900,1952,1952,98115,47.693,122.3,1710,6284,63,0,6.25,4150,8724
5.26e+05,2014,127,2,2,1550,2400,1,0,0,4,7,1550,0,1900,1900,98103,47.654,122.35,1180,1224,114,0,4,2730,2774
3.44e+05,2014,299,4,2.5,2100,8501,2,0,0,5,7,2100,0,1993,1993,98022,47.195,122.01,2130,8560,21,0,6.5,4230,10660
9.7e+05,2014,292,5,3.5,3400,9804,2,0,0,3,9,2550,850,2008,2008,98118,47.543,122.27,2380,7440,6,0,8.5,5780,10840
3.75e+05,2014,266,3,2.5,1580,3825,2,0,0,3,8,1580,0,2011,2011,98126,47.546,122.37,1380,1500,3,0,5.5,2960,3080
2.84e+05,2015,425,3,1.75,1320,35100,1,0,0,3,7,1320,0,1990,1990,98092,47.312,122.13,1660,35100,25,0,4.75,2980,36420
4.8725e+05,2014,139,4,2,1690,3250,1,0,0,3,7,1550,140,1901,1901,98103,47.664,122.35,1620,3250,113,0,6,3310,4940
6.3e+05,2015,373,3,1.75,1540,6930,1,0,0,3,7,1250,290,1944,1944,98115,47.678,122.28,1760,6930,71,0,4.75,3300,8470
1.529e+05,2015,444,1,1,900,4368,1,0,0,5,6,900,0,1915,1950,98022,47.211,121.99,1290,5000,100,1,2,2190,5900
6.15e+05,2014,262,4,2.25,2330,7020,1,0,0,4,8,1450,880,1973,1973,98006,47.562,122.14,2330,8500,41,0,6.25,4660,10830
5.8e+05,2014,270,3,2.5,1620,1171,3,0,4,3,8,1470,150,2008,2008,98103,47.668,122.36,1620,1505,6,0,5.5,3240,3125
2.615e+05,2014,201,3,2.5,1740,6992,2,0,0,3,7,1740,0,1990,1990,98042,47.357,122.16,1260,6825,24,0,5.5,3000,8565
3.79e+05,2015,491,4,1.75,2180,7876,1,0,0,4,7,1290,890,1977,1977,98056,47.516,122.19,1960,7225,38,0,5.75,4140,9405
3.3e+05,2014,169,3,2.5,2238,7209,2,0,0,3,8,2238,0,2011,2011,98023,47.297,122.35,2456,7212,3,0,5.5,4694,9450
4.8e+05,2014,331,3,1,1160,8800,1,0,0,4,7,1160,0,1959,1959,98008,47.611,122.13,1750,8400,55,0,4,2910,9560
1.9999e+05,2014,324,2,1,860,5000,1,0,0,3,7,860,0,1949,1949,98178,47.501,122.27,1130,6000,65,0,3,1990,6860
6.71e+05,2014,185,4,3,3130,5700,1,0,0,3,7,1750,1380,1953,1953,98115,47.681,122.28,2080,5700,61,0,7,5210,8830
5e+05,2015,452,4,2.75,2260,7209,1,0,3,3,7,1330,930,2002,2002,98125,47.709,122.3,1790,10860,13,0,6.75,4050,13120
7.25e+05,2014,211,3,1.75,1880,13300,1,0,0,3,7,1380,500,1967,1967,98004,47.634,122.2,3550,10883,47,0,4.75,5430,12763
3.215e+05,2014,297,4,2.5,2620,5457,2,0,0,3,8,2620,0,2003,2003,98001,47.315,122.27,2740,5816,11,0,6.5,5360,8436
1.52e+06,2014,331,6,3.5,3720,11690,2,0,0,3,10,3720,0,2003,2003,98040,47.57,122.23,3030,11686,11,0,9.5,6750,15406
5e+05,2015,457,3,1.5,1330,1265,2,0,0,3,8,1140,190,2008,2008,98116,47.577,122.41,1330,1264,7,0,4.5,2660,2594
4.595e+05,2014,235,2,1.5,1170,1079,3,0,0,3,7,1170,0,2003,2003,98103,47.661,122.33,1170,1116,11,0,3.5,2340,2286
5.26e+05,2015,445,3,2.25,2000,18099,1,0,0,4,8,1250,750,1978,1978,98006,47.544,122.18,2060,12000,37,0,5.25,4060,14000
4.45e+05,2015,479,3,1.5,860,3200,1,0,0,3,6,860,0,1929,1929,98117,47.679,122.36,1220,4300,86,0,4.5,2080,5160
3.7e+05,2015,479,2,1,750,2020,1,0,0,3,7,750,0,1908,1995,98122,47.617,122.3,1630,2383,107,1,3,2380,3133
9.98e+05,2014,174,4,2.25,2420,10200,2,0,0,4,9,2420,0,1973,1973,98040,47.534,122.22,2390,10200,41,0,6.25,4810,12620
5.3e+05,2015,459,4,2.5,2950,4836,2,0,0,3,7,2950,0,2006,2006,98059,47.479,122.13,2120,4750,9,0,6.5,5070,7700
2.25e+05,2015,486,5,1.5,1790,11656,2,0,0,3,7,1790,0,1963,1963,98198,47.396,122.31,2040,9790,52,0,6.5,3830,11580
2.22e+05,2014,231,3,2,1200,6074,1,0,0,3,7,1200,0,1968,1968,98002,47.325,122.2,1430,6338,46,0,5,2630,7538
5.87e+05,2014,197,5,3.5,3610,52595,2,0,0,4,7,3610,0,1989,1989,98014,47.683,121.91,1620,60112,25,0,8.5,5230,63722
2.5e+05,2015,485,3,2.5,1730,7200,2,0,0,4,7,1730,0,1985,1985,98031,47.403,122.2,1770,7396,30,0,5.5,3500,9126
3.15e+05,2015,386,3,1,1900,14400,1,0,0,4,7,1300,600,1954,1954,98166,47.415,122.34,1940,14400,61,0,4,3840,16300
2.517e+05,2014,245,3,2.25,1810,11800,1,0,0,3,7,1240,570,1977,1977,98178,47.5,122.23,1810,5641,37,0,5.25,3620,7451
3.575e+05,2015,374,3,1,1450,8100,1,0,0,3,6,1450,0,1952,1952,98125,47.703,122.29,1450,7800,63,0,4,2900,9250
4.6e+05,2014,297,3,1.75,1660,9900,2,0,0,3,8,1660,0,1978,1978,98033,47.67,122.18,1720,6600,36,0,4.75,3380,8260
2.868e+05,2014,167,3,2.5,1413,3600,2,0,0,3,8,1413,0,2011,2011,98031,47.422,122.19,2150,3869,3,0,5.5,3563,5282
2.5e+05,2014,290,3,1.75,1480,3900,1,0,0,4,7,1480,0,1980,1980,98023,47.298,122.37,1830,6956,34,0,4.75,3310,8436
7.26e+05,2014,228,3,2.5,2040,10033,1,0,0,4,8,1420,620,1974,1974,98005,47.638,122.17,2260,10115,40,0,5.5,4300,12155
4.01e+05,2014,276,3,1.5,1470,6867,1,0,0,3,8,1470,0,1955,1955,98155,47.749,122.33,1470,6523,59,0,4.5,2940,7993
8.041e+05,2014,175,4,2.5,3070,8086,2,0,0,3,10,3070,0,2005,2005,98059,47.54,122.16,3320,10738,9,0,6.5,6390,13808
2.05e+05,2015,431,3,1,1120,8342,1,0,0,4,7,1120,0,1976,1976,98042,47.373,122.12,1190,6660,39,0,4,2310,7780
4.88e+05,2014,138,2,2,1360,4688,1,0,0,3,7,780,580,1944,1944,98115,47.687,122.31,1340,4750,70,0,4,2700,6110
2.2995e+05,2014,235,3,1.75,1900,8910,2,0,0,4,7,1900,0,1988,1988,98092,47.277,122.14,1610,8586,26,0,4.75,3510,10486
6.5e+05,2014,326,3,2.75,1540,1251,2,0,0,3,8,1230,310,2002,2002,98102,47.63,122.32,1540,1287,12,0,5.75,3080,2827
8.4e+05,2015,467,4,2.5,2360,9600,1,0,2,3,8,1630,730,1973,1973,98040,47.589,122.25,2140,6300,42,0,6.5,4500,8660
4.42e+05,2014,214,4,1.5,1360,6110,1,0,0,3,7,1010,350,1955,1955,98116,47.575,122.4,1520,6110,59,0,5.5,2880,7470
8.125e+05,2014,249,4,2.5,2750,10159,2,0,0,3,10,2750,0,1991,1991,98006,47.543,122.14,3160,10159,23,0,6.5,5910,12909
3.87e+05,2014,129,3,2.25,1445,1606,2,0,0,3,7,1300,145,2003,2003,98027,47.535,122.07,1410,1286,11,0,5.25,2855,2731
7.175e+05,2014,334,3,1,2090,4000,1,0,2,3,8,1890,200,1931,1931,98199,47.639,122.39,2090,4000,83,0,4,4180,6090
7.29e+05,2015,457,4,2.5,2450,27081,2,0,0,3,8,2450,0,1985,1985,98052,47.718,122.1,2630,12025,30,0,6.5,5080,14475
3.089e+05,2014,161,3,2.5,2250,7294,2,0,0,3,8,2250,0,1994,1994,98092,47.264,122.21,2140,7363,20,0,5.5,4390,9613
9.4995e+05,2015,467,5,2.5,2340,1989,2,1,4,3,8,2340,0,1959,1959,98118,47.519,122.26,2200,3230,56,0,7.5,4540,5570
1.5e+06,2014,342,4,3.25,3860,7199,2,0,1,3,9,2870,990,2005,2005,98115,47.685,122.27,2940,9600,9,0,7.25,6800,13460
6.1e+05,2014,352,6,2.5,3610,12033,2,0,0,3,8,3210,400,1970,1970,98011,47.769,122.22,2210,8577,44,0,8.5,5820,12187
6.25e+05,2014,174,3,2.5,2410,64073,1,0,0,4,8,1820,590,1976,1976,98072,47.746,122.14,2980,48760,38,0,5.5,5390,51170
4.13e+05,2014,286,4,3.5,2380,5809,2,0,0,4,7,1750,630,1995,1995,98106,47.554,122.36,1620,5775,19,0,7.5,4000,8155
2.5e+05,2014,229,2,1,950,11835,1,0,0,3,5,950,0,1932,1932,98028,47.749,122.24,1690,12586,82,0,3,2640,13536
4.6e+05,2014,231,2,2.5,1830,8107,1,0,0,5,7,930,900,1946,1946,98125,47.701,122.31,1260,6960,68,0,4.5,3090,8790
5.29e+05,2015,478,2,2,1540,9714,2,0,0,3,8,1540,0,2008,2008,98177,47.763,122.36,1840,8179,7,0,4,3380,9719
1.84e+05,2014,125,3,1.75,1490,10125,1,0,0,4,7,1490,0,1962,1962,98001,47.307,122.28,2488,4981,52,0,4.75,3978,6471
6.575e+05,2014,142,3,2.5,2670,10496,2,0,0,3,9,2670,0,1989,1989,98074,47.627,122.03,2490,8636,25,0,5.5,5160,11306
2.9995e+05,2014,175,3,1.75,1790,7650,1,0,3,3,9,1790,0,1978,1978,98023,47.321,122.39,2540,7600,36,0,4.75,4330,9390
4.78e+05,2014,321,3,1.75,1210,6175,1,0,0,3,7,1210,0,1976,1976,98034,47.729,122.2,1520,7475,38,0,4.75,2730,8685
8e+05,2015,450,4,2.5,3100,7807,2,0,0,3,9,3100,0,2003,2003,98034,47.715,122.23,3100,7807,12,0,6.5,6200,10907
7e+05,2014,148,4,3.5,4490,5099,2,0,0,3,9,3390,1100,2006,2006,98065,47.539,121.86,4290,5537,8,0,7.5,8780,10027
4.25e+05,2014,250,4,2.5,2440,5088,2,0,0,3,7,2440,0,2007,2007,98065,47.541,121.89,2440,5762,7,0,6.5,4880,8202
5.33e+05,2014,126,5,2.75,1800,3780,1,0,0,3,7,1400,400,1926,1926,98103,47.683,122.34,1400,3780,88,0,7.75,3200,5580
4.1e+05,2014,291,3,1,1230,7020,1,0,0,3,7,1090,140,1924,1924,98116,47.572,122.39,1390,5850,90,0,4,2620,7080
6.25e+05,2015,403,3,1.75,2700,18893,1,0,0,4,7,2110,590,1948,1983,98010,47.34,122.05,2260,17494,67,1,4.75,4960,20194
2.96e+05,2014,242,4,2.5,1780,3600,2,0,0,3,7,1780,0,2006,2006,98038,47.367,122.02,2020,3802,8,0,6.5,3800,5582
9.25e+05,2015,462,4,2.25,2590,13894,2,0,0,4,9,2590,0,1975,1975,98005,47.635,122.17,2720,13894,40,0,6.25,5310,16484
1.07e+05,2014,238,2,1,670,4720,1,0,0,4,6,670,0,1948,1948,98106,47.524,122.36,1480,4720,66,0,3,2150,5390
3.045e+05,2014,349,4,2.5,2030,5202,2,0,0,3,8,2030,0,2001,2001,98031,47.388,122.18,2260,5232,13,0,6.5,4290,7262
4.05e+05,2014,162,3,1,1330,15678,1,0,0,3,7,900,430,1984,1984,98074,47.636,122.04,1330,12696,30,0,4,2660,14026
4.5e+05,2014,176,3,1.5,1530,23660,1,0,0,3,7,1530,0,1952,1952,98155,47.747,122.3,1800,11407,62,0,4.5,3330,12937
4.48e+05,2015,487,4,2.5,2230,5000,1,0,0,3,7,1650,580,2006,2006,98059,47.48,122.13,2090,4637,9,0,6.5,4320,6867
9.4e+05,2014,314,3,1.5,2140,3600,2,0,0,3,9,1900,240,1925,1925,98119,47.634,122.36,2020,4800,89,0,4.5,4160,6940
4.7558e+05,2014,176,3,1.75,1520,11085,1,0,0,3,8,1520,0,1983,1983,98074,47.646,122.07,2310,9647,31,0,4.75,3830,11167
5.2e+05,2014,270,2,1,910,5000,1,0,0,3,7,910,0,1924,1924,98107,47.673,122.37,1050,5000,90,0,3,1960,5910
8.05e+05,2015,389,5,2.5,3320,7266,2,0,0,3,9,3320,0,2000,2000,98075,47.586,122.05,3060,10269,15,0,7.5,6380,13589
3.65e+05,2015,366,2,1,1390,8336,1,0,0,4,6,910,480,1946,1946,98166,47.465,122.36,1610,7847,69,0,3,3000,9237
3.985e+05,2014,303,2,2.5,1780,1311,3,0,0,3,8,1350,430,2005,2005,98103,47.696,122.34,1390,1227,9,0,4.5,3170,3007
2.1e+05,2014,196,2,1,1450,4750,1,0,0,3,7,850,600,1950,1950,98118,47.529,122.27,1190,5000,64,0,3,2640,6450
2.65e+05,2014,277,2,1,760,4000,1,0,0,4,6,760,0,1950,1950,98108,47.547,122.3,1640,4500,64,0,3,2400,5260
2.3e+05,2015,474,3,1,1250,9774,1,0,0,4,7,1250,0,1969,1969,98003,47.334,122.31,1280,8850,46,0,4,2530,10100
3.2e+05,2015,453,3,1,1630,5000,1,0,0,3,7,930,700,1954,1954,98108,47.55,122.3,1630,5480,61,0,4,3260,7110
3.3995e+05,2014,127,3,2.25,1630,12295,2,0,0,4,7,1630,0,1985,1985,98058,47.428,122.16,1730,9948,29,0,5.25,3360,11578
6.25e+05,2014,353,4,2.75,3010,6854,2,0,2,3,9,2570,440,2012,2012,98065,47.517,121.88,1830,2952,2,0,6.75,4840,5962
4.5e+05,2014,249,7,4,3150,7800,2,0,0,3,8,3150,0,2013,2013,98118,47.526,122.28,1880,6000,1,0,11,5030,9150
1.28e+05,2015,478,3,1,1400,9690,1,0,0,3,7,1400,0,1969,1969,98023,47.32,122.4,1280,9600,46,0,4,2680,11000
1.1125e+06,2014,263,6,4,3600,6224,2,0,0,3,9,2610,990,1945,2006,98199,47.653,122.41,1430,6224,69,1,10,5030,9824
7.82e+05,2014,148,4,3.5,3910,8095,2,0,0,3,9,3130,780,2007,2007,98029,47.559,122.04,3770,7021,7,0,7.5,7680,10931
5.25e+05,2014,272,3,1.75,2120,9146,1,0,0,3,8,1260,860,1981,1981,98074,47.648,122.06,2040,10485,33,0,4.75,4160,12605
5.7e+05,2014,156,3,2.5,2400,6975,2,0,0,3,9,2400,0,1993,1993,98056,47.534,122.18,2640,11172,21,0,5.5,5040,13572
6.88e+05,2015,477,5,1.75,2250,13526,1,0,1,3,8,1350,900,1957,1957,98125,47.711,122.28,2580,10078,58,0,6.75,4830,12328
8.25e+05,2014,223,3,2.75,3040,24192,2,0,0,4,10,3040,0,1987,1987,98034,47.711,122.22,2770,5728,27,0,5.75,5810,8768
4.9e+05,2015,408,3,2.5,2410,11900,1,0,2,4,9,1600,810,1989,1989,98023,47.338,122.34,3090,11902,26,0,5.5,5500,14312
8.282e+05,2014,340,4,2.75,3400,7081,2,0,0,3,9,3400,0,2001,2001,98006,47.566,122.12,3060,7081,13,0,6.75,6460,10481
3.825e+05,2014,263,3,2,1150,6249,1,0,0,3,7,1150,0,1952,2006,98155,47.749,122.28,2470,7751,62,1,5,3620,8901
4.375e+05,2014,122,3,2.25,1970,35100,2,0,0,4,9,1970,0,1977,1977,98027,47.464,121.99,2340,35100,37,0,5.25,4310,37070
3.4e+05,2014,299,3,2.25,2630,9916,2,0,0,4,9,2630,0,1988,1988,98092,47.331,122.2,2470,10810,26,0,5.25,5100,13440
1.165e+06,2014,180,3,3,3790,5001,2,0,0,3,10,2810,980,1989,1989,98122,47.603,122.28,2500,6286,25,0,6,6290,10076
3.05e+05,2014,182,3,1,1580,7424,1,0,0,3,7,1010,570,1962,1962,98058,47.461,122.17,1710,7772,52,0,4,3290,9352
5.47e+05,2014,155,3,2.5,1480,8381,1,0,0,4,7,1480,0,1968,1968,98125,47.708,122.29,1710,8050,46,0,5.5,3190,9530
3.3455e+05,2014,209,2,1,880,12000,1,0,0,3,7,880,0,1939,1939,98133,47.744,122.36,1960,9395,75,0,3,2840,10275
3.35e+05,2015,471,3,2.5,1740,5267,2,0,0,3,7,1740,0,1999,1999,98038,47.378,122.02,2180,5000,16,0,5.5,3920,6740
1.2e+06,2015,451,3,2,3660,22410,1,0,3,4,9,1830,1830,1947,1947,98117,47.697,122.4,2680,8250,68,0,5,6340,11910
5.85e+05,2014,335,3,3.25,3050,12700,2,0,0,3,8,2240,810,1990,1990,98011,47.745,122.21,3050,12386,24,0,6.25,6100,15436
3.1065e+05,2015,388,3,1.75,1510,12408,1,0,0,4,7,1510,0,1969,1969,98059,47.507,122.14,1480,17800,46,0,4.75,2990,19310
1.05e+06,2014,237,3,2.5,3400,5119,2,0,0,3,8,2300,1100,2014,2014,98115,47.684,122.31,1740,5969,0,0,5.5,5140,9369
8.75e+05,2015,414,4,1.75,2180,9726,1,0,0,4,9,2180,0,1966,1966,98040,47.536,122.23,2560,10244,49,0,5.75,4740,12424
8.1e+05,2015,373,3,2,1760,16928,1,0,0,3,7,1760,0,1953,1953,98004,47.636,122.2,3430,10059,62,0,5,5190,11819
8.6995e+05,2014,345,4,2.75,3140,7928,2,0,0,3,9,3140,0,2013,2013,98074,47.592,122.06,3500,7055,1,0,6.75,6640,10195
7.9e+05,2014,149,5,3.25,2900,12160,1,0,0,4,8,1890,1010,1967,1967,98005,47.615,122.17,2590,12160,47,0,8.25,5490,15060
6.3e+05,2014,196,5,1.75,2490,24969,1,0,2,4,8,1540,950,1959,1959,98023,47.336,122.35,2790,15600,55,0,6.75,5280,18090
3.58e+05,2015,486,3,2.5,2026,7611,2,0,0,3,8,2026,0,2010,2010,98042,47.373,122.16,2270,7611,5,0,5.5,4296,9637
4.8e+05,2014,133,5,4.75,3830,35000,1,0,0,3,8,2130,1700,1976,1976,98077,47.76,122.08,2750,36150,38,0,9.75,6580,39980
4.12e+05,2014,273,2,1.5,1240,3873,1,0,0,4,6,860,380,1909,1909,98116,47.575,122.39,1240,4336,105,0,3.5,2480,5576
5.4e+05,2014,141,3,1.75,1300,62290,1,0,0,3,7,1300,0,1983,1983,98053,47.653,121.98,1850,52272,31,0,4.75,3150,53572
4.75e+05,2015,452,3,2.75,1890,3938,2,0,0,3,8,1890,0,1999,1999,98065,47.534,121.87,1890,4142,16,0,5.75,3780,6032
2.19e+05,2014,208,3,2,1090,7350,1,0,0,4,7,1090,0,1990,1990,98042,47.369,122.08,1490,7741,24,0,5,2580,8831
5.35e+05,2015,400,4,1.75,1570,3250,1,0,0,5,8,1570,0,1928,1928,98136,47.541,122.39,1570,5720,87,0,5.75,3140,7290
4.2495e+05,2014,218,5,3.5,2760,3865,2,0,0,3,8,2760,0,2013,2013,98056,47.505,122.17,2590,4587,1,0,8.5,5350,7347
1.325e+06,2014,143,4,3,3370,7920,1,0,3,3,10,1860,1510,1988,1988,98117,47.677,122.4,2730,7380,26,0,7,6100,10750
9.46e+05,2014,222,4,3,3140,9058,1,0,0,3,9,2140,1000,1989,1989,98006,47.546,122.15,2760,10018,25,0,7,5900,13158
4.33e+05,2014,143,4,1.75,1830,9600,1,0,0,4,7,1010,820,1966,1966,98006,47.573,122.13,1910,11100,48,0,5.75,3740,12930
2.3e+05,2014,205,5,1,1410,9000,1,0,0,5,7,1410,0,1967,1967,98023,47.305,122.37,1200,8346,47,0,6,2610,9756
8.05e+05,2014,231,3,2.25,2860,11250,1,0,1,5,8,2290,570,1956,1956,98166,47.453,122.37,2030,11250,58,0,5.25,4890,14110
4.6e+05,2014,314,2,1,880,3300,1,0,0,4,7,880,0,1909,1909,98107,47.657,122.36,1960,5500,105,0,3,2840,6380
1.8638e+05,2015,478,3,1,1000,7636,1,0,0,2,7,1000,0,1952,1952,98166,47.472,122.34,1150,7600,63,0,4,2150,8600
7.99e+05,2014,136,4,3.25,3120,5000,2,0,0,3,9,2370,750,2005,2005,98115,47.69,122.3,2520,6000,9,0,7.25,5640,9120
8.55e+05,2015,424,4,3.5,2890,5911,2,0,0,3,9,2370,520,2014,2014,98075,47.575,122.07,3490,6093,1,0,7.5,6380,8983
3.43e+05,2014,285,6,5,2732,7655,2,0,0,3,7,2732,0,2009,2009,98002,47.304,122.21,3078,69993,5,0,11,5810,72725
5.2e+05,2014,141,4,2.5,3290,11446,2,0,0,3,8,3290,0,1992,1992,98028,47.74,122.23,2050,11933,22,0,6.5,5340,15223
4.9995e+05,2014,251,2,2.5,1320,1157,2,0,0,3,8,990,330,2014,2014,98107,47.669,122.36,1550,1519,0,0,4.5,2870,2839
3.08e+05,2015,474,2,1,1680,9250,1,0,0,3,7,860,820,1969,1969,98072,47.762,122.16,1590,9542,46,0,3,3270,11222
8.35e+05,2014,333,3,1.75,1490,3840,2,0,0,3,8,1490,0,1984,2014,98033,47.692,122.21,3450,8500,30,1,4.75,4940,9990
1.025e+05,2014,181,2,1,820,4320,1,0,0,3,5,820,0,1937,1937,98106,47.514,122.36,780,7424,77,0,3,1600,8244
3.1e+05,2015,479,3,2.5,1670,5791,2,0,0,3,7,1670,0,1995,1995,98055,47.442,122.19,1610,6034,20,0,5.5,3280,7704
6.31e+05,2015,472,3,2.25,1670,1396,2,0,0,3,9,1250,420,2015,2015,98115,47.681,122.29,1610,5191,0,0,5.25,3280,6861
4.35e+05,2015,423,4,2,2030,4033,2,0,0,4,7,1630,400,1925,1925,98133,47.706,122.34,1350,1340,90,0,6,3380,3370
2.2e+05,2014,312,3,1,1660,21514,1,0,0,4,7,1660,0,1973,1973,98022,47.216,121.96,1660,21600,41,0,4,3320,23260
4.84e+05,2015,447,3,2.25,1620,1425,3,0,0,3,8,1540,80,2009,2009,98027,47.541,122.03,1620,1237,6,0,5.25,3240,2857
3.1e+05,2014,205,4,1.75,1480,11200,1,0,0,4,7,1480,0,1969,1969,98059,47.506,122.14,1480,20310,45,0,5.75,2960,21790
1.9995e+05,2014,274,3,1.75,1550,6225,1,0,0,4,7,1550,0,1949,1949,98002,47.31,122.22,1760,9496,65,0,4.75,3310,11046
4.749e+05,2014,228,3,1,1630,8308,1,0,0,3,7,1630,0,1948,1948,98146,47.508,122.38,1170,8308,66,0,4,2800,9938
5.625e+05,2015,430,3,2.5,2030,7549,1,0,0,3,8,2030,0,1988,1988,98074,47.619,122.04,2040,7130,27,0,5.5,4070,9160
8.9e+05,2014,162,3,2.25,2060,8640,1,0,0,4,8,2060,0,1966,1966,98033,47.653,122.19,2030,9000,48,0,5.25,4090,11060
7.2e+05,2014,136,2,1,2020,7200,1,0,3,4,7,1700,320,1947,1947,98146,47.506,122.38,2020,7200,67,0,3,4040,9220
6.4e+05,2014,159,3,2.5,2140,8925,2,0,0,3,8,2140,0,1991,1991,98074,47.631,122.03,2310,8956,23,0,5.5,4450,11096
3.693e+05,2015,414,3,1.5,1480,21320,1,0,0,4,7,1480,0,1967,1967,98027,47.523,122.04,1850,17825,48,0,4.5,3330,19305
1.96e+05,2014,202,3,2.25,2070,11576,2,0,0,3,7,2070,0,1974,1974,98001,47.342,122.27,1890,7519,40,0,5.25,3960,9589
6.65e+05,2015,408,3,2.25,2580,6000,2,0,0,3,8,1780,800,1925,1925,98144,47.578,122.29,2300,5995,90,0,5.25,4880,8575
4.3e+05,2014,197,4,1,1620,37075,1,0,0,3,7,1620,0,1943,1943,98024,47.565,121.93,2190,87117,71,0,5,3810,88737
2.5e+05,2014,326,3,1.75,1910,10230,1,0,0,4,7,1290,620,1964,1964,98031,47.419,122.21,1590,10800,50,0,4.75,3500,12710
4.05e+05,2014,321,3,1.75,1520,7252,1,0,0,3,7,1140,380,1975,1975,98072,47.736,122.17,1910,7820,39,0,4.75,3430,9340
5.8e+05,2014,305,3,2,1870,5300,1,0,0,3,8,1870,0,2009,2009,98053,47.711,122.02,1870,5050,5,0,5,3740,6920
7.95e+05,2014,163,4,3.5,3200,3250,2,0,0,3,9,2670,530,2007,2007,98029,47.551,122,3400,3663,7,0,7.5,6600,6863
2.45e+05,2014,127,3,1.5,1260,1270,2,0,0,3,7,1040,220,2005,2005,98133,47.711,122.33,1260,1472,9,0,4.5,2520,2732
8.05e+05,2014,312,4,2.5,3960,38615,2,0,0,3,10,3960,0,2000,2000,98077,47.725,122.02,3290,43560,14,0,6.5,7250,47520
2.662e+05,2014,148,3,1.5,1430,9600,1,0,0,4,7,1430,0,1966,1966,98059,47.474,122.15,1590,10240,48,0,4.5,3020,11670
2.75e+05,2014,341,3,2.25,1260,1488,3,0,0,3,7,1260,0,2009,2009,98133,47.707,122.34,1190,1095,5,0,5.25,2450,2355
7.2995e+05,2015,479,5,3,3230,5167,1,0,0,4,8,2000,1230,1909,1909,98133,47.705,122.34,1509,1626,106,0,8,4739,4856
5e+05,2014,236,4,2.25,2350,7210,1,0,0,4,7,2350,0,1972,1972,98011,47.741,122.18,1930,7519,42,0,6.25,4280,9869
2.34e+05,2014,177,4,1,1390,18000,1,0,0,3,7,1390,0,1955,2013,98032,47.389,122.28,1390,18000,59,1,5,2780,19390
2.85e+05,2014,169,3,1,1210,4731,1,0,0,3,7,1210,0,1901,1901,98117,47.687,122.4,1450,5264,113,0,4,2660,6474
7.95e+05,2014,259,4,3.25,3520,5250,2,0,0,3,9,3520,0,2012,2012,98053,47.687,122.02,3220,5781,2,0,7.25,6740,9301
6.25e+05,2014,346,3,2.5,2180,5000,1,0,0,4,8,1240,940,1977,1977,98116,47.583,122.4,2000,5000,37,0,5.5,4180,7180
4.1995e+05,2014,256,3,2.25,2280,8500,1,0,0,4,7,1680,600,1977,1977,98034,47.721,122.17,1890,7700,37,0,5.25,4170,9980
4.15e+05,2014,168,4,2.5,2020,5501,2,0,0,3,7,2020,0,2010,2010,98059,47.494,122.15,2020,5494,4,0,6.5,4040,7514
3.64e+05,2014,224,4,2.5,2080,11050,1,0,0,4,8,2080,0,1969,1969,98059,47.472,122.12,1850,11050,45,0,6.5,3930,13130
4.25e+05,2015,480,3,2.5,2650,12247,2,0,0,3,9,2650,0,2002,2002,98001,47.319,122.26,2920,8965,13,0,5.5,5570,11615
7.9e+05,2014,170,4,1.75,2050,10920,1,0,3,3,8,1450,600,1974,1974,98155,47.743,122.29,2440,10920,40,0,5.75,4490,12970
5e+05,2015,399,3,1,1370,3500,1,0,0,3,7,1370,0,1905,1985,98103,47.686,122.35,1590,4500,110,1,4,2960,5870
6e+05,2014,323,3,1,1620,3000,1,0,0,5,7,1620,0,1928,1928,98103,47.689,122.35,1420,3060,86,0,4,3040,4680
5.33e+05,2014,128,3,1,1670,4080,1,0,0,3,7,1170,500,1967,1967,98115,47.69,122.32,1560,4080,47,0,4,3230,5750
8.8e+05,2014,174,4,2.5,3030,3841,3,0,0,3,9,3030,0,2005,2005,98117,47.678,122.37,1080,4922,9,0,6.5,4110,7952
2.33e+05,2014,319,3,2,1400,9177,1,0,0,3,7,1400,0,1974,1974,98001,47.342,122.27,2020,8547,40,0,5,3420,9947
5.15e+05,2014,333,4,2.5,2800,21370,2,0,0,3,8,2800,0,2003,2003,98028,47.776,122.25,1880,9336,11,0,6.5,4680,12136
7.5e+05,2014,326,4,3.5,3050,7020,2,0,3,3,9,2050,1000,1984,1984,98126,47.571,122.37,2170,5900,30,0,7.5,5220,8950
4.35e+05,2014,259,2,1,720,5600,1,0,0,4,7,720,0,1920,1920,98116,47.564,122.39,1330,5600,94,0,3,2050,6320
2.9e+05,2014,191,2,1,840,3844,1,0,0,4,6,840,0,1919,1919,98133,47.705,122.35,1040,3844,95,0,3,1880,4684
4.39e+05,2015,450,3,2.25,3020,6000,3,0,2,3,8,1980,1040,1994,1994,98108,47.525,122.32,1150,6000,21,0,5.25,4170,9020
6.95e+05,2014,190,4,3.5,3310,21050,2,0,0,5,9,2400,910,1992,1992,98027,47.52,122.04,2260,23400,22,0,7.5,5570,26710
5.5e+05,2014,176,4,2.5,2150,27540,2,0,0,3,8,2150,0,1997,1997,98053,47.637,121.97,2150,27540,17,0,6.5,4300,29690
2.525e+05,2014,221,2,1,770,2191,1,0,0,3,6,770,0,1937,1937,98108,47.551,122.32,940,5000,77,0,3,1710,5770
6.5e+05,2014,216,3,2.5,2500,51836,1,0,0,3,9,1510,990,2013,2013,98027,47.469,121.99,2270,54450,1,0,5.5,4770,56950
4.25e+05,2015,403,5,2.75,2110,5120,2,0,0,3,7,1870,240,1947,1983,98106,47.529,122.36,1580,5120,68,1,7.75,3690,7230
2.7e+05,2015,444,3,2.5,1350,1189,2,0,0,3,7,1080,270,2007,2007,98106,47.522,122.36,1300,1182,8,0,5.5,2650,2532
5.81e+05,2014,321,2,1.75,1930,11200,1,0,2,3,8,1430,500,1951,1951,98177,47.758,122.37,2840,12408,63,0,3.75,4770,14338
3.075e+05,2014,297,3,2.25,1646,7364,2,0,0,3,7,1646,0,1994,1994,98038,47.365,122.04,1975,9161,20,0,5.25,3621,10807
3.6e+05,2015,413,5,3,2680,9624,2,0,0,3,7,1870,810,1995,1995,98010,47.328,122.01,1860,9921,20,0,8,4540,12601
3.7298e+05,2014,134,3,2.5,1690,1618,2,0,0,3,8,1150,540,2014,2014,98029,47.552,122,1690,1618,0,0,5.5,3380,3308
2.105e+05,2015,424,3,1,1220,9600,1,0,0,5,7,1220,0,1958,1958,98001,47.262,122.28,1310,9600,57,0,4,2530,10820
3.05e+05,2015,399,3,2.5,1320,2480,2,0,0,3,7,1320,0,2005,2005,98118,47.536,122.28,1320,3240,10,0,5.5,2640,4560
1.038e+06,2015,439,5,2.75,3050,8904,1,0,0,4,8,1650,1400,1956,1956,98040,47.571,122.21,2920,8904,59,0,7.75,5970,11954
5.25e+05,2015,451,3,1,1500,6800,1,0,0,3,7,1500,0,1943,1943,98105,47.671,122.27,1500,6800,72,0,4,3000,8300
4.5e+05,2015,394,3,1.75,1560,8968,1,0,0,4,8,1560,0,1972,1972,98008,47.624,122.1,1990,8034,43,0,4.75,3550,9594
2.7e+05,2014,176,4,2.25,2600,9900,1,0,0,3,7,1600,1000,1965,1965,98178,47.488,122.24,1770,11250,49,0,6.25,4370,13850
3.49e+05,2014,279,3,2.25,1640,7261,2,0,0,3,7,1640,0,1989,1989,98034,47.719,122.18,1640,6789,25,0,5.25,3280,8429
4.75e+05,2014,357,4,3,2400,5400,2,0,2,4,7,1600,800,1965,1965,98178,47.51,122.26,2400,5400,49,0,7,4800,7800
3.5e+05,2015,444,3,1,1680,8010,1,0,0,3,7,840,840,1951,1951,98117,47.699,122.38,1890,8778,64,0,4,3570,10458
2.6e+05,2015,426,3,2.5,1770,2677,2,0,0,3,7,1770,0,2005,2005,98055,47.434,122.19,1550,1798,10,0,5.5,3320,3568
8.45e+05,2015,393,4,2.5,3360,40471,2,0,0,4,10,3360,0,1994,1994,98077,47.742,122.03,3150,36823,21,0,6.5,6510,40183
1.66e+05,2014,293,1,1,1120,17332,1,0,0,3,7,1120,0,1988,1988,98001,47.297,122.27,1280,17334,26,0,2,2400,18454
1.465e+06,2014,189,6,4.5,4230,6420,2,0,3,4,8,2360,1870,1916,1916,98119,47.63,122.37,3450,4085,98,0,10.5,7680,8315
2.875e+05,2015,392,3,2.25,2030,8690,1,0,0,4,8,1360,670,1986,1986,98023,47.319,122.39,1720,8800,29,0,5.25,3750,10830
5.15e+05,2015,426,4,3.5,3400,5222,2,0,0,3,9,3400,0,2005,2005,98038,47.356,122,3190,5326,10,0,7.5,6590,8726
5.9995e+05,2015,396,3,2.5,1510,1493,3,0,0,3,8,1510,0,2014,2014,98107,47.669,122.4,1530,1357,1,0,5.5,3040,2867
7.832e+05,2014,249,4,2,1590,5400,1,0,2,3,7,990,600,1900,1900,98119,47.637,122.37,2190,4800,114,0,6,3780,6390
1.15e+06,2014,156,3,1.5,2170,16600,1,1,2,3,10,1130,1040,1979,1979,98052,47.631,122.09,3130,13875,35,0,4.5,5300,16045
3.47e+05,2014,249,3,1,940,9198,1,0,0,3,7,940,0,1968,1968,98052,47.689,122.12,1430,8370,46,0,4,2370,9310
3.1496e+05,2014,291,2,1,890,6350,1,0,0,3,6,890,0,1943,1943,98103,47.697,122.36,1490,6350,71,0,3,2380,7240
9.25e+05,2014,195,5,3,3850,9457,2,0,0,4,9,2910,940,1963,1963,98177,47.727,122.36,2830,9608,51,0,8,6680,13458
1.98e+05,2014,167,3,1.5,1430,7347,1,0,0,3,7,820,610,1980,1980,98023,47.293,122.37,1430,8723,34,0,4.5,2860,10153
3.37e+05,2014,203,3,2.5,1470,3976,2,0,0,3,7,1470,0,1999,1999,98065,47.526,121.83,1490,4400,15,0,5.5,2960,5870
3.8787e+05,2014,237,3,2.5,2370,4200,2,0,0,3,8,2370,0,2014,2014,98038,47.37,122.02,2370,4200,0,0,5.5,4740,6570
7.15e+05,2015,381,4,1,2000,4800,2,0,0,4,7,2000,0,1911,1911,98103,47.658,122.35,1260,1452,104,0,5,3260,3452
4.02e+05,2014,279,2,1,710,5100,1,0,0,5,7,710,0,1905,1905,98117,47.676,122.38,1530,5100,109,0,3,2240,5810
6.05e+05,2014,153,3,2,2060,4040,1,0,0,4,8,1120,940,1947,1947,98103,47.68,122.35,1500,4000,67,0,5,3560,6060
5.46e+05,2015,471,4,3,1790,3600,1,0,0,3,8,1790,0,1901,1901,98122,47.612,122.31,1770,3119,114,0,7,3560,4909
9.93e+05,2014,242,4,2,2850,14810,2,0,0,5,8,2490,360,1954,1954,98004,47.589,122.2,2430,10454,60,0,6,5280,13304
4.12e+05,2014,271,3,2.5,1200,813,3,0,0,3,9,1200,0,2010,2010,98144,47.589,122.31,1750,4365,4,0,5.5,2950,5565
7.6e+05,2014,154,4,2.75,3370,12447,2,0,0,3,10,3370,0,1991,1991,98077,47.731,122.06,3700,13129,23,0,6.75,7070,16499
3.8e+05,2014,292,3,2.5,1610,1778,3,0,0,3,7,1610,0,2002,2002,98115,47.69,122.31,1120,2187,12,0,5.5,2730,3797
2.25e+05,2014,222,2,2.5,1360,2693,2,0,0,3,6,1360,0,2003,2003,98038,47.349,122.03,1360,2693,11,0,4.5,2720,4053
3.89e+05,2015,380,2,1.75,1160,4848,2,0,1,4,7,1160,0,1949,1949,98118,47.542,122.27,1990,7440,66,0,3.75,3150,8600
5.325e+05,2014,216,4,2.5,2490,8750,2,0,0,3,8,2040,450,1976,1976,98008,47.593,122.12,2120,10240,38,0,6.5,4610,12730
8.25e+05,2014,361,4,2.5,3210,18901,2,0,0,3,10,3210,0,1993,1993,98077,47.709,122.07,3330,18901,21,0,6.5,6540,22111
7.5e+05,2014,176,4,2.75,1750,5080,1,0,0,3,8,1750,0,1903,1903,98122,47.614,122.31,1700,4572,111,0,6.75,3450,6322
9.49e+05,2015,465,4,3,4270,85643,2,0,0,3,11,4270,0,1991,1991,98077,47.771,122.05,3760,51170,24,0,7,8030,55440
6.41e+05,2014,228,4,3.25,2760,4104,2,0,0,3,8,1900,860,2014,2014,98056,47.529,122.19,2760,5186,0,0,7.25,5520,7946
4.17e+05,2014,263,4,2,2090,4000,1,0,0,3,6,1060,1030,1907,1907,98144,47.589,122.3,1590,4000,107,0,6,3680,6090
3.5e+05,2014,139,3,2.25,1640,7200,2,0,0,4,8,1640,0,1985,1985,98007,47.595,122.15,1830,8372,29,0,5.25,3470,10012
4.25e+05,2014,285,2,2,1440,6677,1,0,0,3,7,870,570,1952,1952,98118,47.551,122.26,2020,7642,62,0,4,3460,9082
6.43e+05,2014,322,3,2.75,2030,7700,1,0,0,5,8,1400,630,1965,1965,98008,47.626,122.11,1780,8160,49,0,5.75,3810,10190
5.6e+05,2014,201,3,2,1840,14985,1,0,0,3,7,1840,0,1968,1968,98033,47.692,122.16,2300,16067,46,0,5,4140,17907
7.3e+05,2014,345,2,1,1860,3400,1,0,0,3,7,1010,850,1920,1920,98105,47.671,122.33,1540,3997,94,0,3,3400,5857
5.5e+05,2014,360,3,2.5,2430,5400,2,0,0,3,8,2430,0,2007,2007,98074,47.606,122.06,2640,11990,7,0,5.5,5070,14420
3.93e+05,2014,299,5,1.75,1610,15246,1,0,0,3,6,1610,0,1936,1936,98024,47.565,121.89,1410,10500,78,0,6.75,3020,12110
4.53e+05,2014,177,4,2.75,2300,37533,1,0,3,5,8,1550,750,1979,1979,98070,47.371,122.43,2130,10092,35,0,6.75,4430,12392
6.865e+05,2015,395,2,1.75,1390,5025,1,0,0,4,8,1390,0,1928,1928,98105,47.67,122.29,2160,5000,87,0,3.75,3550,6390
7.315e+05,2015,476,4,2.5,2650,4644,2,0,0,3,8,2650,0,2013,2013,98053,47.694,122.02,2640,5099,2,0,6.5,5290,7749
5.385e+05,2014,214,3,3.5,2500,4270,2,0,0,3,8,2500,0,2000,2000,98065,47.536,121.88,2420,4205,14,0,6.5,4920,6705
3.6e+05,2015,392,4,3,2580,6740,2,0,0,3,8,2580,0,1999,1999,98058,47.43,122.19,2010,6740,16,0,7,4590,9320
9.67e+05,2015,431,4,3.25,1860,4356,2,0,0,3,9,1860,0,1917,2005,98103,47.678,122.35,1860,4356,98,1,7.25,3720,6216
2.298e+06,2015,408,4,4.25,4070,13860,2,0,3,3,10,4070,0,2004,2004,98040,47.59,122.23,3430,9240,11,0,8.25,7500,13310
4.1e+05,2014,159,3,1,1410,5060,1,0,0,4,7,910,500,1956,1956,98133,47.707,122.34,1130,5693,58,0,4,2540,7103
2.5831e+05,2015,414,2,1.5,750,2964,1,0,0,5,5,750,0,1919,1919,98118,47.552,122.28,1350,3090,96,0,3.5,2100,3840
5.3e+05,2014,166,4,2.5,2050,6360,2,0,0,3,8,2050,0,1988,1988,98029,47.564,122.01,2070,7541,26,0,6.5,4120,9591
2.7e+05,2015,457,3,1.75,1610,6205,1,0,0,4,7,1210,400,1979,1979,98023,47.3,122.38,1780,8056,36,0,4.75,3390,9666
2.502e+05,2014,238,3,1.5,1180,7384,1,0,0,5,7,1180,0,1959,1959,98032,47.384,122.29,1150,7455,55,0,4.5,2330,8635
3.65e+05,2014,340,4,2.5,2420,8404,2,0,0,3,8,2420,0,2013,2013,98042,47.372,122.13,2440,4822,1,0,6.5,4860,7242
1.562e+06,2014,293,5,3,3910,16200,1,0,0,4,9,2890,1020,1960,1960,98004,47.633,122.22,3620,16200,54,0,8,7530,20110
2.75e+05,2015,422,2,1,2180,12875,1,0,0,3,7,1480,700,1959,1959,98198,47.376,122.3,1800,7447,56,0,3,3980,9627
5.75e+05,2014,175,3,2.25,1700,3333,1,0,0,3,7,1100,600,1924,1924,98117,47.678,122.36,1700,3750,90,0,5.25,3400,5450
5.4e+05,2014,278,4,2.5,2329,9436,2,0,0,3,9,2329,0,1995,1995,98011,47.737,122.2,2660,10252,19,0,6.5,4989,12581
2.65e+05,2014,237,5,2.25,2600,8075,1,0,0,4,8,2600,0,1969,1969,98092,47.296,122.19,2200,8800,45,0,7.25,4800,11400
3.49e+05,2014,262,3,3.25,1340,1151,3,0,0,3,7,1340,0,2008,2008,98103,47.69,122.35,1290,1200,6,0,6.25,2630,2540
3.9e+05,2015,476,5,1.75,1940,6654,1,0,0,4,7,1940,0,1953,1953,98166,47.466,122.36,2300,9500,62,0,6.75,4240,11440
6.25e+05,2014,263,4,2,2190,3622,1,0,0,5,8,1990,200,1925,1925,98115,47.689,122.31,1450,3082,89,0,6,3640,5272
4.69e+05,2014,168,5,2.5,2240,7543,1,0,0,3,7,1140,1100,1966,1966,98177,47.776,122.37,2110,7408,48,0,7.5,4350,9648
5.85e+05,2015,407,3,2.5,1750,1381,3,0,0,3,8,1750,0,2008,2008,98122,47.602,122.29,1940,4800,7,0,5.5,3690,6550
3.2e+05,2014,173,4,1.5,1890,43560,1,0,0,4,8,1890,0,1974,1974,98092,47.327,122.17,2376,5820,40,0,5.5,4266,7710
2.3995e+05,2014,136,5,1,1460,6032,2,0,0,4,6,1460,0,1941,1941,98168,47.487,122.28,1060,10300,73,0,6,2520,11760
7.5e+05,2014,277,2,2,2180,21392,2,0,0,3,8,2180,0,1934,1979,98034,47.716,122.25,2890,22000,80,1,4,5070,24180
8.23e+05,2014,125,6,1.75,2920,5000,2,0,0,4,9,2780,140,1908,1908,98122,47.602,122.3,2020,5000,106,0,7.75,4940,7920
6.72e+05,2015,458,3,2.25,1130,4445,1,0,0,4,8,1130,0,1930,1930,98117,47.684,122.38,1330,4445,85,0,5.25,2460,5575
2.949e+05,2014,242,3,2.5,1860,5025,2,0,0,3,8,1860,0,2010,2010,98038,47.356,122.06,2000,5550,4,0,5.5,3860,7410
6.26e+05,2014,176,3,1.75,2430,5000,2,0,0,4,7,1760,670,1945,1945,98117,47.678,122.37,1320,4062,69,0,4.75,3750,6492
8.5e+05,2014,346,6,3.5,2820,5400,1,0,0,3,8,1620,1200,1958,1958,98117,47.679,122.37,1560,2276,56,0,9.5,4380,5096
4.85e+05,2015,464,4,3.25,1946,17786,2,0,1,4,7,1946,0,1990,1990,98070,47.359,122.45,1460,16661,25,0,7.25,3406,18607
3.55e+05,2014,290,3,1,1200,16000,1,0,0,3,7,1200,0,1970,1970,98072,47.745,122.1,1960,15500,44,0,4,3160,16700
1.9e+06,2014,159,4,3.25,4130,1.1252e+05,2,0,0,3,11,4130,0,1978,1978,98005,47.639,122.17,3140,26147,36,0,7.25,7270,30277
7.8e+05,2014,205,3,2.25,2130,11782,1,0,0,4,8,1590,540,1977,1977,98040,47.542,122.22,2700,11782,37,0,5.25,4830,13912
2.85e+05,2015,438,4,1.75,1870,22072,1,0,0,3,7,1070,800,1959,1959,98042,47.377,122.17,2100,10185,56,0,5.75,3970,12055
4.118e+05,2014,352,4,2.25,2190,6800,1,0,0,5,7,1340,850,1969,1969,98011,47.737,122.19,1560,7611,45,0,6.25,3750,9801
3.595e+05,2014,339,4,2.25,2390,11250,2,0,0,3,9,2390,0,1988,1988,98023,47.331,122.37,2480,11250,26,0,6.25,4870,13640
2.4995e+05,2014,224,3,1.75,1320,10454,1,0,0,4,7,1320,0,1968,1968,98002,47.284,122.22,1680,10183,46,0,4.75,3000,11503
7.5e+05,2015,480,3,2,1840,2825,1,0,0,3,7,1040,800,1920,1920,98112,47.643,122.3,1820,3750,95,0,5,3660,5590
3e+05,2015,459,2,1.5,1300,6120,1,0,0,3,6,820,480,1945,1945,98146,47.509,122.34,1250,6120,70,0,3.5,2550,7420
5.38e+05,2015,380,4,1.75,1880,7953,1,0,0,4,7,1880,0,1965,1965,98008,47.584,122.12,1750,8591,50,0,5.75,3630,10471
7.7e+05,2014,132,3,1.75,1720,5000,1,0,0,3,9,1720,0,1954,2014,98122,47.616,122.29,2120,4188,60,1,4.75,3840,5908
6.7e+05,2014,311,3,3,2980,3730,2,0,0,3,9,2980,0,2005,2005,98029,47.553,122,2710,3640,9,0,6,5690,6620
4.045e+05,2015,444,2,2,1320,3060,1,0,0,4,6,1320,0,1910,1910,98118,47.564,122.28,1410,3264,105,0,4,2730,4584
5.5e+05,2014,259,4,2.75,3080,6731,2,0,3,3,9,3080,0,2003,2003,98058,47.452,122.12,3080,6731,11,0,6.75,6160,9811
3.35e+05,2014,122,3,2.25,1580,16215,1,0,0,4,7,1580,0,1978,1978,98024,47.564,121.9,1450,16215,36,0,5.25,3030,17795
2.1e+05,2014,273,3,1,1000,5454,1,0,0,3,7,1000,0,1954,1954,98133,47.734,122.34,1320,5250,60,0,4,2320,6250
6.055e+05,2014,167,3,2.5,2830,6536,2,0,0,3,9,2830,0,1989,1989,98072,47.746,122.17,2710,6954,25,0,5.5,5540,9784
6.3e+05,2015,471,4,2.5,2540,8706,2,0,0,3,9,2540,0,1997,1997,98075,47.586,122.03,2540,6239,18,0,6.5,5080,8779
2.185e+05,2015,376,3,1.75,1390,9328,1,0,0,4,7,1390,0,1987,1987,98092,47.277,122.15,1550,8374,28,0,4.75,2940,9764
6.78e+05,2015,464,3,1.75,1670,7210,1,0,0,5,8,1670,0,1967,1967,98008,47.634,122.12,2200,7210,48,0,4.75,3870,8880
3.75e+05,2014,244,3,1.75,1260,11224,1,0,0,5,7,1260,0,1947,1947,98155,47.744,122.32,1570,11052,67,0,4.75,2830,12312
4.07e+05,2014,300,2,2.5,1700,6635,2,0,0,4,8,1700,0,1976,1976,98052,47.666,122.13,1700,6635,38,0,4.5,3400,8335
3.06e+05,2015,437,3,2.5,2588,5702,2,0,0,3,8,2588,0,2008,2008,98042,47.345,122.15,2403,5703,7,0,5.5,4991,8291
6.746e+05,2014,188,4,2.5,2610,5140,2,0,0,3,8,2610,0,2006,2006,98103,47.695,122.35,1190,5101,8,0,6.5,3800,7711
4.2e+05,2015,478,4,1.75,1320,4978,1,0,0,4,7,940,380,1942,1942,98126,47.527,122.38,1260,4693,73,0,5.75,2580,6013
4.38e+05,2014,244,4,2.5,1970,8545,2,0,0,3,8,1970,0,2004,2004,98059,47.489,122.14,2590,7200,10,0,6.5,4560,9170
4.67e+05,2014,331,3,1.75,2660,5511,1,0,0,3,8,1330,1330,1948,1948,98108,47.557,122.3,2030,6111,66,0,4.75,4690,8771
7.8e+05,2014,225,4,2.75,3430,6500,2,0,0,3,9,3050,380,2006,2006,98052,47.708,122.11,3070,6802,8,0,6.75,6500,10232
2.37e+05,2014,195,3,1,1160,6132,1,0,0,4,7,1160,0,1958,1958,98056,47.502,122.17,1280,6132,56,0,4,2440,7292
8.58e+05,2015,409,5,3,3620,12778,1,0,2,5,8,1900,1720,1964,1964,98006,47.551,122.19,2930,10669,51,0,8,6550,14289
4.35e+05,2015,443,1,1,670,1800,1,0,0,5,6,670,0,1905,1905,98103,47.654,122.35,1330,3360,110,0,2,2000,4030
5.7e+05,2015,376,4,3.5,3990,23544,1,0,2,3,10,2300,1690,1999,1999,98023,47.325,122.38,3410,15932,16,0,7.5,7400,19922
3e+05,2014,173,2,1,1060,7200,1,0,0,4,6,1060,0,1951,1951,98155,47.746,122.31,1850,8291,63,0,3,2910,9351
3.25e+05,2015,464,4,2.5,2200,7719,2,0,0,3,8,2200,0,2000,2000,98030,47.365,122.19,2460,7348,15,0,6.5,4660,9548
7.11e+05,2014,168,4,1.75,1980,10800,1,0,0,5,6,990,990,1948,1948,98040,47.577,122.22,2180,10800,66,0,5.75,4160,12780
1.3e+06,2014,187,4,2.25,2360,4000,2,0,0,3,9,2360,0,2013,2013,98112,47.62,122.29,3040,4400,1,0,6.25,5400,6760
2.75e+05,2014,175,2,1,770,4840,1,0,0,4,7,770,0,1927,1927,98126,47.551,122.38,930,4840,87,0,3,1700,5610
4.82e+05,2015,413,3,1.75,2300,16474,1,0,0,3,7,1220,1080,1984,1984,98072,47.761,122.14,1940,15601,31,0,4.75,4240,17901
4.2e+05,2015,452,2,1.75,1200,3136,1,0,0,3,7,800,400,1904,2005,98122,47.613,122.3,1330,3164,111,1,3.75,2530,4364
4.55e+05,2014,194,3,1,1480,13280,2,0,0,3,6,1480,0,1940,1940,98027,47.538,122.04,1510,8723,74,0,4,2990,10203
9.1995e+05,2014,243,5,2.75,3170,7062,2,0,0,3,9,3170,0,2014,2014,98074,47.594,122.06,3210,6891,0,0,7.75,6380,10061
4.37e+05,2014,174,4,2.5,1890,8505,1,0,0,3,8,1290,600,1980,1980,98052,47.68,122.11,1720,9600,34,0,6.5,3610,11490
5.5039e+05,2014,250,3,3,1720,70567,1,0,2,5,7,1720,0,1966,1966,98027,47.494,122.07,2740,70567,48,0,6,4460,72287
3.68e+05,2015,445,4,2,3160,11193,1,0,0,5,6,2410,750,1942,1942,98056,47.494,122.18,1020,5940,73,0,6,4180,9100
7.65e+05,2014,237,2,2.5,2170,6750,1,0,0,3,8,2170,0,2012,2012,98053,47.712,122.01,2150,6074,2,0,4.5,4320,8244
3.3401e+05,2014,198,4,2,1650,9305,1,0,0,4,6,1650,0,1960,1960,98034,47.718,122.21,1860,7486,54,0,6,3510,9136
8.02e+05,2014,256,3,2.25,2170,5001,2,0,0,3,8,2170,0,2014,2014,98103,47.694,122.34,1700,6991,0,0,5.25,3870,9161
7.1e+05,2014,238,3,2,1780,9732,1,0,0,3,8,1780,0,1967,1967,98040,47.58,122.23,1900,10200,47,0,5,3680,11980
3.53e+05,2015,381,4,2.5,2300,4249,2,0,0,3,8,2300,0,2006,2006,98038,47.352,122,2390,4385,9,0,6.5,4690,6685
4.25e+05,2014,290,4,2.25,3680,26266,2,0,0,4,9,3680,0,1981,1981,98042,47.322,122.08,2340,19939,33,0,6.25,6020,23619
1.68e+05,2015,445,3,1,1150,8000,1,0,0,4,6,1150,0,1913,1957,98001,47.275,122.25,1170,9600,102,1,4,2320,10750
9.35e+05,2014,232,3,3.25,3710,38509,2,0,0,3,10,3710,0,1998,1998,98014,47.693,121.87,1680,25865,16,0,6.25,5390,29575
4.89e+05,2014,259,3,2,1510,3000,1,0,0,4,7,910,600,1972,1972,98115,47.68,122.32,1620,4000,42,0,5,3130,5510
1e+06,2015,484,4,1.5,2100,4560,1,0,0,4,8,2100,0,1912,1912,98103,47.65,122.34,1930,4560,103,0,5.5,4030,6660
8.18e+05,2014,139,2,2.5,2380,9374,1,0,2,3,8,2380,0,2011,2011,98053,47.709,122.02,1610,5000,3,0,4.5,3990,7380
6.8e+05,2014,251,5,3,2970,6500,2,0,0,3,9,2970,0,2000,2000,98075,47.597,122.02,2970,6588,14,0,8,5940,9558
3.94e+05,2014,203,3,2,1160,3441,1,0,0,4,6,580,580,1930,1930,98136,47.531,122.39,1160,4000,84,0,5,2320,5160
2.24e+05,2014,176,4,1.5,1600,9289,1,0,0,4,7,1600,0,1959,1959,98002,47.311,122.21,1540,9918,55,0,5.5,3140,11518
3.51e+05,2014,242,4,1,1430,8400,1,0,0,3,6,730,700,1969,1969,98072,47.742,122.17,1310,8240,45,0,5,2740,9670
6.85e+05,2014,187,3,3.25,2030,11070,2,0,0,4,8,2030,0,1980,1980,98052,47.648,122.12,2450,11070,34,0,6.25,4480,13100
2.35e+05,2014,303,3,1,1250,7592,1,0,0,5,7,1250,0,1961,1961,98042,47.36,122.11,1250,7592,53,0,4,2500,8842
2.79e+05,2014,348,3,2.5,1660,7388,2,0,0,3,7,1660,0,2003,2003,98038,47.386,122.03,2240,6228,11,0,5.5,3900,7888
7.75e+05,2014,293,3,3.5,2690,1.0454e+05,2,0,0,3,8,2690,0,1948,1990,98072,47.772,122.11,2300,81698,66,1,6.5,4990,84388
5.615e+05,2014,257,4,2.25,2310,9800,1,0,0,3,8,1780,530,1968,1968,98033,47.666,122.18,2310,9800,46,0,6.25,4620,12110
1.11e+06,2014,181,5,3.25,3350,4000,2,0,0,4,8,2510,840,1997,1997,98105,47.664,122.29,1620,4000,17,0,8.25,4970,7350
2.24e+05,2014,232,3,1.5,1440,8370,1,0,0,3,7,1440,0,1977,1977,98118,47.542,122.28,1440,8370,37,0,4.5,2880,9810
3.7e+05,2014,211,3,2.25,1600,7620,1,0,0,3,7,1280,320,1987,1987,98011,47.774,122.21,1600,8215,27,0,5.25,3200,9815
3.735e+05,2015,445,4,2.5,2610,4978,2,0,0,3,8,2610,0,2004,2004,98038,47.344,122.04,2470,5024,11,0,6.5,5080,7634
4.228e+05,2014,354,3,1.75,1820,8400,1,0,0,3,7,1340,480,1976,1976,98072,47.734,122.17,1900,8112,38,0,4.75,3720,9932
5.85e+05,2014,202,3,1.75,1740,9500,1,0,3,4,8,1150,590,1958,1958,98146,47.492,122.36,2110,9450,56,0,4.75,3850,11190
4.8728e+05,2015,471,4,2.5,2400,3986,2,0,0,3,8,2400,0,1999,1999,98065,47.534,121.88,2070,3986,16,0,6.5,4470,6386
2.03e+05,2015,449,3,1.75,1190,6000,1,0,0,3,7,1190,0,1952,2015,98178,47.503,122.24,1200,6000,63,1,4.75,2390,7190
7.45e+05,2014,148,3,1.75,1490,9800,1,0,0,4,7,1140,350,1947,1947,98004,47.584,122.2,2310,9800,67,0,4.75,3800,11290
4.065e+05,2014,267,3,2,1780,8621,1,0,0,3,8,1780,0,1992,1992,98059,47.506,122.15,2470,8542,22,0,5,4250,10322
1.349e+06,2015,480,4,3.5,4740,8611,2,0,3,3,11,3640,1100,2006,2006,98027,47.538,122.07,4042,8321,9,0,7.5,8782,13061
3.5e+05,2014,310,4,2.5,2506,7206,2,0,0,3,8,2506,0,2007,2007,98023,47.324,122.34,2441,7220,7,0,6.5,4947,9726
8.7e+05,2015,437,5,3.5,4495,10079,2,0,0,3,9,3580,915,2013,2013,98011,47.734,122.21,4495,10079,2,0,8.5,8990,14574
4.7128e+05,2014,239,4,2.5,3361,5038,2,0,0,3,9,3361,0,2014,2014,98092,47.327,122.17,2316,4105,0,0,6.5,5677,7466
4.29e+05,2014,276,3,2.5,1860,11122,2,0,0,3,8,1860,0,1994,1994,98059,47.506,122.15,2420,8542,20,0,5.5,4280,10402
4.85e+05,2014,248,3,2.5,2430,5867,2,0,0,3,7,2430,0,2011,2011,98065,47.516,121.87,2620,5866,3,0,5.5,5050,8296
9.78e+05,2015,478,4,2.75,2890,7821,2,0,0,3,9,2890,0,2014,2014,98006,47.554,122.19,2890,10108,1,0,6.75,5780,12998
9.12e+05,2015,451,4,2.75,4030,10888,2,0,0,3,10,4030,0,1997,1997,98075,47.565,122.03,3720,10756,18,0,6.75,7750,14786
6.6e+05,2014,271,3,1.75,1750,5200,1,0,1,4,8,1750,0,1956,1956,98117,47.7,122.38,2060,5200,58,0,4.75,3810,6950
6.585e+05,2015,484,4,2.25,1900,5000,1,0,0,3,7,1400,500,1963,1963,98199,47.646,122.39,1710,4994,52,0,6.25,3610,6894
2.69e+05,2014,353,3,2.25,1950,8661,1,0,0,4,8,1950,0,1966,1966,98023,47.313,122.36,1950,8800,48,0,5.25,3900,10750
3.29e+05,2014,147,3,1,1600,5952,1,0,0,4,7,1150,450,1964,1964,98106,47.529,122.36,1460,6200,50,0,4,3060,7800
1.225e+06,2015,372,3,2.25,2980,7700,1,0,0,3,9,2530,450,1964,1964,98112,47.634,122.29,3020,8234,51,0,5.25,6000,11214
7.95e+05,2014,211,4,2.5,2920,32219,2,0,0,5,10,2920,0,1995,1995,98077,47.744,122.04,3420,37206,19,0,6.5,6340,40126
4.25e+05,2014,342,2,1,1280,5026,1,0,2,4,8,1020,260,1951,1951,98115,47.694,122.31,1540,6380,63,0,3,2820,7660
4.275e+05,2014,154,4,2.5,2460,5091,2,0,0,3,9,2460,0,2003,2003,98058,47.45,122.12,2490,4750,11,0,6.5,4950,7210
2.5028e+05,2014,168,2,1,790,11234,1,0,0,4,6,790,0,1942,1942,98166,47.441,122.35,1930,11871,72,0,3,2720,12661
5.5e+05,2014,173,3,1.75,1840,8086,1,0,0,4,8,1840,0,1964,1964,98052,47.67,122.16,1840,8060,50,0,4.75,3680,9900
3.047e+05,2014,159,2,1,740,5995,1,0,0,4,7,740,0,1949,1949,98133,47.729,122.34,1140,5995,65,0,3,1880,6735
2.7e+05,2015,437,3,2.25,2140,9990,1,0,0,4,8,2140,0,1962,1962,98003,47.348,122.3,2060,9990,53,0,5.25,4200,12130
7.64e+05,2014,270,3,2,1420,4080,1,0,0,5,8,1420,0,1904,1904,98103,47.68,122.35,1220,3060,110,0,5,2640,4480
6.1036e+05,2014,203,4,2.5,2610,5562,2,0,0,3,9,2610,0,2013,2013,98056,47.514,122.17,2720,7400,1,0,6.5,5330,10010
3.15e+05,2014,190,3,2.5,2340,6837,2,0,0,3,7,2340,0,1992,1992,98030,47.361,122.19,1850,6209,22,0,5.5,4190,8549
7.88e+05,2014,319,4,2.5,2680,8778,2,0,0,4,8,2680,0,1977,1977,98006,47.552,122.16,2680,10020,37,0,6.5,5360,12700
2.2e+06,2015,491,5,4.25,4640,22703,2,1,4,5,8,2860,1780,1952,1952,98052,47.639,122.1,3140,14200,63,0,9.25,7780,18840
5.265e+05,2014,298,3,2.5,1860,43170,2,0,0,3,8,1860,0,1986,1986,98072,47.771,122.14,2270,40835,28,0,5.5,4130,42695
2.84e+05,2014,314,3,1,1080,8214,1,0,0,3,7,1080,0,1944,1944,98133,47.74,122.35,1850,13560,70,0,4,2930,14640
1.5e+05,2014,301,4,2,1460,7254,1,0,0,3,6,1460,0,1959,1959,98178,47.506,122.25,1460,7236,55,0,6,2920,8696
4.75e+05,2014,182,4,2.5,1850,5444,2,0,0,5,7,1850,0,1981,1981,98034,47.723,122.16,1540,5000,33,0,6.5,3390,6850
5.24e+05,2014,208,2,2,1450,2272,1,0,0,4,6,750,700,1924,1924,98112,47.633,122.28,2170,4370,90,0,4,3620,5820
3.195e+05,2015,415,4,2.5,2730,4962,2,0,0,3,8,2730,0,2006,2006,98002,47.336,122.22,2150,3802,9,0,6.5,4880,6532
4.57e+05,2014,237,4,1.75,2100,10358,1,0,0,5,8,1280,820,1959,1959,98133,47.748,122.34,2080,9000,55,0,5.75,4180,11100
8.35e+05,2014,245,4,2.75,3130,13412,2,0,0,3,9,2140,990,1993,1993,98052,47.699,122.1,2260,9984,21,0,6.75,5390,13114
4.65e+05,2014,264,4,2.25,2100,7350,2,0,0,3,8,2100,0,1979,1979,98033,47.702,122.17,1780,7350,35,0,6.25,3880,9450
6.88e+05,2014,231,4,4,4000,9309,2,0,0,3,9,4000,0,2007,2007,98065,47.542,121.89,3920,8048,7,0,8,7920,12048
1.535e+05,2015,438,3,1,890,4810,1,0,0,3,6,890,0,1910,1910,98118,47.515,122.27,1230,6057,105,0,4,2120,6947
2.425e+05,2014,250,3,1,1020,5870,1,0,0,3,6,1020,0,1941,1941,98155,47.741,122.31,1160,6901,73,0,4,2180,7921
2.3e+05,2014,256,3,1,1190,9083,1,0,0,3,7,1190,0,1955,1955,98198,47.412,122.29,1190,9450,59,0,4,2380,10640
3.02e+05,2014,264,5,2,1540,9629,1,0,0,4,7,1540,0,1960,1960,98059,47.492,122.14,2260,9600,54,0,7,3800,11140
2.56e+05,2015,423,2,1,860,5000,1,0,0,3,6,860,0,1915,1945,98146,47.513,122.36,1220,5000,100,1,3,2080,5860
5.77e+05,2014,238,2,1.75,1620,4879,1,0,0,3,7,1040,580,1924,2011,98116,47.57,122.39,1500,5000,90,1,3.75,3120,6620
6.65e+05,2014,133,3,2,1940,5820,1,0,0,5,7,1150,790,1944,1944,98107,47.664,122.36,990,3880,70,0,5,2930,5820
3.2495e+05,2014,277,2,1,1150,9186,1,0,0,3,7,1150,0,1946,1946,98168,47.508,122.33,1390,10690,68,0,3,2540,11840
6.19e+05,2014,235,3,2.5,2560,43608,2,0,0,3,9,2560,0,2002,2002,98077,47.761,122.03,3000,54088,12,0,5.5,5560,56648
3.037e+05,2014,245,3,2.5,1981,5700,2,0,0,3,8,1981,0,2010,2010,98030,47.367,122.18,1981,5894,4,0,5.5,3962,7875
3.1e+05,2014,167,4,2,1870,6000,1,0,0,3,7,1870,0,1956,1956,98125,47.715,122.31,1520,7169,58,0,6,3390,9039
6.0495e+05,2014,229,3,2.5,2110,5608,1,0,0,3,8,1340,770,2013,2013,98033,47.674,122.18,2040,9363,1,0,5.5,4150,11473
3.15e+05,2015,443,3,2.25,2170,8480,1,0,0,3,8,2170,0,1965,1965,98148,47.456,122.33,2080,8452,50,0,5.25,4250,10622
2.91e+05,2014,263,4,2.25,1890,7616,1,0,0,4,8,1260,630,1979,1979,98003,47.328,122.33,1890,7420,35,0,6.25,3780,9310
3.25e+05,2014,342,3,1.5,1890,7650,1,0,0,5,7,1890,0,1966,1966,98003,47.345,122.31,1510,7560,48,0,4.5,3400,9450
1.4e+06,2015,390,3,3.25,3020,6073,2,0,0,4,9,3020,0,1954,1954,98112,47.633,122.29,3020,7700,61,0,6.25,6040,10720
2.99e+05,2014,197,3,2.25,1920,7840,2,0,0,4,8,1920,0,1982,1982,98032,47.363,122.28,2170,7210,32,0,5.25,4090,9130
4.5e+05,2015,477,2,1,740,5100,1,0,0,4,7,740,0,1947,1947,98115,47.679,122.3,920,5100,68,0,3,1660,5840
1.8399e+06,2015,445,4,3.25,4140,11007,2,0,0,3,10,4140,0,2013,2013,98040,47.571,122.22,2150,9663,2,0,7.25,6290,13803
5.49e+05,2014,243,2,1,1510,11165,1,0,0,4,7,1510,0,1921,1921,98133,47.721,122.33,2210,8851,93,0,3,3720,10361
5.85e+05,2015,474,4,2.5,2910,6250,2,0,0,3,8,2910,0,1999,1999,98065,47.538,121.87,2550,6250,16,0,6.5,5460,9160
4.7e+05,2014,202,5,3.25,3910,7077,2,0,0,3,9,2710,1200,2000,2000,98038,47.377,122.03,2650,7077,14,0,8.25,6560,10987
3.099e+05,2014,334,5,2.5,2100,17825,1,0,0,4,7,1400,700,1974,1974,98092,47.309,122.19,2200,14602,40,0,7.5,4300,16702
4.375e+05,2014,311,4,2.5,2680,7513,2,0,0,3,8,2680,0,1998,1998,98059,47.496,122.16,2640,7243,16,0,6.5,5320,9923
8.5e+05,2014,142,4,3.25,3090,6744,2,0,4,3,9,3090,0,1923,2015,98177,47.768,122.39,2020,6656,91,1,7.25,5110,9746
2.06e+05,2014,140,4,2,1700,6025,1,0,0,3,6,1700,0,1978,1978,98002,47.303,122.22,1320,5956,36,0,6,3020,7656
5.77e+05,2015,382,3,2.25,2370,7878,2,0,0,3,8,2370,0,1985,1985,98034,47.728,122.17,1870,7766,30,0,5.25,4240,10136
5.825e+05,2014,265,2,2,1540,6804,1,0,0,5,7,1020,520,1942,1942,98177,47.704,122.37,1380,6930,72,0,4,2920,8470
3.4e+05,2015,383,4,2.75,3527,7200,2,0,0,3,7,3527,0,2005,2005,98198,47.382,122.3,2490,7200,10,0,6.75,6017,10727
2.54e+05,2014,148,2,1,1060,8187,1,0,0,4,6,1060,0,1952,1952,98133,47.751,122.35,1260,8188,62,0,3,2320,9248
5.5e+05,2014,224,4,1.75,2410,8447,2,0,3,4,8,2060,350,1936,1980,98074,47.65,122.09,2520,14789,78,1,5.75,4930,17199
6.5e+05,2014,341,4,2.5,3700,4500,2,0,0,3,9,3700,0,2007,2007,98028,47.747,122.23,3050,5047,7,0,6.5,6750,8747
4.15e+05,2014,354,2,1,1510,6807,1,0,0,3,7,1090,420,1939,1939,98133,47.711,122.35,1460,6807,75,0,3,2970,8317
1.05e+06,2014,188,4,2.75,2250,3433,1,0,0,3,8,1500,750,1927,2013,98112,47.638,122.31,1970,3484,87,1,6.75,4220,5734
5.89e+05,2014,222,4,1.75,1920,4862,1,0,0,5,7,1060,860,1919,1919,98116,47.575,122.38,1840,4862,95,0,5.75,3760,6782
5.06e+05,2015,466,4,2.25,2040,12000,1,0,0,4,7,1300,740,1963,1963,98028,47.736,122.24,1930,12000,52,0,6.25,3970,14040
1.1e+06,2015,422,5,2.75,2890,22547,1,0,0,4,10,2150,740,1963,1963,98040,47.548,122.22,3010,17809,52,0,7.75,5900,20699
3.5625e+05,2014,199,3,2.5,2060,5115,2,0,0,3,9,2060,0,2014,2014,98092,47.326,122.16,2648,4500,0,0,5.5,4708,6560
4.81e+05,2014,292,3,2,2580,15653,1,0,0,3,9,2580,0,1990,1990,98166,47.456,122.36,1920,9840,24,0,5,4500,12420
2.8e+05,2014,159,2,1.75,1610,1.5856e+05,1,0,0,2,6,1610,0,1948,1948,98065,47.532,121.84,1800,3572,66,0,3.75,3410,5182
6.5e+05,2015,451,3,1.75,1970,54450,1,0,0,3,8,1570,400,1980,1980,98075,47.594,122.01,2460,36677,35,0,4.75,4430,38647
1.195e+06,2014,177,5,2.75,3650,13297,2,0,0,5,9,2750,900,1969,1969,98040,47.55,122.23,2900,11568,45,0,7.75,6550,15218
3.385e+05,2015,409,3,2.25,1333,1470,3,0,3,3,7,1333,0,2009,2009,98125,47.706,122.3,1360,1680,6,0,5.25,2693,3013
4.79e+05,2014,140,3,2.5,1260,889,3,0,0,3,8,1260,0,2008,2008,98109,47.628,122.34,1340,1324,6,0,5.5,2600,2584
4e+05,2014,262,4,1.5,1980,1.1369e+05,1,0,0,3,7,1980,0,1962,1962,98024,47.561,121.85,1980,89298,52,0,5.5,3960,91278
3.6e+05,2014,211,3,2,1630,10723,1,0,0,5,7,1630,0,1959,1959,98059,47.49,122.13,1450,10723,55,0,5,3080,12353
3.28e+05,2014,232,3,1,890,5965,1,0,0,3,7,890,0,1950,1950,98155,47.752,122.28,1930,7500,64,0,4,2820,8390
3.664e+05,2015,396,4,2.25,2040,14383,1,0,0,4,8,1270,770,1977,1977,98042,47.385,122.16,2030,11500,38,0,6.25,4070,13540
2.85e+05,2014,284,3,1.75,1630,4000,1,0,0,3,7,1100,530,1968,1968,98106,47.535,122.35,1300,4000,46,0,4.75,2930,5630
4.05e+05,2014,339,6,2,2800,29985,1,0,0,5,7,1400,1400,1954,1954,98058,47.44,122.08,1980,29985,60,0,8,4780,32785
6.45e+05,2014,307,5,2.25,3340,52476,2,0,0,4,8,3340,0,1975,1975,98027,47.455,121.99,2460,48351,39,0,7.25,5800,51691
2.8e+05,2015,459,2,1,1150,12861,1,0,0,3,6,1150,0,1959,1959,98058,47.449,122.17,1170,7574,56,0,3,2320,8724
1.145e+06,2014,176,3,2.5,2490,4000,2,0,0,5,8,1670,820,1918,1918,98109,47.64,122.35,2310,4000,96,0,5.5,4800,6490
2.35e+05,2014,232,2,1,1010,7500,1,0,0,3,7,1010,0,1941,1941,98108,47.528,122.32,1220,6000,73,0,3,2230,7010
4.45e+05,2014,143,3,2,1630,8702,1,0,0,3,9,1630,0,1987,1987,98056,47.517,122.19,2250,9890,27,0,5,3880,11520
5.82e+05,2014,348,2,1.75,1210,4141,1,0,0,4,7,910,300,1942,1942,98117,47.686,122.38,1310,4141,72,0,3.75,2520,5351
9.5e+05,2014,312,4,3.5,4030,4200,3,0,0,3,9,4030,0,1992,1992,98199,47.642,122.39,2130,5000,22,0,7.5,6160,9030
3.52e+05,2015,472,2,1,940,5000,1,0,0,4,7,940,0,1937,1937,98117,47.688,122.39,1560,4500,78,0,3,2500,5440
2.0633e+05,2014,223,5,2.5,1720,10202,1,0,0,3,7,1720,0,1970,1970,98058,47.457,122.17,1720,8478,44,0,7.5,3440,10198
5.525e+05,2015,379,4,2.5,3260,6902,2,0,0,3,8,3260,0,2008,2008,98059,47.483,122.16,3130,6588,7,0,6.5,6390,9848
3.95e+05,2014,300,3,2.25,1780,9672,1,0,0,3,8,1350,430,1960,1960,98133,47.777,122.35,1860,10080,54,0,5.25,3640,11860
1.715e+06,2014,353,4,2.5,3070,7207,2,0,0,4,10,2670,400,1927,1927,98112,47.633,122.29,3190,7523,87,0,6.5,6260,10593
1.7e+05,2014,342,2,1,1300,11400,1,0,0,3,7,1300,0,1961,1961,98003,47.346,122.3,1360,9750,53,0,3,2660,11050
3.509e+05,2015,444,4,2.5,2540,12843,2,0,0,3,9,2540,0,1992,1992,98030,47.387,122.17,2410,9383,23,0,6.5,4950,11923
4.7995e+05,2015,429,2,2,1510,6516,1,0,0,3,8,1510,0,2005,2005,98053,47.708,122.01,1640,6009,10,0,4,3150,7519
7.7e+05,2015,402,4,1.75,2520,8442,1,0,0,4,7,1640,880,1953,1953,98004,47.632,122.2,2110,8442,62,0,5.75,4630,10962
5.05e+05,2014,206,3,1,1020,5410,1,0,0,4,7,880,140,1928,1928,98115,47.692,122.31,1580,5376,86,0,4,2600,6396
7.25e+05,2014,177,3,2.5,3580,54450,1,0,0,3,9,3580,0,1990,1990,98038,47.403,122.03,3090,35943,24,0,5.5,6670,39523
2.9e+05,2014,334,3,1.5,1040,9997,1,0,0,4,7,1040,0,1955,1955,98155,47.758,122.3,1040,8699,59,0,4.5,2080,9739
3e+05,2014,229,3,1.75,1310,9761,1,0,0,3,7,1310,0,1967,1967,98034,47.721,122.23,1490,9600,47,0,4.75,2800,10910
2.65e+05,2014,222,3,2,1850,16535,1,0,0,3,7,1850,0,1992,1992,98014,47.657,121.91,1528,13295,22,0,5,3378,15145
2.634e+05,2014,180,4,2,1360,60548,1,0,0,3,6,960,400,1960,1960,98001,47.272,122.27,1930,28800,54,0,6,3290,30160
6e+05,2015,386,3,1.75,1310,5000,2,0,0,4,7,1310,0,1901,1901,98107,47.672,122.38,1270,4750,114,0,4.75,2580,6060
6.45e+05,2014,299,4,1.5,2550,4000,1,0,0,4,7,1760,790,1926,1926,98115,47.681,122.32,1840,4000,88,0,5.5,4390,6550
4.49e+05,2015,440,4,1.75,2350,54450,1,0,0,4,7,1250,1100,1971,1971,98027,47.482,122,2180,50529,44,0,5.75,4530,52879
6.95e+05,2014,176,3,2.75,2590,12063,2,0,0,3,10,2590,0,1993,1993,98006,47.553,122.12,2850,8469,21,0,5.75,5440,11059
4.36e+05,2014,259,3,2.5,1460,1238,2,0,0,3,8,1200,260,2008,2008,98107,47.672,122.37,1280,1257,6,0,5.5,2740,2717
5.5e+05,2014,277,5,2.75,3000,9473,1,0,0,3,8,1500,1500,1966,1966,98052,47.657,122.13,2050,8820,48,0,7.75,5050,11820
5.52e+05,2014,159,2,2.5,1380,951,3,0,0,3,9,1380,0,2006,2006,98103,47.665,122.36,1430,3400,8,0,4.5,2810,4780
2.535e+05,2014,156,2,1,810,4800,1,0,0,3,7,810,0,1948,1948,98126,47.523,122.38,1240,7740,66,0,3,2050,8550
3.95e+05,2014,189,2,1,930,6380,1,0,0,4,7,930,0,1940,1940,98115,47.691,122.32,1180,6380,74,0,3,2110,7310
9.0995e+05,2015,466,5,3.75,3050,8972,2,0,0,3,9,3050,0,2014,2014,98033,47.682,122.17,2750,8979,1,0,8.75,5800,12029
7.8e+05,2014,173,4,3.5,3910,59863,2,0,0,4,10,2490,1420,1987,1987,98027,47.485,122.07,2830,37674,27,0,7.5,6740,41584
3.48e+05,2014,269,3,2,2360,6145,1,0,0,3,8,2360,0,2011,2011,98030,47.356,122.2,2304,5880,3,0,5,4664,8240
5.25e+05,2014,139,4,1.75,2420,7672,1,0,0,3,8,1480,940,1979,1979,98027,47.564,122.08,2370,7699,35,0,5.75,4790,10119
4.995e+05,2014,167,3,2.5,2970,21907,2,0,0,3,9,2970,0,1998,2006,98059,47.474,122.1,2040,27917,16,1,5.5,5010,30887
8.02e+05,2014,172,3,1.75,2870,5000,1,0,0,4,8,1840,1030,1907,1907,98144,47.579,122.29,2200,5000,107,0,4.75,5070,7870
3.35e+05,2014,324,4,2.5,2330,7050,2,0,0,3,8,2330,0,1998,1998,98178,47.5,122.23,1810,5424,16,0,6.5,4140,7754
2.5e+05,2014,238,3,2.5,1650,2802,2,0,0,3,7,1650,0,2004,2004,98055,47.433,122.2,1490,2084,10,0,5.5,3140,3734
5.29e+05,2014,147,3,1,1210,3328,1,0,0,4,7,1210,0,1924,1924,98107,47.673,122.36,1640,3333,90,0,4,2850,4543
2.79e+05,2014,249,3,1,1530,15975,1,0,0,3,7,970,560,1952,1952,98168,47.477,122.33,1540,15975,62,0,4,3070,17505
3.852e+05,2014,156,4,1,1550,7740,1,0,0,3,6,1550,0,1954,1954,98126,47.522,122.38,1220,7740,60,0,5,2770,9290
3.15e+05,2014,153,5,2.5,2090,4698,2,0,0,3,7,2090,0,1998,1998,98038,47.354,122.03,2070,4698,16,0,7.5,4160,6788
2.98e+05,2015,486,2,1,850,5000,1,0,0,3,5,850,0,1907,1907,98055,47.487,122.21,910,4815,108,0,3,1760,5665
3.95e+05,2014,170,3,1,1500,4000,1,0,0,3,6,900,600,1925,1925,98117,47.692,122.38,950,4000,89,0,4,2450,5500
8.6e+05,2015,402,3,1.75,1860,5584,1,0,0,3,8,1310,550,1951,1951,98199,47.637,122.4,1630,6022,64,0,4.75,3490,7882
3.065e+05,2015,479,3,2.5,1970,6291,2,0,0,4,7,1970,0,1998,1998,98042,47.363,122.07,1980,8852,17,0,5.5,3950,10822
8.5e+05,2014,286,3,3.5,2620,11148,2,0,4,4,9,2060,560,1977,1977,98008,47.584,122.11,2590,10796,37,0,6.5,5210,13416
3.55e+05,2014,331,3,2.5,1880,5290,1,0,0,3,8,1250,630,1974,1974,98108,47.54,122.3,2030,5092,40,0,5.5,3910,6972
2.35e+05,2014,298,2,2,870,6450,1,0,0,4,6,740,130,1954,1954,98118,47.535,122.28,1640,5775,60,0,4,2510,6645
3.26e+05,2015,438,2,1,1210,7440,1,0,0,3,6,780,430,1940,1940,98155,47.738,122.32,1070,7440,75,0,3,2280,8650
3.79e+05,2014,159,4,1.5,2020,7560,1,0,0,4,7,2020,0,1960,1960,98059,47.502,122.15,1410,8080,54,0,5.5,3430,10100
7.8e+05,2014,335,3,2.25,2206,82031,1,0,2,3,6,866,1340,1983,1983,98074,47.63,122.07,2590,53024,31,0,5.25,4796,55230
3.76e+05,2014,129,3,2,1340,1384,3,0,0,3,8,1340,0,2008,2008,98103,47.697,122.35,1110,1384,6,0,5,2450,2724
4.35e+05,2014,198,3,2.5,1600,2375,2,0,0,3,7,1600,0,2005,2005,98029,47.553,122,1830,2375,9,0,5.5,3430,3975
3.4995e+05,2014,325,1,1,1230,9300,1,0,0,4,6,1230,0,1918,1918,98133,47.706,122.35,1190,6820,96,0,2,2420,8050
5e+05,2015,362,4,2.5,2230,26989,1,0,1,4,8,1400,830,1962,1962,98166,47.428,122.34,2570,17702,53,0,6.5,4800,19932
5.85e+05,2014,272,3,2.5,1740,2350,2,0,0,3,8,1130,610,1995,1995,98112,47.621,122.3,1740,3201,19,0,5.5,3480,4941
4.25e+05,2014,243,3,1,1550,4160,1,0,0,4,6,1550,0,1926,1926,98118,47.539,122.27,1590,5000,88,0,4,3140,6550
2.6995e+05,2015,412,2,1.75,1320,7540,1,0,0,3,7,1320,0,1968,1968,98038,47.363,122.05,1570,7540,47,0,3.75,2890,8860
3.6e+05,2015,416,3,1,1120,10500,1,0,0,4,7,1120,0,1966,1966,98034,47.727,122.23,1320,10500,49,0,4,2440,11620
2.3e+05,2014,203,2,1,1430,4000,1,0,0,3,7,930,500,1949,1949,98118,47.523,122.28,1110,4000,65,0,3,2540,5430
4.499e+05,2015,487,3,2.5,2780,8225,2,0,1,3,9,2780,0,1990,1990,98198,47.351,122.32,720,9736,25,0,5.5,3500,12516
2.45e+05,2014,287,2,2,1070,4500,1,0,0,4,6,910,160,1932,1932,98055,47.49,122.2,1280,4500,82,0,4,2350,5570
5e+05,2014,277,3,1.5,960,4600,1,0,0,3,6,960,0,1944,1944,98033,47.694,122.21,2230,9350,70,0,4.5,3190,10310
5.47e+05,2015,479,3,2.5,1570,1452,2,0,0,3,9,1240,330,2007,2007,98199,47.648,122.4,1670,1596,8,0,5.5,3240,3166
6.7575e+05,2014,176,4,2.5,2770,10274,2,0,0,3,9,2770,0,1989,1989,98029,47.575,122.02,2270,7210,25,0,6.5,5040,9980
2.8e+05,2015,473,3,1,1350,7553,1,0,0,3,6,1350,0,1914,1914,98118,47.535,122.27,1380,7470,101,0,4,2730,8820
3.83e+05,2014,353,3,2.5,1720,10031,2,0,0,3,8,1720,0,1993,1993,98028,47.769,122.24,2280,5845,21,0,5.5,4000,7565
6.4e+05,2014,360,4,2,2360,6000,2,0,0,4,8,2360,0,1904,1904,98107,47.67,122.36,1730,4700,110,0,6,4090,7060
2.84e+05,2014,272,3,2.5,1660,4083,2,0,0,3,7,1660,0,2013,2013,98038,47.359,122.05,1800,4087,1,0,5.5,3460,5747
3.15e+05,2014,140,3,2.25,1400,31626,1,0,0,2,7,1140,260,1987,1987,98092,47.303,122.07,1680,35093,27,0,5.25,3080,36493
5.2e+05,2015,402,2,1,1340,6380,1,0,0,3,7,890,450,1939,1939,98115,47.697,122.31,1380,6380,76,0,3,2720,7720
2.62e+05,2015,399,3,1.5,1700,9579,1,0,0,4,7,1100,600,1962,1962,98023,47.321,122.34,1700,9628,53,0,4.5,3400,11328
2.3995e+05,2014,168,3,1.75,1670,6900,1,0,0,3,7,1170,500,1978,1978,98023,47.297,122.38,1740,7000,36,0,4.75,3410,8670
5.525e+05,2015,447,3,1.5,1300,1435,2,0,0,3,8,1120,180,2007,2007,98122,47.611,122.31,1320,1652,8,0,4.5,2620,2952
3.4e+05,2014,352,4,2.25,2180,8000,1,0,0,4,9,1630,550,1975,1975,98023,47.317,122.38,2310,8000,39,0,6.25,4490,10180
4.03e+05,2014,317,2,1.5,1240,1101,2,0,0,3,8,1080,160,2009,2009,98144,47.576,122.31,1530,1209,5,0,3.5,2770,2449
2.5e+05,2014,318,3,2,1470,12096,1,0,0,4,6,1470,0,1942,1942,98030,47.373,122.19,1470,10966,72,0,5,2940,12436
3.7e+05,2015,423,3,1.75,1290,10117,1,0,0,3,7,1290,0,1984,1984,98072,47.76,122.15,1770,11839,31,0,4.75,3060,13129
3.27e+05,2015,475,2,1,1140,7435,1,0,0,3,7,1140,0,1952,1990,98125,47.73,122.31,1320,9385,63,1,3,2460,10525
6.68e+05,2014,201,4,2.5,2670,4410,2,0,0,3,8,2670,0,1999,1999,98075,47.598,122.04,2670,4410,15,0,6.5,5340,7080
9.255e+05,2015,439,3,2.75,1970,5200,1,0,3,3,8,1970,0,1915,2002,98136,47.537,122.39,2140,5200,100,1,5.75,4110,7170
4.21e+05,2014,320,4,2.25,1310,8400,1,0,0,4,7,1310,0,1966,1966,98034,47.732,122.18,1600,8400,48,0,6.25,2910,9710
2.5e+05,2015,464,4,2.25,1730,8400,1,0,0,3,7,1730,0,1962,1962,98001,47.339,122.29,1550,7920,53,0,6.25,3280,9650
3.7e+05,2015,436,3,1.5,1360,1167,3,0,0,3,8,1360,0,2008,2008,98103,47.696,122.35,1360,1167,7,0,4.5,2720,2527
7.7e+05,2015,408,3,3.5,2050,21744,2,1,4,4,9,1750,300,1930,1930,98166,47.454,122.38,2300,12200,85,0,6.5,4350,14250
5.719e+05,2014,331,4,1.75,1710,8947,1,0,0,4,7,1710,0,1956,1956,98007,47.595,122.14,1360,10133,58,0,5.75,3070,11843
4.4e+05,2015,470,4,2,2310,5004,1,0,0,3,7,1430,880,1994,1994,98108,47.547,122.3,1630,5060,21,0,6,3940,7370
7.4e+05,2014,236,6,2.25,3140,10250,1,0,0,4,8,1570,1570,1959,1959,98005,47.612,122.17,2320,10250,55,0,8.25,5460,13390
4.111e+05,2014,290,3,1.5,1040,10323,1,0,0,4,7,1040,0,1958,1958,98005,47.588,122.16,1580,7200,56,0,4.5,2620,8240
3e+05,2014,216,3,2.5,1330,1200,3,0,0,3,7,1330,0,2002,2002,98133,47.703,122.34,1330,1206,12,0,5.5,2660,2536
4.2e+05,2015,471,4,2.25,2270,9100,2,0,0,3,7,2270,0,1978,1978,98034,47.724,122.17,1710,7910,37,0,6.25,3980,10180
9.05e+05,2014,170,4,3.5,2970,14486,2,0,0,3,9,2340,630,1997,1997,98040,47.563,122.22,3680,14486,17,0,7.5,6650,17456
4.05e+05,2014,331,2,1.5,1370,4102,2,0,0,4,7,1370,0,1987,1987,98033,47.694,122.18,1380,3211,27,0,3.5,2750,4581
3.1e+05,2014,232,3,2.5,1590,3359,2,0,0,3,7,1590,0,2000,2000,98019,47.735,121.99,1820,3383,14,0,5.5,3410,4973
7.9995e+05,2014,276,4,2.5,3320,7429,2,0,0,3,9,3320,0,2014,2014,98034,47.719,122.22,1840,7429,0,0,6.5,5160,10749
2.58e+05,2014,191,3,2,1680,19978,1,0,0,3,6,880,800,1948,1948,98198,47.392,122.31,2150,11588,66,0,5,3830,13268
3.86e+05,2014,167,2,2.5,1620,3196,2,0,0,3,8,1620,0,2008,2008,98065,47.517,121.88,1750,2828,6,0,4.5,3370,4448
2.9995e+05,2015,447,3,1.5,1940,8951,1,0,0,3,7,1300,640,1958,1958,98168,47.473,122.33,2000,8319,57,0,4.5,3940,10259
6.6e+05,2014,132,4,2.5,2550,10000,1,0,0,3,8,1290,1260,1964,1964,98007,47.621,122.14,2270,8640,50,0,6.5,4820,11190
7.33e+05,2015,451,5,2.75,2880,4425,2,0,0,3,8,2880,0,2005,2005,98052,47.705,122.11,2940,6581,10,0,7.75,5820,9461
4.8e+05,2014,203,3,2.5,1640,7847,2,0,0,3,8,1640,0,1987,1987,98029,47.568,122.02,1870,6079,27,0,5.5,3510,7719
4.25e+05,2015,478,2,1,770,5040,1,0,0,3,5,770,0,1930,1930,98144,47.596,122.3,1330,2580,85,0,3,2100,3350
8.175e+05,2014,279,5,3.5,3600,9312,2,0,3,3,10,2680,920,2005,2005,98052,47.658,122.12,3420,9860,9,0,8.5,7020,13460
4.002e+05,2015,446,4,3.5,2260,30250,2,0,0,3,7,2260,0,2013,2013,98188,47.449,122.28,1270,16350,2,0,7.5,3530,18610
1.698e+06,2015,430,4,3.5,3950,6240,2,0,0,3,11,3950,0,2015,2015,98112,47.622,122.29,2040,6240,0,0,7.5,5990,10190
5.1156e+05,2014,129,3,2,1400,7293,1,0,0,4,7,1400,0,1963,1963,98008,47.586,122.12,1600,7960,51,0,5,3000,9360
5.32e+05,2014,129,5,3,3480,57499,1,0,0,4,8,2340,1140,1976,1976,98027,47.457,122.02,2020,40946,38,0,8,5500,44426
3.6e+05,2014,173,4,1.5,1720,6417,1,0,0,3,7,1720,0,1953,1953,98125,47.727,122.31,1430,6240,61,0,5.5,3150,7960
2.8995e+05,2014,180,3,2.5,1760,8584,1,0,0,5,7,1760,0,1937,1937,98148,47.461,122.33,2160,8584,77,0,5.5,3920,10344
4.37e+05,2015,407,4,1.75,1700,10642,1,0,0,4,7,850,850,1954,1954,98006,47.567,122.14,1610,11200,61,0,5.75,3310,12900
2.15e+05,2014,196,3,1.5,1500,15000,1,0,0,3,7,1500,0,1952,1952,98031,47.393,122.21,1790,13905,62,0,4.5,3290,15405
7.76e+05,2015,466,2,2,1990,6180,1,0,0,4,7,1010,980,1941,1941,98115,47.679,122.3,1470,5150,74,0,4,3460,7140
4.85e+05,2014,139,2,2.25,1260,1240,3,0,0,3,8,1260,0,2004,2004,98103,47.653,122.35,1330,1300,10,0,4.25,2590,2560
3.39e+05,2015,402,4,1.5,2390,7480,1,0,2,3,7,2390,0,1920,1920,98178,47.504,122.23,2850,6867,95,0,5.5,5240,9257
6.8e+05,2015,432,4,1,1660,6075,1,0,0,5,7,1660,0,1915,1915,98117,47.675,122.4,1810,5400,100,0,5,3470,7060
2.15e+05,2014,250,3,1,1190,7500,1,0,0,5,7,1190,0,1968,1968,98042,47.325,122.14,1200,9750,46,0,4,2390,10940
2.9e+05,2015,410,4,2,1660,4788,1,0,0,3,7,1660,0,1968,1968,98144,47.588,122.31,1150,5000,47,0,6,2810,6660
2.2e+05,2015,381,3,1.75,1720,7587,1,0,0,4,7,1140,580,1981,1981,98092,47.318,122.18,1120,7287,34,0,4.75,2840,9007
2.066e+05,2014,291,3,2,1390,13464,1,0,0,4,7,1390,0,1987,1987,98030,47.358,122.17,1720,12080,27,0,5,3110,13470
5e+05,2015,407,3,1.75,1780,11096,1,0,0,3,7,1210,570,1979,1979,98074,47.617,122.05,1780,10640,36,0,4.75,3560,12420
1.385e+06,2014,310,5,3.75,3290,6480,2,0,0,5,10,2190,1100,1938,1938,98199,47.653,122.42,2010,7639,76,0,8.75,5300,10929
7.25e+05,2014,211,4,2.75,2440,7042,1,0,2,4,7,1640,800,1941,1941,98116,47.573,122.41,2170,7900,73,0,6.75,4610,10340
2.49e+05,2014,203,4,2.25,1860,9576,1,0,0,3,7,1400,460,1962,1962,98032,47.361,122.28,1860,9576,52,0,6.25,3720,11436
3.7895e+05,2014,293,4,2,1820,8400,1,0,0,5,7,1300,520,1956,1956,98155,47.761,122.33,1700,9450,58,0,6,3520,11270
7.75e+05,2014,276,5,3.5,3290,5600,2,0,0,3,9,2670,620,2004,2004,98052,47.706,122.12,3130,5600,10,0,8.5,6420,8890
7.905e+05,2014,223,4,2.75,3350,5416,2,0,0,3,9,3350,0,2014,2014,98053,47.685,122.02,3625,5637,0,0,6.75,6975,8987
6.05e+05,2014,297,2,1,1550,3200,1,0,0,3,8,1550,0,1927,1927,98112,47.637,122.31,1800,3937,87,0,3,3350,5487
6.9e+05,2014,269,4,2.5,2820,8307,2,0,0,3,9,2820,0,1990,1990,98074,47.625,122.03,2820,8307,24,0,6.5,5640,11127
3.5e+05,2015,473,3,2.25,1190,1022,3,0,0,3,8,1190,0,1998,1998,98103,47.697,122.35,1210,1171,17,0,5.25,2400,2361
6.5e+05,2015,478,5,2.75,2580,7865,1,0,0,4,8,1480,1100,1964,1964,98007,47.621,122.14,2140,8400,51,0,7.75,4720,10980
5.75e+05,2015,452,3,1,1740,9163,1,0,0,3,7,1740,0,1954,1954,98125,47.705,122.3,1490,6509,61,0,4,3230,8249
3.3e+05,2014,265,3,2.5,1520,3003,2,0,0,3,7,1520,0,2009,2009,98059,47.488,122.15,1820,3030,5,0,5.5,3340,4550
3.8e+05,2014,228,1,1.5,1200,44866,1,0,0,3,7,1200,0,1983,1983,98019,47.721,121.93,1480,67082,31,0,2.5,2680,68282
5.85e+05,2015,459,5,1.75,1880,16617,1,0,0,3,7,960,920,1963,1963,98007,47.6,122.13,1720,8400,52,0,6.75,3600,10280
5.3e+05,2014,161,3,1.75,1550,3680,1,0,0,3,7,1050,500,1927,1927,98117,47.682,122.36,1560,4000,87,0,4.75,3110,5550
5.4e+05,2015,407,4,2.5,2190,3855,2,0,0,3,8,2190,0,2010,2010,98011,47.77,122.17,2190,3600,5,0,6.5,4380,5790
6.75e+05,2014,264,3,1.5,2510,3600,2,0,0,4,8,2510,0,1907,1907,98112,47.62,122.31,1740,1885,107,0,4.5,4250,4395
1.54e+06,2015,487,5,3.25,2920,6960,2,0,1,3,9,2120,800,1953,2008,98105,47.671,122.27,2470,6735,62,1,8.25,5390,9655
6.99e+05,2015,439,5,2.75,2970,36817,2,0,0,4,8,2970,0,1978,1978,98072,47.773,122.14,2730,29150,37,0,7.75,5700,32120
2.87e+05,2015,464,3,2.25,1370,6000,2,0,0,4,7,1370,0,1992,1992,98038,47.348,122.03,1370,6200,23,0,5.25,2740,7570
2.4e+05,2014,277,4,1.75,2020,10332,1,0,0,3,7,1010,1010,1954,1954,98168,47.506,122.3,2240,8379,60,0,5.75,4260,10399
4.475e+05,2015,425,2,2.25,1180,2090,2,0,0,3,7,1180,0,2004,2004,98122,47.603,122.31,1550,2812,11,0,4.25,2730,3992
3.25e+05,2014,244,1,1,730,1942,1,0,0,3,7,730,0,2009,2009,98144,47.594,122.3,1020,2044,5,0,2,1750,2774
4.65e+05,2015,477,3,1.75,1490,10757,1,0,0,3,7,1060,430,1966,1966,98034,47.72,122.23,1490,10609,49,0,4.75,2980,12099
3.46e+05,2014,271,2,1,1070,2196,1,0,0,4,7,880,190,1917,1917,98144,47.573,122.31,1160,3600,97,0,3,2230,4670
4.15e+05,2014,129,4,2.25,3060,48787,2,0,0,3,8,3060,0,1992,1992,98010,47.34,121.92,2090,48787,22,0,6.25,5150,51847
5.88e+05,2014,183,5,3,2190,4900,2,0,0,5,7,1490,700,1940,1940,98117,47.689,122.39,1370,4606,74,0,8,3560,6796
3.935e+05,2015,381,3,1.75,1230,1441,2,0,0,3,8,1010,220,2004,2004,98116,47.563,122.38,1170,1942,11,0,4.75,2400,3172
3.45e+05,2014,287,4,2.5,2040,5875,2,0,0,3,8,2040,0,2004,2004,98056,47.505,122.17,2230,5459,10,0,6.5,4270,7499
8.799e+05,2015,367,4,2.75,3580,12000,1,0,0,3,10,1840,1740,1979,1979,98074,47.632,122.05,2910,12428,36,0,6.75,6490,16008
2.7e+05,2014,189,4,2.5,1660,8063,1,0,0,4,7,1660,0,1978,1978,98198,47.376,122.32,1060,8437,36,0,6.5,2720,10097
5e+05,2014,245,4,2.5,2840,18001,2,0,0,3,9,2840,0,1994,1994,98019,47.736,121.96,2500,18001,20,0,6.5,5340,20841
8.7e+05,2014,223,3,2.5,3210,8630,2,0,0,4,10,2530,680,1990,1990,98033,47.694,122.19,2630,8630,24,0,5.5,5840,11840
9.555e+05,2014,181,4,1.75,2130,5080,1,0,0,3,8,2130,0,1914,1993,98119,47.643,122.36,1900,5080,100,1,5.75,4030,7210
2.8e+05,2014,280,5,2,2110,7919,1,0,0,3,7,1110,1000,1966,1966,98118,47.516,122.27,1590,5250,48,0,7,3700,7360
7.75e+05,2014,223,4,2.75,2740,6200,1,0,3,4,8,1820,920,1947,1947,98125,47.708,122.28,2430,6000,67,0,6.75,5170,8740
3.05e+05,2014,266,3,1,820,5150,1,0,0,5,6,820,0,1918,1918,98118,47.551,122.28,1100,5150,96,0,4,1920,5970
9e+05,2014,345,4,3.5,3860,6543,2,0,0,3,10,3860,0,2014,2014,98075,47.593,121.97,3760,6888,0,0,7.5,7620,10748
4.35e+05,2014,125,5,2,1840,9240,1,0,0,4,7,1540,300,1942,1958,98133,47.731,122.34,1200,5250,72,1,7,3040,7090
3.15e+05,2014,294,2,1,780,7200,1,0,0,2,6,780,0,1935,1935,98118,47.561,122.28,1750,7200,79,0,3,2530,7980
2.35e+05,2014,285,2,1,1270,9182,1,0,0,3,6,1270,0,1917,1917,98126,47.536,122.38,1760,9100,97,0,3,3030,10370
4.54e+05,2014,163,4,2.25,2630,39000,2,0,0,3,9,2630,0,1979,1979,98042,47.409,122.15,2270,66647,35,0,6.25,4900,69277
8.2e+05,2014,300,3,2.5,2990,10711,1,1,4,3,9,1560,1430,1976,1991,98198,47.357,122.32,2870,11476,38,1,5.5,5860,14466
9.25e+05,2014,225,4,3.25,3640,60086,2,0,0,3,10,3640,0,2005,2005,98074,47.633,122.02,2900,51721,9,0,7.25,6540,55361
6.3e+05,2014,195,5,2,1900,5000,1,0,2,3,8,1720,180,1957,1957,98107,47.673,122.36,1770,5000,57,0,7,3670,6900
4.25e+05,2015,388,2,1,1160,5038,1,0,0,5,7,740,420,1942,1942,98126,47.53,122.38,1160,5076,73,0,3,2320,6236
1.1e+05,2015,409,2,1,600,6120,1,0,0,3,5,600,0,1943,1943,98168,47.5,122.32,1060,6120,72,0,3,1660,6720
5.64e+05,2015,423,4,2.5,2870,6658,2,0,0,3,8,2870,0,2004,2004,98065,47.539,121.88,2770,6658,11,0,6.5,5640,9528
5.1e+05,2014,202,6,4.5,3300,7480,2,0,0,3,8,3300,0,1980,1980,98052,47.68,122.1,2470,7561,34,0,10.5,5770,10861
3.6e+05,2015,452,2,2,1770,7607,1,0,0,4,8,1770,0,1987,1987,98058,47.429,122.16,2090,7109,28,0,4,3860,8879
2.337e+05,2014,258,3,2.25,1650,3788,2,0,0,3,7,1650,0,1985,1985,98031,47.391,122.17,1510,3994,29,0,5.25,3160,5644
1.3e+06,2014,272,4,2.5,3470,4160,2,0,0,3,9,2480,990,1927,1927,98119,47.63,122.36,2280,5440,87,0,6.5,5750,8910
7.2903e+05,2014,181,4,2.5,2840,12866,1,0,0,4,9,1780,1060,1977,1977,98005,47.639,122.17,2840,13209,37,0,6.5,5680,16049
5.3e+05,2014,319,3,2.5,2030,10958,2,0,0,3,8,2030,0,1983,1983,98052,47.725,122.11,1960,10282,31,0,5.5,3990,12312
3.285e+05,2015,413,3,2.25,1390,1407,3,0,0,3,7,1390,0,2004,2004,98125,47.723,122.3,1390,1628,11,0,5.25,2780,3018
2.6e+05,2015,465,3,2.5,1920,7415,2,0,0,3,7,1920,0,1989,1989,98031,47.402,122.17,1930,7536,26,0,5.5,3850,9456
4.15e+05,2014,194,4,1.5,1540,7886,2,0,0,3,7,1540,0,1967,1967,98034,47.734,122.19,1550,7396,47,0,5.5,3090,8936
3.975e+05,2014,164,3,2,1510,6710,1,0,0,3,7,1070,440,1972,1972,98034,47.719,122.22,1660,6600,42,0,5,3170,8110
4.75e+05,2014,168,3,1.75,1700,8432,1,0,0,3,8,1230,470,1977,1977,98125,47.722,122.32,1800,7842,37,0,4.75,3500,9542
4.9e+05,2014,136,2,1,1160,5000,1,0,0,4,8,1160,0,1937,1937,98117,47.687,122.4,1750,5000,77,0,3,2910,6160
4.18e+05,2014,171,4,1.5,1550,9176,1,0,0,3,7,1000,550,1956,1956,98008,47.6,122.13,1730,8539,58,0,5.5,3280,10089
3.9e+05,2014,296,2,1,860,5160,1,0,0,4,7,860,0,1909,1909,98117,47.682,122.39,1090,5356,105,0,3,1950,6216
5.79e+05,2014,321,3,1.75,1800,4429,2,0,0,4,7,1800,0,1906,1906,98103,47.684,122.36,1310,4429,108,0,4.75,3110,6229
4.9123e+05,2014,173,4,2.5,1540,1860,2,0,0,3,8,1540,0,2014,2014,98029,47.552,122,1210,1090,0,0,6.5,2750,2630
9.1415e+05,2014,258,3,3.5,2940,6431,2,0,0,3,10,2940,0,2014,2014,98075,47.582,122.05,2760,6695,0,0,6.5,5700,9635
6.73e+05,2014,269,4,2.25,2590,8190,2,0,0,4,8,2590,0,1980,1980,98006,47.562,122.13,2260,8335,34,0,6.25,4850,10925
9.8e+05,2014,159,4,2.5,2730,4800,1,0,0,5,8,2230,500,1909,1909,98119,47.642,122.36,2190,4200,105,0,6.5,4920,6930
4.08e+05,2014,252,3,1.75,1970,7100,1,0,0,3,7,1590,380,1976,1976,98072,47.735,122.17,1790,7455,38,0,4.75,3760,9425
7.1e+05,2014,266,4,2,1740,9000,1,0,0,5,8,1740,0,1958,1958,98033,47.681,122.2,1850,7700,56,0,6,3590,9440
7.29e+05,2014,167,3,1,1580,3840,2,0,0,3,8,1580,0,1908,1908,98102,47.619,122.32,1680,2624,106,0,4,3260,4204
2.45e+05,2015,464,5,1.5,2000,8100,1,0,0,3,6,2000,0,1946,1946,98168,47.495,122.3,960,9239,69,0,6.5,2960,11239
5.49e+05,2014,125,4,2.5,2910,6338,2,0,0,3,8,2910,0,2008,2008,98059,47.48,122.13,2500,5877,6,0,6.5,5410,8787
5.2e+05,2014,264,4,3,2190,5085,2,0,0,4,8,2190,0,1992,1992,98029,47.569,122,2130,5142,22,0,7,4320,7332
2.0543e+05,2014,173,2,1,880,6780,1,0,0,4,6,880,0,1945,1945,98178,47.501,122.25,1190,6780,69,0,3,2070,7660
3.2e+05,2014,222,4,2.25,2190,9020,2,0,0,3,8,2190,0,1978,1978,98032,47.374,122.28,2170,8400,36,0,6.25,4360,10590
4.59e+05,2014,291,3,2.5,1780,4000,2,0,0,4,8,1780,0,1995,1995,98029,47.568,122,1730,4000,19,0,5.5,3510,5780
6.38e+05,2014,176,3,2,1660,3729,1,0,0,5,7,970,690,1922,1922,98116,47.574,122.41,1560,3729,92,0,5,3220,5389
3.52e+05,2015,418,4,2.5,1252,25002,1,0,0,3,8,992,260,1996,1996,98001,47.322,122.29,1860,25002,19,0,6.5,3112,26254
2.6995e+05,2014,202,3,1.75,1760,12823,1,0,0,4,7,1460,300,1956,1956,98002,47.287,122.21,1450,10800,58,0,4.75,3210,12560
5.01e+05,2015,425,3,1.75,1480,8667,1,0,0,5,7,740,740,1954,1954,98006,47.572,122.14,1600,10644,61,0,4.75,3080,12124
4.1e+05,2014,342,4,3,2430,7243,2,0,0,3,8,2430,0,2003,2003,98038,47.353,122.02,2430,7084,11,0,7,4860,9514
3.238e+05,2015,480,3,2.5,2060,7658,2,0,0,3,8,2060,0,2003,2003,98023,47.292,122.36,2250,7299,12,0,5.5,4310,9359
3.52e+05,2014,127,5,2.5,2420,8560,1,0,2,3,7,1620,800,1978,1978,98118,47.532,122.28,2210,7040,36,0,7.5,4630,9460
7.4e+05,2015,425,3,1.75,1380,4590,1,0,0,2,7,930,450,1950,1950,98115,47.684,122.29,1320,4692,65,0,4.75,2700,6072
5.59e+05,2014,277,2,2,1930,5520,1,0,0,3,8,1930,0,2006,2006,98053,47.719,122.02,1640,4533,8,0,4,3570,6463
3.5e+05,2014,230,3,1,2010,6000,1,0,0,3,7,1210,800,1967,1967,98108,47.551,122.3,2460,6000,47,0,4,4470,8010
3.2e+05,2015,486,4,2.5,1920,7277,2,0,0,4,8,1920,0,1990,1990,98031,47.406,122.19,2300,7645,25,0,6.5,4220,9565
2.7e+05,2014,277,3,1.5,1230,7500,1,0,0,3,7,1230,0,1962,1962,98198,47.42,122.33,1260,7800,52,0,4.5,2490,9030
2.53e+05,2014,303,3,1,1580,8240,1,0,0,4,7,1040,540,1978,1978,98030,47.354,122.18,1480,9200,36,0,4,3060,10780
1.15e+06,2014,285,2,2.25,2320,9300,1,0,4,5,9,1920,400,1937,1937,98115,47.681,122.27,2790,9300,77,0,4.25,5110,11620
5.42e+05,2014,263,3,2.5,1990,15985,1,0,0,3,8,1540,450,1964,1964,98007,47.62,122.14,2470,10125,50,0,5.5,4460,12115
2.565e+05,2015,431,3,2,1320,8568,1,0,0,3,7,1320,0,1993,1993,98042,47.39,122.16,1600,8463,22,0,5,2920,9783
4e+05,2015,473,3,2.5,2080,7877,2,0,0,3,9,2080,0,1987,1987,98058,47.44,122.15,2550,7660,28,0,5.5,4630,9740
4.51e+05,2014,176,5,2.75,2830,8925,1,0,0,3,7,2830,0,1967,1967,98034,47.731,122.18,1700,8539,47,0,7.75,4530,11369
7.5e+05,2014,285,4,2.5,3020,13122,2,0,0,3,9,2540,480,1997,1997,98052,47.699,122.11,3020,10873,17,0,6.5,6040,13893
5.57e+05,2014,129,4,2.5,2840,4500,2,0,0,3,8,2840,0,2012,2012,98028,47.768,122.24,2840,4939,2,0,6.5,5680,7779
6.15e+05,2015,484,2,1.5,880,2400,1,0,0,3,7,880,0,1929,1929,98122,47.614,122.3,1220,4440,86,0,3.5,2100,5320
7.599e+05,2014,204,4,2.5,3000,5639,2,0,0,3,8,3000,0,2008,2008,98052,47.707,122.11,3000,4587,6,0,6.5,6000,7587
5.15e+05,2014,127,3,1.75,1580,9147,1,0,1,4,7,1210,370,1967,1967,98008,47.607,122.11,2600,23564,47,0,4.75,4180,25144
4.05e+05,2015,485,3,1.75,2390,6000,1,0,0,3,6,1240,1150,1908,1908,98118,47.536,122.27,2020,6000,107,0,4.75,4410,8390
6.3e+05,2015,441,3,2,1470,6000,1,0,0,3,8,1090,380,1950,1996,98033,47.683,122.2,1880,7799,65,1,5,3350,9269
1.505e+06,2015,411,5,3,3300,33474,1,0,3,3,9,1870,1430,1957,1991,98040,47.567,122.21,3836,20953,58,1,8,7136,24253
4.626e+05,2014,311,3,1.75,1430,11761,1,0,0,4,8,1430,0,1964,1964,98052,47.669,122.16,2040,10035,50,0,4.75,3470,11465
3.11e+05,2014,279,5,3,2020,5917,1,0,0,3,7,1220,800,1993,1993,98108,47.548,122.29,2130,5529,21,0,8,4150,7549
3.5e+05,2014,255,2,1,1280,5250,1,0,0,4,7,1140,140,1942,1942,98126,47.526,122.38,1050,5250,72,0,3,2330,6530
3.25e+05,2015,440,6,2,2780,13950,2,0,0,4,7,2780,0,1955,1964,98030,47.374,122.23,2120,13950,60,1,8,4900,16730
5.65e+05,2014,215,3,1.5,1540,3570,1,0,0,5,7,1490,50,1930,1930,98105,47.669,122.33,1620,4080,84,0,4.5,3160,5620
1.7495e+05,2014,135,3,1,1060,5200,1,0,0,5,6,1060,0,1970,1970,98042,47.364,122.09,1380,5200,44,0,4,2440,6260
3.4e+05,2014,298,2,1,1280,9690,1,0,0,4,6,640,640,1919,1919,98118,47.534,122.28,1630,15884,95,0,3,2910,17164
5.02e+05,2015,451,3,2.75,2010,11200,1,0,0,3,8,1360,650,1979,1979,98028,47.773,122.25,2200,10640,36,0,5.75,4210,12650
3.365e+05,2014,190,3,2.25,1420,3433,2,0,0,4,7,1420,0,1981,1981,98034,47.724,122.16,1150,3432,33,0,5.25,2570,4852
3.16e+05,2014,262,4,2.5,2320,7379,2,0,0,3,8,2320,0,1987,1987,98003,47.343,122.32,2230,7614,27,0,6.5,4550,9934
4.267e+05,2014,342,3,1.75,2080,7700,1,0,0,5,7,1600,480,1968,1968,98056,47.538,122.18,1680,7700,46,0,4.75,3760,9780
2.2e+05,2015,401,3,1.75,1230,8917,1,0,0,4,7,1230,0,1966,1966,98058,47.453,122.17,1420,7938,49,0,4.75,2650,9168
3.14e+05,2015,438,3,1.75,1620,9600,1,0,0,4,7,1620,0,1966,1966,98059,47.475,122.16,1660,10200,49,0,4.75,3280,11820
3.5756e+05,2014,188,2,1.75,1210,1032,2,0,0,3,8,1210,0,2014,2014,98029,47.552,122,1210,1090,0,0,3.75,2420,2300
8.45e+05,2015,457,4,2.5,2390,5071,2,0,0,3,9,1760,630,1988,1988,98122,47.614,122.28,1940,5071,27,0,6.5,4330,7461
2.6e+05,2014,196,3,1.75,1100,10968,1,0,0,5,7,1100,0,1984,1984,98042,47.363,122.08,1400,7799,30,0,4.75,2500,8899
6.26e+05,2014,122,3,2.25,1750,1572,2,0,0,3,9,1470,280,2005,2005,98102,47.65,122.32,2410,3050,9,0,5.25,4160,4800
1.06e+06,2015,465,4,3.5,4220,8417,3,0,0,3,10,4220,0,2012,2012,98075,47.587,122.05,3730,8435,3,0,7.5,7950,12655
7.65e+05,2014,135,5,3.75,3580,14275,2,0,0,3,10,3190,390,1999,1999,98027,47.532,122.06,2740,14300,15,0,8.75,6320,17880
1.72e+05,2015,431,3,1,1350,9680,1,0,0,4,7,820,530,1959,1959,98023,47.327,122.35,1320,9225,56,0,4,2670,10575
4.3e+05,2014,345,3,1,1740,4800,1,0,0,3,8,1740,0,1952,1952,98118,47.56,122.27,1600,4800,62,0,4,3340,6540
3.22e+05,2015,445,3,1,1230,9660,1,0,0,3,7,1230,0,1968,1968,98053,47.683,122.06,1380,10125,47,0,4,2610,11355
4.59e+05,2014,345,2,1.75,1170,4887,1,0,0,3,6,1020,150,1929,1929,98117,47.695,122.37,1170,5441,85,0,3.75,2340,6611
5.35e+05,2014,258,3,1.75,2020,10031,1,0,0,5,7,1370,650,1952,1952,98155,47.749,122.32,1500,8456,62,0,4.75,3520,10476
4e+05,2015,424,3,2,1170,3868,1,0,0,4,7,1170,0,1925,1925,98118,47.554,122.29,1400,3800,90,0,5,2570,4970
4.95e+05,2015,389,5,2.5,2200,4942,2,0,0,3,8,2200,0,1989,1989,98029,47.577,122,2200,5924,26,0,7.5,4400,8124
5.2e+05,2014,353,4,0.75,1960,8277,1,1,4,4,7,1320,640,1923,1986,98198,47.365,122.33,1940,8402,91,1,4.75,3900,10362
3.75e+05,2014,168,2,1,940,9839,1,0,0,3,6,940,0,1910,1910,98136,47.538,122.39,1330,8740,104,0,3,2270,9680
2.5e+05,2014,265,5,1.75,2320,7700,1,0,0,5,7,1290,1030,1962,1962,98001,47.343,122.28,1740,7210,52,0,6.75,4060,9530
9.61e+05,2014,320,5,2.75,2590,6120,2,0,0,3,8,2590,0,1909,1909,98105,47.667,122.33,1390,3060,105,0,7.75,3980,5650
3.9e+05,2014,175,4,2.5,2340,8548,2,0,0,3,8,2340,0,1993,1993,98031,47.421,122.18,1970,6818,21,0,6.5,4310,9158
4.5e+05,2015,414,2,1.5,960,1000,2,0,0,3,8,920,40,2008,2008,98103,47.649,122.33,1200,1297,7,0,3.5,2160,2257
7.5e+05,2015,473,2,1,1620,6120,1,0,0,3,7,1620,0,1951,1951,98115,47.673,122.33,1650,4590,64,0,3,3270,6210
2.71e+05,2014,270,4,1.75,1490,9112,1,0,0,3,6,970,520,1940,1940,98146,47.499,122.34,1650,8411,74,0,5.75,3140,9901
2.79e+05,2015,380,4,2.75,2180,8475,1,0,0,4,7,1330,850,1987,1987,98031,47.404,122.17,1500,7140,28,0,6.75,3680,9320
9.01e+05,2015,473,4,3.25,1560,4080,1,0,0,3,7,1560,0,1916,1916,98126,47.535,122.38,1370,4080,99,0,7.25,2930,5640
5.14e+05,2014,161,3,1.75,1720,5899,1,0,1,3,8,1220,500,1986,1986,98136,47.54,122.39,1900,6244,28,0,4.75,3620,7964
2.05e+05,2015,438,2,1.75,1740,5100,1,0,0,3,6,580,1160,1915,1915,98108,47.521,122.33,1440,5100,100,0,3.75,3180,6840
2.92e+05,2014,338,4,3,1984,4460,2,0,0,3,7,1984,0,2012,2012,98002,47.353,122.21,2095,3402,2,0,7,4079,5386
2.95e+05,2015,487,3,1.75,1520,6559,1,0,0,4,7,1170,350,1992,1992,98038,47.35,122.04,1520,6095,23,0,4.75,3040,7615
4.8e+05,2015,471,4,2.5,2940,9172,2,0,0,3,9,2940,0,2006,2006,98001,47.344,122.27,2660,7955,9,0,6.5,5600,10895
9.2625e+05,2015,450,4,1.75,2390,17717,1,0,0,4,8,2390,0,1964,1964,98040,47.575,122.22,2390,10730,51,0,5.75,4780,13120
4.65e+05,2014,332,3,2.5,1450,5175,1,0,0,3,8,1030,420,1995,1995,98133,47.708,122.34,1740,9250,19,0,5.5,3190,10700
5.23e+05,2014,314,4,2.5,3180,20870,2,0,0,3,8,2120,1060,1967,1967,98034,47.718,122.24,2700,14190,47,0,6.5,5880,17370
3.75e+05,2014,214,3,1,980,7296,1,0,0,3,7,980,0,1967,1967,98034,47.729,122.23,1280,7296,47,0,4,2260,8276
3.15e+05,2014,222,4,2.5,2080,5650,1,0,0,3,7,1680,400,1950,1950,98178,47.511,122.26,1270,5650,64,0,6.5,3350,7730
5.55e+05,2015,453,3,2.5,2690,4819,2,0,0,3,7,2690,0,2004,2004,98065,47.53,121.85,2360,4829,11,0,5.5,5050,7519
5.71e+05,2014,292,5,1.75,2280,43560,1,0,1,4,8,1380,900,1949,1949,98166,47.456,122.36,1940,17664,65,0,6.75,4220,19944
3.26e+05,2014,148,3,2.75,1720,28000,1,0,0,4,7,1720,0,1958,1958,98058,47.438,122.18,2000,41817,56,0,5.75,3720,43537
3.598e+05,2014,217,5,2.5,2170,2752,2,0,0,3,8,2170,0,2014,2014,98106,47.517,122.35,1800,2752,0,0,7.5,3970,4922
2.46e+05,2015,431,3,1,990,9145,1,0,0,4,6,990,0,1939,1939,98146,47.502,122.36,1640,8320,76,0,4,2630,9310
4.95e+05,2014,272,2,1,1670,14695,1,0,0,5,7,1670,0,1930,1930,98033,47.7,122.2,1800,11355,84,0,3,3470,13025
3.9e+05,2014,306,5,1.75,2290,7900,1,0,0,4,7,1190,1100,1965,1965,98133,47.758,122.36,1870,8250,49,0,6.75,4160,10540
2.5554e+05,2015,464,3,1,1360,6186,1,0,0,4,6,760,600,1941,1941,98133,47.75,122.33,1610,7453,74,0,4,2970,8813
1.3e+06,2015,436,3,1,2040,7936,1,0,3,5,8,1680,360,1940,1940,98177,47.703,122.39,2300,10080,75,0,4,4340,12120
3.03e+05,2014,191,4,2.25,2560,8927,1,0,0,3,7,1790,770,1976,1976,98001,47.34,122.27,1920,9669,38,0,6.25,4480,12229
3.132e+05,2015,395,3,2.5,1950,4197,2,0,0,3,7,1950,0,2013,2013,98042,47.361,122.08,2300,4178,2,0,5.5,4250,6128
6.25e+05,2014,189,4,1,1600,5500,1,0,0,4,7,1600,0,1946,1946,98117,47.698,122.39,1900,5500,68,0,5,3500,7100
3.5e+05,2015,458,2,1,1160,5395,1,0,0,3,7,860,300,1940,1940,98103,47.701,122.35,1664,5363,75,0,3,2824,6523
7.6e+05,2015,383,4,2.5,3600,1.5551e+05,2,0,0,3,9,3600,0,2004,2004,98010,47.354,121.99,3410,34412,11,0,6.5,7010,38012
3.6295e+05,2014,359,4,1.75,2140,1.5987e+05,1,0,0,4,7,1140,1000,1960,1960,98031,47.423,122.22,1830,15569,54,0,5.75,3970,17709
2.255e+05,2014,203,4,2,1440,7950,1,0,0,5,6,1440,0,1962,1962,98058,47.452,122.08,1530,20037,52,0,6,2970,21477
4.25e+05,2014,210,3,1,980,4800,1,0,0,3,7,980,0,1926,1926,98118,47.566,122.27,2030,7200,88,0,4,3010,8180
2.91e+05,2014,347,4,1,1590,24330,1,0,0,3,6,1140,450,1942,1942,98168,47.491,122.31,1000,16228,72,0,5,2590,17818
3.9745e+05,2014,235,4,2.5,2650,9451,2,0,0,4,8,2650,0,1993,1993,98042,47.369,122.13,2510,8850,21,0,6.5,5160,11500
4.98e+05,2014,143,2,2,1140,8282,1,0,0,3,6,1140,0,1924,2009,98033,47.695,122.21,1650,9000,90,1,4,2790,10140
3.65e+05,2015,414,2,1,870,5689,1,0,0,4,7,870,0,1948,1948,98103,47.699,122.35,1100,5711,67,0,3,1970,6581
4.2e+05,2014,348,3,2.25,1800,9800,1,0,0,4,7,1300,500,1959,1959,98028,47.739,122.24,1680,9545,55,0,5.25,3480,11345
7.4995e+05,2014,140,3,2.5,2770,10773,2,0,2,3,9,2770,0,1992,1992,98008,47.575,122.12,2530,10423,22,0,5.5,5300,13193
2.8e+05,2014,332,3,2.5,1800,8697,2,0,0,3,8,1800,0,1987,1987,98023,47.312,122.4,1770,8390,27,0,5.5,3570,10190
3.95e+05,2015,422,2,1,700,7457,1,0,0,3,6,700,0,1943,1943,98108,47.535,122.3,1500,7130,72,0,3,2200,7830
5.75e+05,2014,182,3,1.75,2680,8625,1,0,0,5,8,1590,1090,1974,1974,98027,47.532,122.06,2620,14275,40,0,4.75,5300,16955
7.82e+05,2014,143,4,2.5,2380,9614,2,0,0,4,10,2380,0,1991,1991,98006,47.562,122.12,2560,9770,23,0,6.5,4940,12150
1.7e+05,2015,417,2,1,860,5265,1,0,0,3,6,860,0,1931,1931,98178,47.505,122.27,1650,8775,84,0,3,2510,9635
8.35e+05,2014,179,3,2.25,2120,54014,2,0,0,4,9,2120,0,1964,1964,98005,47.648,122.16,3280,50690,50,0,5.25,5400,52810
4.09e+05,2015,440,4,2.75,3230,12651,2,0,0,4,8,3230,0,2002,2002,98001,47.316,122.25,2550,12081,13,0,6.75,5780,15311
2.58e+05,2014,277,3,1.75,2090,7461,1,0,0,3,6,1200,890,1986,1986,98030,47.376,122.18,1420,7462,28,0,4.75,3510,9552
5.2e+05,2015,452,2,1,950,3880,1,0,0,4,6,950,0,1919,1919,98117,47.687,122.39,1660,3880,96,0,3,2610,4830
8.8e+05,2014,146,3,2,2130,35169,1,0,0,4,8,2130,0,1989,1989,98072,47.749,122.12,2860,43560,25,0,5,4990,45690
3.975e+05,2015,460,3,2.5,1860,44093,1,0,0,3,7,1860,0,1978,1978,98055,47.438,122.19,1900,6130,37,0,5.5,3760,7990
8.75e+05,2015,414,3,2.75,3270,39586,1,0,0,3,11,3270,0,1988,1988,98077,47.731,122.08,3480,35998,27,0,5.75,6750,39268
5.35e+05,2014,310,3,1,1090,3000,1,0,0,4,8,1090,0,1929,1929,98117,47.689,122.38,1570,5080,85,0,4,2660,6170
4.49e+05,2014,228,4,2.75,2090,14141,1,0,0,4,8,1680,410,1941,1941,98166,47.433,122.35,1990,12920,73,0,6.75,4080,15010
3.53e+05,2014,126,3,1,1350,7740,1,0,0,4,6,860,490,1947,1947,98125,47.71,122.29,1130,7740,67,0,4,2480,9090
2.675e+05,2014,290,3,1.5,1600,9072,1,0,0,4,7,1600,0,1963,1963,98030,47.374,122.22,1710,8000,51,0,4.5,3310,9600
7e+05,2014,159,4,3,3150,7778,2,0,0,3,9,3150,0,2000,2000,98075,47.597,122.02,2970,6500,14,0,7,6120,9650
4.15e+05,2015,443,3,2.25,1820,9694,1,0,0,3,7,1240,580,1977,1977,98074,47.616,122.05,1820,9694,38,0,5.25,3640,11514
7.55e+05,2014,140,6,2,2150,4505,1,0,0,3,7,1270,880,1952,1952,98119,47.651,122.37,1740,4505,62,0,8,3890,6655
4.7222e+05,2014,214,3,2.5,2010,2212,2,0,0,3,8,1390,620,2014,2014,98029,47.552,122,1690,1619,0,0,5.5,3700,3629
3.35e+05,2014,203,3,1.75,1400,7920,1,0,0,3,7,1400,0,1965,1965,98034,47.731,122.2,1310,7876,49,0,4.75,2710,9276
5.28e+05,2014,360,4,2.25,1910,8005,1,0,0,3,8,1280,630,1960,1960,98125,47.726,122.3,1860,8010,54,0,6.25,3770,9920
4.72e+05,2014,353,3,2,2200,21890,1,0,2,3,8,1200,1000,1961,1961,98155,47.758,122.27,2600,15162,53,0,5,4800,17362
6.35e+05,2014,331,3,1.5,2240,5300,1,0,0,5,7,1120,1120,1955,1955,98117,47.693,122.39,1740,7110,59,0,4.5,3980,9350
6.04e+05,2014,339,4,3,1960,5000,1,0,0,5,7,1050,910,1965,1965,98136,47.521,122.39,1360,5000,49,0,7,3320,6960
2.49e+05,2014,175,4,2.25,1830,6136,2,0,0,3,7,1830,0,1990,1990,98030,47.367,122.18,1830,7664,24,0,6.25,3660,9494
2.5e+05,2014,167,3,1.75,1160,6134,1,0,0,3,7,1160,0,1998,1998,98002,47.341,122.22,1330,6301,16,0,4.75,2490,7461
5.35e+05,2014,237,4,2.5,2710,12138,1,0,0,3,8,1700,1010,1968,1968,98155,47.766,122.29,2390,10052,46,0,6.5,5100,12762
1.49e+06,2014,251,5,3.5,3620,7821,2,0,2,3,10,2790,830,1958,2010,98040,47.574,122.22,2690,9757,56,1,8.5,6310,13377
2.65e+05,2015,414,3,2,1690,9516,1,0,0,3,7,1690,0,1997,1997,98022,47.213,122,1850,9516,18,0,5,3540,11206
3.08e+05,2015,460,3,2.5,2320,7140,2,0,0,3,8,2320,0,1990,1990,98003,47.275,122.3,2360,7955,25,0,5.5,4680,10275
5.11e+05,2014,304,3,1,1430,3455,1,0,0,3,7,980,450,1947,1947,98103,47.687,122.34,1450,4599,67,0,4,2880,6029
1.26e+06,2014,280,3,3.5,3220,3960,2,0,4,3,10,2760,460,1991,1991,98116,47.591,122.38,3080,4444,23,0,6.5,6300,7664
5.1e+05,2015,451,3,2,1410,11995,1,0,0,4,8,1410,0,1965,1965,98006,47.572,122.13,2690,12650,50,0,5,4100,14060
4.3e+05,2015,416,3,2.5,1690,1310,2,0,0,3,8,1140,550,2004,2004,98136,47.54,122.39,1640,1321,11,0,5.5,3330,3011
5.95e+05,2014,299,2,1.75,1280,8500,1,0,0,3,7,1280,0,1953,2010,98033,47.655,122.19,1950,10356,61,1,3.75,3230,11636
4.45e+05,2014,158,2,1,1440,3225,1,0,0,3,7,960,480,1915,1915,98103,47.665,122.34,1160,3630,99,0,3,2600,5070
5.7e+05,2014,263,4,2.75,3140,10918,1,0,0,3,8,1900,1240,1968,1986,98034,47.709,122.24,3170,10918,46,1,6.75,6310,14058
1e+06,2014,197,4,2.75,3090,16538,3,0,0,4,8,2590,500,1919,1987,98116,47.58,122.4,1500,5130,95,1,6.75,4590,8220
4.35e+05,2014,201,2,1,1650,5106,1,0,0,3,7,1090,560,1960,1960,98115,47.699,122.31,1300,6947,54,0,3,2950,8597
7.5e+05,2014,312,4,2.75,2310,10232,1,0,0,5,8,1310,1000,1980,1980,98006,47.551,122.15,2820,9886,34,0,6.75,5130,12196
2.66e+05,2014,285,3,1.5,1120,8250,1,0,0,4,7,1120,0,1957,1957,98056,47.49,122.18,1320,8400,57,0,4.5,2440,9520
5.15e+05,2015,407,2,1,970,3300,1,0,0,4,7,970,0,1916,1916,98103,47.661,122.34,1060,3600,99,0,3,2030,4570
5.36e+05,2015,424,3,2.5,1990,7397,2,0,0,3,9,1990,0,1993,1993,98072,47.77,122.17,2210,7397,22,0,5.5,4200,9387
2.57e+05,2015,445,3,1.75,1540,8223,1,0,0,4,7,1070,470,1987,1987,98042,47.367,122.09,1240,8113,28,0,4.75,2780,9653
7.25e+05,2014,265,3,2.5,3570,35271,2,0,0,3,9,3570,0,1997,1997,98027,47.478,122.03,3510,37194,17,0,5.5,7080,40764
7.7595e+05,2014,170,4,2.5,2970,4400,2,0,0,3,8,2970,0,2014,2014,98052,47.705,122.11,3010,4892,0,0,6.5,5980,7862
4.5e+05,2014,191,3,2.5,1810,914,3,0,0,3,8,1380,430,2008,2008,98116,47.573,122.39,1810,914,6,0,5.5,3620,2724
2.17e+05,2014,271,3,1.5,1860,8505,1,0,0,4,7,1860,0,1967,1967,98023,47.311,122.36,1810,8262,47,0,4.5,3670,10122
7.9e+05,2015,471,3,2.5,2390,15084,2,0,0,3,8,2390,0,2000,2000,98010,47.339,122.05,1850,17494,15,0,5.5,4240,19884
1.595e+06,2015,453,4,4.25,4645,7757,2,0,0,3,10,3855,790,2006,2006,98112,47.625,122.29,2150,6970,9,0,8.25,6795,11615
4.74e+05,2014,280,3,1,1140,4560,1,0,0,4,6,770,370,1944,1944,98117,47.689,122.36,1340,3980,70,0,4,2480,5120
9.35e+05,2015,409,4,2,1220,7489,2,0,0,3,7,1220,0,1903,1903,98122,47.613,122.31,1220,3750,112,0,6,2440,4970
4.05e+05,2015,474,3,1,1280,11625,1,0,0,4,7,1280,0,1977,1977,98053,47.683,122.06,1320,10875,38,0,4,2600,12155
1.399e+06,2014,280,3,2.5,2560,3600,2,0,0,3,9,2110,450,1967,2003,98112,47.632,122.28,2690,4800,47,1,5.5,5250,7360
3.92e+05,2014,223,2,1.5,940,5000,1,0,0,4,7,810,130,1925,1925,98126,47.538,122.37,940,5026,89,0,3.5,1880,5966
5.157e+05,2014,293,3,2.5,2180,9722,2,0,0,3,8,2180,0,1994,1994,98056,47.527,122.17,2440,9722,20,0,5.5,4620,11902
4.3225e+05,2015,440,3,2.25,1440,6232,2,0,0,3,7,1440,0,1985,1985,98029,47.566,122.02,1740,5999,30,0,5.25,3180,7439
8.95e+05,2015,479,4,3,3570,10273,1,0,3,3,9,2630,940,1935,2007,98074,47.639,122.08,3640,15324,80,1,7,7210,18894
1.9425e+05,2014,300,3,2.25,2190,8834,1,0,0,3,7,1390,800,1987,1987,98001,47.263,122.24,1490,8766,27,0,5.25,3680,10956
3.8e+05,2014,235,2,1,1120,7560,1,0,1,3,6,1120,0,1947,1947,98177,47.77,122.39,1120,7200,67,0,3,2240,8320
7.1e+05,2015,394,4,2.5,3220,18618,2,0,1,3,10,3220,0,1991,1991,98056,47.533,122.18,2650,11896,24,0,6.5,5870,15116
2.525e+05,2014,263,2,1.5,1280,8710,1,0,0,3,7,1280,0,1967,1967,98058,47.447,122.16,1520,9375,47,0,3.5,2800,10655
1.225e+06,2015,440,6,2.25,2930,4320,2,0,0,3,9,2130,800,1913,1913,98112,47.63,122.31,2860,4320,102,0,8.25,5790,7250
4.17e+05,2014,345,3,1.75,1590,11454,1,0,0,4,8,1590,0,1979,1979,98056,47.505,122.19,1970,9960,35,0,4.75,3560,11550
4.4e+05,2015,429,3,2,1800,10950,1,0,0,4,8,1800,0,1982,1982,98006,47.557,122.16,2400,11300,33,0,5,4200,13100
5.95e+05,2014,313,3,1.75,2060,3600,1,0,0,3,7,1180,880,1905,1985,98119,47.639,122.37,1730,2475,109,1,4.75,3790,4535
6.95e+05,2015,485,2,1,1140,3990,1,0,0,3,7,1140,0,1924,1924,98103,47.655,122.33,1800,5700,91,0,3,2940,6840
6.55e+05,2014,148,4,2.5,2990,5669,2,0,0,3,8,2990,0,2003,2003,98074,47.612,122.01,3110,5058,11,0,6.5,6100,8048
2.77e+05,2014,166,3,1,1100,8536,1,0,0,4,7,1100,0,1957,1957,98118,47.516,122.26,1570,8040,57,0,4,2670,9140
4.2e+05,2014,160,2,1,860,3880,1,0,0,4,6,860,0,1916,1916,98117,47.686,122.39,1230,4260,98,0,3,2090,5120
6.7475e+05,2014,303,4,2.5,2590,9753,2,0,0,3,10,2590,0,1993,1993,98075,47.585,122.03,2800,9917,21,0,6.5,5390,12507
3.6995e+05,2014,265,3,2.5,1360,3718,2,0,0,3,7,1360,0,1987,1987,98052,47.683,122.1,1090,3718,27,0,5.5,2450,5078
2.15e+05,2014,189,3,1,1200,7280,1,0,0,4,7,1200,0,1967,1967,98032,47.372,122.28,1200,8400,47,0,4,2400,9600
2.03e+05,2015,430,3,1.5,1200,9120,1,0,0,3,7,1000,200,1963,1963,98055,47.455,122.19,1640,9200,52,0,4.5,2840,10400
4.75e+05,2014,127,2,1,820,2723,1,0,0,3,7,820,0,1921,1921,98103,47.662,122.34,1370,3850,93,0,3,2190,4670
2.27e+05,2014,307,3,1,1280,7198,1,0,0,5,6,1280,0,1916,1983,98022,47.209,122,1260,7198,98,1,4,2540,8478
7.5e+05,2014,127,3,2.75,2520,5401,1,0,0,4,7,1360,1160,1946,1946,98119,47.645,122.37,1800,5036,68,0,5.75,4320,7556
2.575e+05,2014,236,3,2,1300,9334,1,0,0,5,7,1300,0,1981,1981,98178,47.486,122.24,2210,9636,33,0,5,3510,10936
4.9995e+05,2014,263,3,3.5,1820,1991,2,0,0,3,8,1430,390,2014,2014,98144,47.596,122.3,1550,1460,0,0,6.5,3370,3280
3.75e+05,2014,216,4,2.5,1800,8432,1,0,0,4,7,1200,600,1960,1960,98133,47.746,122.34,1780,8432,54,0,6.5,3580,10232
2.3e+05,2014,233,2,2,1340,7605,1,0,0,3,7,1340,0,1992,1992,98022,47.194,121.98,1670,7136,22,0,4,3010,8476
4.05e+05,2014,128,2,1,1020,8155,1,0,0,4,7,1020,0,1948,1948,98177,47.726,122.36,1430,8157,66,0,3,2450,9177
2.65e+05,2014,202,3,2.5,1780,6527,2,0,0,3,8,1780,0,1989,1989,98092,47.258,122.22,2040,8840,25,0,5.5,3820,10620
5.69e+05,2014,160,5,3,3670,10583,1,0,0,5,8,2060,1610,1952,1952,98155,47.759,122.28,2720,13865,62,0,8,6390,17535
7.1613e+05,2014,231,3,2.25,2110,7279,1,0,0,4,9,2110,0,1984,1984,98033,47.667,122.17,2130,7279,30,0,5.25,4240,9389
2.16e+06,2014,230,3,3.5,3080,6495,2,0,3,3,11,2530,550,1996,2006,98199,47.632,122.39,4120,8620,18,1,6.5,7200,11700
2.15e+05,2014,339,3,1.5,1100,33600,1,0,0,3,7,1100,0,1967,1967,98001,47.319,122.29,1570,32700,47,0,4.5,2670,33800
6.85e+05,2014,297,4,1,1550,15239,1,1,4,3,6,1370,180,1930,1930,98166,47.45,122.38,1790,22047,84,0,5,3340,23597
5.25e+05,2015,443,3,3.25,2200,7440,2,0,0,4,7,1710,490,1947,1947,98118,47.541,122.27,1260,6765,68,0,6.25,3460,8965
8e+05,2014,176,3,1.75,2080,75794,1,0,0,3,7,2080,0,1958,1958,98033,47.702,122.19,1870,11020,56,0,4.75,3950,13100
5.51e+05,2015,423,3,1,1580,6000,1,0,0,5,7,1580,0,1947,1947,98027,47.529,122.03,1580,6000,68,0,4,3160,7580
4.49e+05,2015,386,4,2,1870,6000,1,0,0,3,7,1870,0,1956,1956,98125,47.715,122.31,1520,7169,59,0,6,3390,9039
1.245e+05,2015,446,2,1,840,6480,1,0,0,4,5,840,0,1954,1954,98001,47.264,122.26,1100,7300,61,0,3,1940,8140
6.9e+05,2014,208,4,2.5,2120,8448,2,0,0,4,9,2120,0,1989,1989,98029,47.565,122.01,2140,8122,25,0,6.5,4260,10242
2.798e+05,2015,451,3,1.75,1410,2052,2,0,0,3,8,1410,0,2014,2014,98106,47.517,122.35,1410,1988,1,0,4.75,2820,3398
1.2989e+06,2015,443,5,2.25,2690,10800,1,0,3,4,8,2020,670,1956,1956,98040,47.582,122.25,3380,9134,59,0,7.25,6070,11824
3.2e+05,2014,336,2,1,1140,3834,1,0,0,3,6,1140,0,1911,1911,98126,47.564,122.38,1190,5750,103,0,3,2330,6890
3.64e+05,2015,416,3,2.25,1420,6600,1,0,0,3,7,1160,260,1987,1987,98028,47.77,122.27,1920,7902,28,0,5.25,3340,9322
5.55e+05,2015,485,2,1.5,1190,1361,2,0,0,3,8,1190,0,2007,2007,98122,47.616,122.3,1280,3360,8,0,3.5,2470,4550
6.6299e+05,2014,143,3,1.75,1240,3600,1,0,0,5,7,1240,0,1926,1926,98116,47.58,122.41,1660,3600,88,0,4.75,2900,4840
1.025e+06,2014,183,4,3.5,4370,10860,2,0,0,3,11,4370,0,2008,2008,98059,47.507,122.15,3560,8070,6,0,7.5,7930,12440
5.0725e+05,2015,394,3,1.75,1400,5750,1,0,2,3,6,1100,300,1915,1915,98126,47.566,122.38,1500,5175,100,0,4.75,2900,6575
2.07e+05,2014,222,2,1,820,4860,1,0,0,5,6,820,0,1955,1955,98118,47.53,122.27,1240,6000,59,0,3,2060,6820
2.98e+05,2014,202,3,2.5,1852,4000,2,0,0,3,7,1852,0,2014,2014,98002,47.346,122.21,2166,4000,0,0,5.5,4018,5852
1.08e+06,2014,132,3,2.5,3720,11610,2,0,0,3,11,3720,0,1982,1982,98074,47.636,122.05,3530,11877,32,0,5.5,7250,15597
2.4e+05,2015,403,4,1,1220,8075,1,0,0,2,7,890,330,1969,1969,98001,47.334,122.28,1290,7800,46,0,5,2510,9020
4.668e+05,2014,155,3,2.5,1480,14250,2,0,0,3,7,1480,0,1996,1996,98033,47.66,122.19,1660,14250,18,0,5.5,3140,15730
7.3e+05,2014,181,2,2.25,2130,4920,1,0,4,4,7,1530,600,1941,1941,98116,47.573,122.41,2130,4920,73,0,4.25,4260,7050
3.2e+05,2015,447,4,2.5,1940,7040,2,0,0,3,8,1940,0,1998,1998,98092,47.263,122.21,2400,7145,17,0,6.5,4340,9085
4.3e+05,2015,414,3,1.75,3440,10428,1,0,0,5,8,3440,0,1974,1974,98058,47.449,122.13,2160,8400,41,0,4.75,5600,11840
5.43e+05,2014,221,4,2.25,2060,8767,2,0,0,3,8,2060,0,1983,1983,98052,47.723,122.1,1610,8062,31,0,6.25,3670,10122
4.7e+05,2015,438,4,2.75,2310,7350,1,0,0,3,8,1670,640,1989,1989,98011,47.751,122.18,2600,6077,26,0,6.75,4910,8387
4.2e+05,2014,173,3,2,1200,5029,1,0,0,3,6,880,320,1937,1937,98115,47.694,122.29,1510,5854,77,0,5,2710,7054
3.95e+05,2015,470,5,2.5,2070,9600,1,0,0,3,7,1270,800,1962,1962,98146,47.5,122.36,1950,7800,53,0,7.5,4020,9870
9.75e+05,2015,459,3,2.5,2530,7000,2,0,4,3,9,2530,0,1915,1999,98136,47.547,122.4,2380,7000,100,1,5.5,4910,9530
5.27e+05,2014,222,3,2.25,2240,6450,1,0,0,3,7,1440,800,1979,1979,98125,47.703,122.31,1390,6450,35,0,5.25,3630,8690
6.6495e+05,2014,173,5,3,3190,7081,1,0,2,3,9,1890,1300,2013,2013,98178,47.509,122.24,2270,7623,1,0,8,5460,10813
2.95e+05,2014,167,4,2.5,1660,9760,2,0,0,3,7,1660,0,1994,1994,98030,47.364,122.19,1580,9614,20,0,6.5,3240,11274
4.37e+05,2014,249,5,2,2190,8316,1,0,0,3,7,1390,800,1961,1961,98108,47.549,122.3,2010,8316,53,0,7,4200,10506
3.86e+05,2015,471,4,2.25,2810,8560,1,0,0,3,8,1610,1200,1979,1979,98058,47.444,122.12,2400,7600,36,0,6.25,5210,10410
6.4e+05,2014,170,2,1.75,1760,4400,1,0,0,4,7,880,880,1930,1930,98103,47.65,122.34,1330,4180,84,0,3.75,3090,5940
3.15e+05,2014,162,2,1,970,5665,1,0,0,4,6,970,0,1908,1908,98118,47.551,122.27,1490,4429,106,0,3,2460,5399
4.28e+05,2014,159,3,2,1310,2550,1,0,0,3,7,780,530,1986,1986,98103,47.691,122.35,1460,5100,28,0,5,2770,6410
2.76e+05,2015,480,3,2,1370,8137,1,0,0,4,7,1370,0,1988,1988,98003,47.28,122.3,1660,8840,27,0,5,3030,10210
5.38e+05,2014,201,4,2.5,3260,10032,1,0,0,3,8,1960,1300,1978,1978,98125,47.72,122.32,1802,7249,36,0,6.5,5062,10509
5.6e+05,2014,189,2,1,1010,9219,1,0,0,4,7,1010,0,1960,1960,98033,47.689,122.2,1610,9219,54,0,3,2620,10229
1.375e+06,2014,299,5,3.75,3330,5042,2,0,2,3,9,2470,860,2014,2014,98103,47.65,122.34,1780,3990,0,0,8.75,5110,7320
2.875e+05,2014,297,4,2.25,2250,12000,2,0,0,3,8,2250,0,1985,1985,98032,47.371,122.27,2140,11871,29,0,6.25,4390,14121
4.35e+05,2015,464,4,2.25,1910,8400,2,0,0,3,7,1910,0,1975,1975,98072,47.735,122.17,1910,8400,40,0,6.25,3820,10310
4.04e+05,2014,152,3,1.5,2030,8880,1,0,0,3,7,1330,700,1963,1963,98108,47.559,122.31,2140,5592,51,0,4.5,4170,7622
3.65e+05,2015,376,2,1,910,7617,1,0,0,3,6,910,0,1936,1936,98125,47.733,122.31,1310,6624,79,0,3,2220,7534
1.15e+05,2014,188,1,2,1150,9812,1,0,0,4,7,1150,0,1962,1962,98001,47.295,122.28,1200,9812,52,0,3,2350,10962
1.387e+06,2015,471,4,3.5,4010,10880,2,0,3,4,11,3150,860,1990,1990,98040,47.536,122.21,3530,17310,25,0,7.5,7540,21320
6.802e+05,2015,396,2,1.5,1960,6000,1,0,0,3,8,1210,750,1951,1951,98103,47.685,122.33,2060,6000,64,0,3.5,4020,7960
3.21e+05,2014,142,3,2.25,1347,1292,3,0,0,3,7,1347,0,2010,2010,98125,47.731,122.29,1480,1865,4,0,5.25,2827,3212
3.05e+05,2014,321,4,2.5,2430,5959,2,0,0,3,8,2430,0,2002,2002,98092,47.335,122.19,2100,5414,12,0,6.5,4530,7844
6.68e+05,2014,201,5,3.5,3990,42436,2,0,0,3,9,2710,1280,2002,2002,98027,47.461,122,3030,41684,12,0,8.5,7020,45674
2.5e+05,2014,140,4,2,1960,7560,1,0,0,5,7,1160,800,1978,1978,98031,47.408,122.18,1950,7560,36,0,6,3910,9520
9.3775e+05,2015,447,4,2.75,2580,3560,1,0,0,5,7,1710,870,1917,1917,98115,47.675,122.3,1980,3800,98,0,6.75,4560,6380
4.05e+05,2014,245,4,2.5,1850,9136,2,0,0,3,8,1850,0,1997,1997,98059,47.494,122.16,1930,7873,17,0,6.5,3780,9723
6.35e+05,2014,255,3,1.75,2940,6000,1,0,2,4,8,1590,1350,1957,1957,98177,47.724,122.37,2880,8100,57,0,4.75,5820,11040
7.15e+05,2014,173,4,2.5,2650,30500,1,0,0,4,8,1680,970,1960,1960,98029,47.553,122.03,2650,30500,54,0,6.5,5300,33150
3.45e+05,2015,477,5,1.75,2840,12870,2,0,2,4,7,2840,0,1925,1925,98178,47.496,122.23,2170,9612,90,0,6.75,5010,12452
2e+05,2015,376,2,1,830,7200,1,0,0,2,6,830,0,1920,1920,98118,47.56,122.28,1150,6600,95,0,3,1980,7430
2.35e+05,2015,415,3,1.5,1300,7600,1,0,0,4,7,1300,0,1963,1963,98022,47.208,122,1570,7600,52,0,4.5,2870,8900
6.659e+05,2014,170,4,2.25,2870,5453,2,0,1,4,8,2220,650,1926,1926,98146,47.513,122.39,1660,4800,88,0,6.25,4530,7670
3.1e+05,2015,422,3,1,1520,6500,1,0,0,3,7,990,530,1958,1958,98198,47.416,122.33,1500,7500,57,0,4,3020,9020
4.12e+05,2014,188,3,1.75,1880,5752,1,0,0,4,7,940,940,1945,1945,98126,47.535,122.38,1110,5201,69,0,4.75,2990,7081
4e+05,2015,388,2,2,1050,1173,2,0,0,3,8,720,330,2004,2004,98122,47.618,122.3,1340,1317,11,0,4,2390,2367
1.065e+06,2014,312,4,2.25,3240,12930,2,0,0,4,9,2730,510,1968,1968,98040,47.537,122.22,2610,12884,46,0,6.25,5850,16124
3.6e+05,2015,403,4,2.5,1840,9611,2,0,0,3,7,1840,0,1996,1996,98178,47.496,122.25,1830,8505,19,0,6.5,3670,10345
4.15e+05,2014,347,4,1.75,2230,9625,1,0,4,3,8,1180,1050,1955,1955,98178,47.508,122.24,2300,8211,59,0,5.75,4530,10441
6.29e+05,2015,396,3,1.75,1460,12367,2,1,4,4,8,1120,340,1970,1970,98023,47.331,122.38,1970,18893,45,0,4.75,3430,20353
4.5e+05,2014,286,3,1,1360,3737,1,0,0,4,6,1360,0,1910,1910,98107,47.675,122.36,1820,4500,104,0,4,3180,5860
2.44e+05,2014,147,3,1,910,5250,1,0,0,4,6,910,0,1971,1971,98166,47.473,122.35,1650,10442,43,0,4,2560,11352
1.184e+06,2014,162,4,2.5,3200,7500,1,0,1,5,8,1860,1340,1948,1948,98115,47.683,122.27,2500,6500,66,0,6.5,5700,9700
6.6e+05,2014,326,3,2,2080,5750,1,0,0,5,7,1040,1040,1926,1926,98116,47.579,122.39,1710,4830,88,0,5,3790,6910
6.55e+05,2014,264,4,2.25,2200,9163,1,0,0,4,8,1430,770,1971,1971,98006,47.565,122.15,2420,9163,43,0,6.25,4620,11363
8.575e+05,2014,273,3,1.5,2040,3960,2,0,2,5,8,2040,0,1928,1928,98103,47.666,122.36,1540,3400,86,0,4.5,3580,5440
4.75e+05,2014,242,3,1.5,2480,5280,1,0,0,5,7,1620,860,1947,1947,98108,47.557,122.3,2090,4800,67,0,4.5,4570,7280
3.245e+05,2015,459,3,2.5,1590,4108,2,0,0,3,7,1590,0,2003,2003,98056,47.483,122.18,2160,3912,12,0,5.5,3750,5502
2.4145e+05,2014,222,3,1,1100,8138,1,0,0,3,7,1100,0,1949,1949,98155,47.739,122.33,1440,8131,65,0,4,2540,9231
7.65e+05,2015,464,3,2.5,2300,9752,2,0,2,3,8,2300,0,1968,2003,98075,47.583,122.08,2640,10764,47,1,5.5,4940,13064
2.1e+05,2014,167,1,1,930,7129,1,0,0,3,6,930,0,1948,1948,98133,47.723,122.33,1300,8075,66,0,2,2230,9005
3.1995e+05,2015,492,5,1.75,1710,11900,1,0,0,3,7,1070,640,1958,1958,98146,47.506,122.36,1030,10360,57,0,6.75,2740,12070
8.15e+05,2015,447,6,3,2860,17853,1,0,0,3,8,1430,1430,1962,2015,98006,47.546,122.17,1920,13452,53,1,9,4780,16312
3.6e+05,2015,484,2,1,880,1165,2,0,0,3,8,880,0,2005,2005,98122,47.619,122.3,1640,3825,10,0,3,2520,4705
1.0999e+06,2015,431,5,2.75,3520,6353,2,0,0,4,10,3520,0,2001,2001,98199,47.651,122.39,2520,6250,14,0,7.75,6040,9770
4.3e+05,2015,485,3,2,1540,6000,1,0,0,4,6,1540,0,1953,1953,98155,47.737,122.31,1490,8213,62,0,5,3030,9753
4.15e+05,2014,239,4,2.25,2240,12650,1,0,0,4,8,1730,510,1981,1981,98059,47.478,122.14,2150,12650,33,0,6.25,4390,14890
1.85e+05,2015,368,4,1,1400,8684,1,0,0,3,7,1400,0,1957,1957,98146,47.489,122.34,1520,8712,58,0,5,2920,10112
5.45e+05,2014,313,3,2.5,1990,5149,2,0,0,3,8,1990,0,2003,2003,98075,47.59,122.02,2280,4506,11,0,5.5,4270,6496
4.95e+05,2015,392,3,2.5,1860,3150,2,0,0,3,8,1860,0,2001,2001,98034,47.719,122.18,2050,3375,14,0,5.5,3910,5235
6.79e+05,2014,257,4,3.5,3420,49223,2,0,0,3,9,3420,0,2004,2004,98010,47.353,121.99,3580,49223,10,0,7.5,7000,52643
8.725e+05,2014,236,3,2.5,2040,6000,1,0,0,3,8,1840,200,1951,1951,98109,47.633,122.35,1820,4920,63,0,5.5,3860,6960
2.995e+05,2015,474,2,1,740,6300,1,0,0,3,6,740,0,1942,1942,98126,47.516,122.38,740,6300,73,0,3,1480,7040
3.175e+05,2014,263,2,1,1000,5120,1,0,0,3,6,1000,0,1902,1902,98122,47.609,122.31,1940,4300,112,0,3,2940,5300
3.925e+05,2015,427,4,2.75,2400,19923,1,0,0,5,7,1320,1080,1953,1953,98042,47.362,122.14,2470,10736,62,0,6.75,4870,13136
5.02e+05,2014,294,4,2.25,2140,10943,1,0,0,3,7,1550,590,1977,1977,98034,47.727,122.22,2350,9000,37,0,6.25,4490,11140
4.76e+05,2014,298,3,2.25,1630,3070,2,0,0,3,7,1630,0,2004,2004,98053,47.678,122.03,1690,3200,10,0,5.25,3320,4830
4.1e+05,2014,204,2,1.5,1180,1034,2,0,0,3,7,1120,60,2001,2001,98115,47.678,122.32,1137,1034,13,0,3.5,2317,2214
4.6e+05,2014,191,3,2.5,1610,2527,2,0,2,3,9,1080,530,2005,2005,98118,47.567,122.29,1610,4173,9,0,5.5,3220,5783
1.7e+05,2014,262,3,1,1480,5670,1,0,0,3,6,780,700,1944,1944,98106,47.517,122.36,760,5040,70,0,4,2240,6520
4.18e+05,2014,125,3,2,1410,6030,1,0,0,4,7,1410,0,1930,1930,98103,47.699,122.35,1410,6300,84,0,5,2820,7710
6.45e+05,2014,331,3,2.25,3280,79279,1,0,0,3,10,3280,0,2001,2001,98003,47.321,122.29,1860,24008,13,0,5.25,5140,27288
7e+05,2014,277,2,1,1620,9855,1,0,4,3,8,1320,300,1948,1948,98136,47.526,122.38,1820,7700,66,0,3,3440,9320
4.93e+05,2014,255,3,2.75,1720,6720,1,0,0,4,7,1270,450,1947,1947,98122,47.614,122.3,1690,3248,67,0,5.75,3410,4968
4.6e+05,2014,176,4,2.5,2550,19017,1,0,0,4,7,1300,1250,1961,1961,98155,47.768,122.28,2080,21100,53,0,6.5,4630,23650
3.25e+05,2014,340,6,3,2650,12870,1,0,0,4,7,2650,0,1977,1977,98022,47.207,121.99,1450,8668,37,0,9,4100,11318
9.17e+05,2014,202,4,2.5,3500,10891,2,0,2,3,10,3500,0,1995,1995,98027,47.553,122.09,3820,13521,19,0,6.5,7320,17021
2.73e+05,2015,415,3,1,1560,7800,1,0,0,3,7,1560,0,1955,1955,98188,47.455,122.29,1468,9375,60,0,4,3028,10935
3.1e+05,2014,189,3,1.5,1460,9908,1,0,0,3,7,1460,0,1952,1952,98148,47.428,122.33,1420,9582,62,0,4.5,2880,11042
7.75e+05,2014,210,5,2,3540,9970,2,0,3,3,9,3540,0,1970,1970,98125,47.711,122.28,2280,7195,44,0,7,5820,10735
6.2e+05,2014,136,3,2.25,1720,4000,1,0,0,4,7,1450,270,1921,1921,98105,47.668,122.29,1410,4000,93,0,5.25,3130,5720
2.89e+05,2014,297,2,1,1010,7740,1,0,0,3,6,890,120,1924,1924,98106,47.532,122.36,1030,6000,90,0,3,2040,7010
1.081e+06,2015,473,4,3,2490,4325,1,0,0,3,8,1690,800,1922,2003,98105,47.663,122.33,1960,4284,93,1,7,4450,6774
2.9795e+05,2014,128,3,2,1240,10800,1,0,0,3,7,1240,0,1967,2010,98058,47.449,122.16,1480,8840,47,1,5,2720,10080
5.05e+05,2014,285,4,2.75,2980,9825,1,0,0,3,8,1910,1070,2007,2007,98056,47.507,122.17,2580,12231,7,0,6.75,5560,15211
7.95e+05,2015,479,4,2.5,2570,13450,1,0,4,3,8,1510,1060,1948,1948,98155,47.743,122.28,3470,12615,67,0,6.5,6040,15185
3.5e+05,2015,416,2,1,720,5820,1,0,1,5,6,720,0,1950,1950,98028,47.76,122.25,952,5820,65,0,3,1672,6540
1.07e+06,2014,160,3,3,2940,4622,2,0,0,4,9,2230,710,1988,1988,98105,47.664,122.29,1580,4000,26,0,6,4520,6940
3.4995e+05,2014,283,4,2.5,2632,4117,2,0,0,3,8,2632,0,2013,2013,98001,47.343,122.28,2040,5195,1,0,6.5,4672,7827
1.8e+06,2014,155,5,4.5,4400,15580,2,0,0,3,11,3390,1010,2003,2003,98004,47.623,122.21,2150,14249,11,0,9.5,6550,18649
5.85e+05,2014,338,3,2.5,2290,5089,2,0,0,3,9,2290,0,2001,2001,98006,47.544,122.17,2290,7984,13,0,5.5,4580,10274
1.0275e+06,2015,459,4,3,3540,10202,2,0,0,3,8,2720,820,1988,1988,98006,47.547,122.16,2780,10714,27,0,7,6320,14254
3.299e+05,2015,473,3,2,1380,5198,1,0,0,4,7,1380,0,1982,1982,98106,47.551,122.36,1320,6827,33,0,5,2700,8207
7.05e+05,2014,127,4,2.5,2650,4316,1,0,0,3,8,1520,1130,1905,2013,98116,47.587,122.39,1690,5625,109,1,6.5,4340,8275
5.83e+05,2014,175,3,2.5,1790,8144,2,0,0,3,8,1790,0,1989,1989,98074,47.617,122.05,1800,7503,25,0,5.5,3590,9293
4.36e+05,2014,342,4,2.75,2080,9600,1,0,0,3,8,1240,840,1979,1979,98034,47.715,122.23,1880,9525,35,0,6.75,3960,11605
9.8899e+05,2015,417,4,4.75,4150,6303,3,0,0,3,9,4150,0,2014,2014,98052,47.705,122.12,3570,6285,1,0,8.75,7720,10435
7.25e+05,2014,136,5,2.75,2830,5310,2,0,0,3,9,2830,0,2006,2006,98052,47.707,122.1,3150,6581,8,0,7.75,5980,9411
3.16e+05,2014,211,5,2.5,2600,4641,2,0,0,3,7,2600,0,2005,2005,98058,47.432,122.15,2330,4589,9,0,7.5,4930,7189
82000,2014,305,3,1,860,10426,1,0,0,3,6,860,0,1954,1954,98146,47.499,122.34,1140,11250,60,0,4,2000,12110
2.37e+05,2014,294,3,1.75,1270,8470,1,0,0,4,7,1270,0,1960,1960,98198,47.421,122.29,1600,8470,54,0,4.75,2870,9740
6.779e+05,2014,259,3,2.5,2440,4587,2,0,0,3,8,2440,0,2010,2010,98052,47.707,122.11,2750,4587,4,0,5.5,5190,7027
1.5e+05,2014,176,3,1,1310,9612,1,0,0,3,7,960,350,1962,1962,98001,47.296,122.28,1310,9812,52,0,4,2620,11122
4.4e+05,2015,446,4,1,1440,6678,1,0,0,3,7,1040,400,1950,1950,98116,47.571,122.39,1320,6678,65,0,5,2760,8118
4.1e+05,2014,277,3,2.5,1860,15457,2,0,0,3,8,1860,0,1997,1997,98019,47.738,121.95,2040,14055,17,0,5.5,3900,15915
2.2e+05,2014,347,3,1.75,1900,7680,1,0,0,3,7,1260,640,1959,1959,98178,47.508,122.27,2000,7740,55,0,4.75,3900,9640
4.9e+05,2014,160,3,2,2220,10275,2,0,0,3,9,1640,580,1980,1980,98027,47.53,122.06,2300,9975,34,0,5,4520,12195
4.15e+05,2014,313,3,2.5,2420,10733,2,0,0,3,8,2420,0,1996,1996,98038,47.383,122.03,1950,8534,18,0,5.5,4370,10954
8.1e+05,2015,415,4,3.5,2700,2868,2,0,0,3,11,1920,780,2006,2006,98118,47.569,122.29,1430,3858,9,0,7.5,4130,6558
2.87e+05,2015,443,3,2.5,1710,10341,2,0,2,3,7,1710,0,1986,1986,98030,47.349,122.17,1830,9358,29,0,5.5,3540,11068
6.99e+05,2015,456,4,2.5,3230,40319,2,0,0,4,10,3230,0,1987,1987,98027,47.486,122.07,2990,40234,28,0,6.5,6220,43464
2.0475e+05,2015,493,2,1,880,7575,1,0,0,4,7,880,0,1942,1942,98198,47.376,122.3,1800,7575,73,0,3,2680,8455
4.55e+05,2015,373,2,1.5,1020,1146,3,0,0,3,7,1020,0,2001,2001,98115,47.677,122.33,1138,1156,14,0,3.5,2158,2176
5.4995e+05,2014,250,3,2.5,2080,8690,1,0,0,3,8,1430,650,1974,1974,98166,47.442,122.34,2400,9625,40,0,5.5,4480,11705
8.5e+05,2014,252,3,2.5,3300,11570,2,0,0,3,9,3300,0,1994,1994,98006,47.56,122.12,3280,11446,20,0,5.5,6580,14746
5.1e+05,2015,437,3,1.5,1730,6240,1,0,1,3,8,1000,730,1954,1954,98136,47.528,122.39,1620,6240,61,0,4.5,3350,7970
3.599e+05,2014,170,5,2.25,2290,7420,1,0,0,3,7,1290,1000,1973,1973,98058,47.438,122.17,1660,7526,41,0,7.25,3950,9816
4.2701e+05,2015,446,3,3,1460,1200,3,0,0,3,8,1460,0,2006,2006,98117,47.7,122.37,1460,1245,9,0,6,2920,2705
3.3e+05,2015,454,3,2.5,2410,17424,1,0,0,3,7,1630,780,1978,1978,98030,47.374,122.22,1530,11761,37,0,5.5,3940,14171
4.18e+05,2014,321,4,3.25,3266,5969,2,0,0,3,8,3266,0,2014,2014,98023,47.297,122.35,3087,5169,0,0,7.25,6353,8435
5e+05,2015,387,4,2,1530,7816,1,0,0,3,7,1530,0,1955,1955,98133,47.731,122.33,1480,7816,60,0,6,3010,9346
3.7e+05,2014,291,3,1.75,1530,10300,1,0,0,4,7,1530,0,1978,1978,98133,47.777,122.36,1940,9883,36,0,4.75,3470,11413
4.611e+05,2014,239,2,2.25,1210,1267,2,0,0,3,8,1120,90,2010,2010,98117,47.678,122.38,1360,1349,4,0,4.25,2570,2559
3.6e+05,2014,156,3,1.75,1020,7020,1,0,0,4,7,1020,0,1953,1953,98155,47.736,122.31,1020,5871,61,0,4.75,2040,6891
5.3e+05,2015,472,4,2,2150,14161,1,0,2,3,8,1330,820,1966,1966,98003,47.338,122.32,2310,14034,49,0,6,4460,16184
9.57e+05,2014,256,4,3,2370,3836,2,0,0,3,9,1750,620,1969,2008,98107,47.672,122.39,1690,4698,45,1,7,4060,7068
4.76e+05,2015,401,3,2.25,1570,7187,1,0,0,4,8,1170,400,1980,1980,98133,47.76,122.36,1660,8775,35,0,5.25,3230,10345
3.885e+05,2014,347,4,2.5,1890,5395,2,0,0,3,7,1890,0,2006,2006,98065,47.541,121.88,2060,5395,8,0,6.5,3950,7285
3.42e+05,2014,122,3,2,1930,11947,1,0,0,4,8,1930,0,1966,1966,98042,47.367,122.15,2200,12825,48,0,5,4130,14755
2.698e+05,2014,208,4,2.75,1830,3420,2,0,0,3,8,1830,0,2012,2012,98198,47.366,122.31,1813,3420,2,0,6.75,3643,5250
3.95e+05,2014,198,3,1.75,1620,8085,1,0,0,3,7,1210,410,1976,1976,98011,47.735,122.2,1700,8085,38,0,4.75,3320,9705
4.05e+05,2014,294,3,2.5,1430,10200,1,0,0,3,7,1430,0,1960,1960,98033,47.701,122.17,1470,10350,54,0,5.5,2900,11780
4.45e+05,2014,197,3,2.25,2100,8201,1,0,2,3,8,1620,480,1967,1967,98178,47.509,122.24,2660,8712,47,0,5.25,4760,10812
8e+05,2015,388,3,3,2060,3200,2,0,0,3,8,2060,0,1907,1984,98102,47.637,122.32,1760,2669,108,1,6,3820,4729
1.849e+05,2014,231,2,1,1230,5000,1,0,0,5,6,1230,0,1911,1911,98022,47.206,121.99,1230,5413,103,0,3,2460,6643
3.52e+05,2015,440,5,2.5,2900,6650,1,0,0,3,7,1450,1450,1964,1964,98168,47.493,122.33,1600,8246,51,0,7.5,4500,11146
4.25e+05,2014,208,4,2.25,2060,8540,1,0,0,4,7,1540,520,1967,1967,98034,47.734,122.19,1560,7700,47,0,6.25,3620,9760
3.535e+05,2014,356,3,2.5,1260,972,2,0,0,3,8,840,420,2008,2008,98144,47.587,122.32,1270,925,6,0,5.5,2530,2185
4.4e+05,2014,152,4,2.75,2340,11034,1,0,0,3,8,1720,620,1967,1967,98155,47.769,122.28,2370,11941,47,0,6.75,4710,14281
3.025e+05,2014,353,3,2.5,2200,7201,2,0,0,3,8,2200,0,1994,1994,98030,47.382,122.21,2250,7240,20,0,5.5,4450,9440
4.35e+05,2014,259,2,1,2240,7200,1,0,0,4,7,1120,1120,1940,1940,98118,47.563,122.27,1390,6000,74,0,3,3630,8240
8.65e+05,2014,231,5,3,2900,6730,1,0,0,5,8,1830,1070,1977,1977,98115,47.678,122.28,2370,6283,37,0,8,5270,9183
6.665e+05,2014,244,4,2.5,2860,6600,2,0,0,3,9,2860,0,2000,2000,98074,47.607,122.02,2790,6723,14,0,6.5,5650,9583
7e+05,2014,311,5,3.25,2400,3118,2,0,0,4,7,1780,620,1928,1928,98122,47.609,122.29,2100,3941,86,0,8.25,4500,6341
9e+05,2014,218,3,3.25,2620,7215,1,0,0,4,8,1770,850,1980,1980,98004,47.584,122.2,2180,8931,34,0,6.25,4800,11551
2.82e+05,2014,232,3,2.25,1260,915,2,0,0,3,8,1020,240,2007,2007,98106,47.555,122.36,1260,1056,7,0,5.25,2520,2316
7.3e+05,2014,347,4,2.75,3440,8150,2,0,0,3,10,3440,0,2014,2014,98056,47.517,122.19,2560,8315,0,0,6.75,6000,11755
7.3938e+05,2014,198,5,3,2640,3200,2,0,0,4,7,2140,500,1906,1906,98112,47.619,122.31,1540,2242,108,0,8,4180,4882
2.75e+05,2014,348,5,1.5,1950,9000,1,0,0,3,7,1130,820,1964,1964,98146,47.488,122.34,1680,9526,50,0,6.5,3630,11476
2.7728e+05,2015,458,3,1.75,1030,4800,1,0,0,3,6,930,100,1927,1927,98126,47.566,122.37,1540,4800,88,0,4.75,2570,5830
7.25e+05,2015,451,3,2,1820,6324,1,0,0,5,7,910,910,1945,1945,98115,47.682,122.27,1850,6440,70,0,5,3670,8260
6e+05,2014,317,4,2.25,1970,7125,1,0,0,3,7,1500,470,1908,1908,98115,47.672,122.29,1980,4750,106,0,6.25,3950,6720
2.945e+06,2015,424,5,4.5,4340,5722,3,0,4,3,10,4340,0,2010,2010,98107,47.672,122.41,1770,5250,5,0,9.5,6110,9590
3.215e+05,2014,189,1,1,730,1942,1,0,0,3,7,730,0,2008,2008,98144,47.594,122.3,1020,2183,6,0,2,1750,2913
2.495e+05,2014,173,2,1.75,1500,8645,1,0,0,4,7,1500,0,1963,1963,98042,47.364,122.11,1220,8645,51,0,3.75,2720,10145
6.75e+05,2015,456,4,2.5,2420,18470,1,0,0,3,8,920,1500,1968,1968,98005,47.6,122.18,2690,13800,47,0,6.5,5110,16220
8.98e+05,2014,310,2,1.75,1490,9874,1,0,0,4,7,1490,0,1963,1963,98004,47.625,122.2,2280,9869,51,0,3.75,3770,11359
3.1e+05,2014,230,2,1.75,1160,2500,2,0,0,3,7,1160,0,2008,2008,98014,47.649,121.91,970,7500,6,0,3.75,2130,8660
1.205e+06,2014,255,4,3.5,3590,5335,2,0,2,3,9,3140,450,2006,2006,98115,47.676,122.27,2100,6250,8,0,7.5,5690,9840
6.25e+05,2014,140,4,2.5,3550,8048,2,0,0,3,9,3550,0,2007,2007,98065,47.542,121.89,3920,7871,7,0,6.5,7470,11421
7e+05,2014,140,4,1,1680,4021,1,0,0,3,7,1680,0,1921,1921,98103,47.666,122.33,1710,4021,93,0,5,3390,5701
5.55e+05,2014,140,3,2.5,3050,1.5856e+05,1,0,0,4,9,3050,0,1987,1987,98055,47.433,122.21,2960,31050,27,0,5.5,6010,34100
8.55e+05,2015,415,4,3,2550,5300,2,0,0,3,8,1720,830,1908,2013,98117,47.679,122.37,1590,4505,107,1,7,4140,7055
6.6e+05,2014,162,3,3,2340,2970,2,0,0,5,8,2160,180,1925,1925,98103,47.687,122.35,1370,4000,89,0,6,3710,6340
3.39e+05,2014,187,3,2.5,1450,3748,2,0,0,3,7,1450,0,2004,2004,98065,47.532,121.85,1970,3748,10,0,5.5,3420,5198
1.326e+06,2015,415,3,2.25,2960,8330,1,0,3,4,10,2260,700,1953,1953,98177,47.703,122.39,2960,8840,62,0,5.25,5920,11800
5.3e+05,2015,464,3,1.5,1240,4080,1,0,0,3,8,1240,0,1914,1914,98144,47.575,122.29,1420,4080,101,0,4.5,2660,5320
2.45e+05,2014,348,3,2.25,1422,3677,2,0,0,3,7,1422,0,2012,2012,98092,47.32,122.18,1677,3677,2,0,5.25,3099,5099
2.65e+05,2014,243,4,3,1730,7264,2,0,0,3,6,1730,0,1920,1920,98168,47.474,122.26,1500,12104,94,0,7,3230,13834
2.21e+05,2015,445,3,1,1240,5250,1,0,0,4,6,1240,0,1904,1904,98055,47.492,122.21,1240,5250,111,0,4,2480,6490
3.75e+05,2014,243,2,1,1010,4050,1,0,0,3,7,1010,0,1950,1950,98116,47.584,122.38,2310,5000,64,0,3,3320,6010
2.65e+05,2015,443,4,1.75,1430,5490,1,0,0,5,6,1430,0,1942,1942,98056,47.494,122.18,1030,5900,73,0,5.75,2460,7330
4.4395e+05,2014,290,3,1.75,2000,36000,1,0,0,3,6,2000,0,1946,1995,98056,47.522,122.18,2100,9681,68,1,4.75,4100,11681
2.17e+05,2014,340,3,2,1690,6750,1,0,0,3,7,1210,480,1977,1977,98023,47.302,122.38,1930,7350,37,0,5,3620,9040
2.485e+05,2014,224,2,1,720,5160,1,0,0,3,6,720,0,1949,1949,98106,47.527,122.36,990,5160,65,0,3,1710,5880
3.125e+05,2015,461,4,2.5,2500,11983,1,0,0,3,7,1320,1180,1984,2008,98058,47.429,122.15,1460,9005,31,1,6.5,3960,11505
8.2e+05,2015,426,4,2.5,3260,26772,2,0,0,3,9,3260,0,2007,2007,98027,47.511,122.03,3260,14491,8,0,6.5,6520,17751
6.65e+05,2014,177,3,2.5,2610,35000,2,0,0,3,10,2610,0,1988,1988,98072,47.738,122.1,3060,35427,26,0,5.5,5670,38037
1.08e+06,2014,170,3,3,4910,43560,2,0,0,4,10,4000,910,1989,1989,98007,47.591,122.13,3540,12288,25,0,6,8450,17198
1.95e+05,2015,410,3,1,1260,8378,1,0,0,4,6,840,420,1959,1977,98023,47.327,122.35,1140,8496,56,1,4,2400,9756
5.52e+05,2015,446,4,2.75,3160,8429,1,0,3,4,7,1620,1540,1982,1982,98178,47.511,122.25,1760,6780,33,0,6.75,4920,9940
1.4e+06,2015,445,4,2.5,3520,7815,2,0,3,3,10,3140,380,1929,1929,98199,47.643,122.41,2790,6644,86,0,6.5,6310,10164
2.2e+05,2014,223,3,2.25,1470,7518,1,0,0,3,7,1160,310,1985,1985,98003,47.273,122.3,1720,8300,29,0,5.25,3190,9770
3.7e+05,2014,320,3,2.75,1750,9166,1,0,0,4,7,1170,580,1979,1979,98155,47.77,122.33,1810,8760,35,0,5.75,3560,10510
2.35e+05,2015,401,4,1.75,1720,10137,2,0,0,3,7,1720,0,1956,1956,98188,47.442,122.28,1350,10205,59,0,5.75,3070,11925
4.45e+05,2014,304,4,1.75,2100,4400,1,0,0,5,7,1720,380,1924,1924,98118,47.53,122.27,1850,4400,90,0,5.75,3950,6500
2.8e+05,2015,456,2,1,870,4025,1,0,0,3,7,870,0,1981,1981,98034,47.724,122.16,1370,3488,34,0,3,2240,4358
2.09e+05,2014,221,3,2,1230,1340,2,0,0,3,7,1020,210,2003,2003,98106,47.526,122.36,1260,1312,11,0,5,2490,2542
7.93e+05,2015,452,4,2.5,2450,4080,1,0,0,4,8,1490,960,1930,1930,98115,47.69,122.32,2000,4080,85,0,6.5,4450,6530
4.45e+05,2014,298,2,1,930,3150,1,0,0,5,6,930,0,1918,1918,98115,47.678,122.3,1900,5000,96,0,3,2830,5930
6.65e+05,2014,361,4,2.5,2510,5936,2,0,0,3,9,2510,0,1998,1998,98075,47.585,122.03,2760,6060,16,0,6.5,5270,8570
6.025e+05,2015,463,4,1.75,2190,41000,2,0,0,3,8,2190,0,1980,1980,98075,47.575,122.03,2590,35370,35,0,5.75,4780,37560
3.05e+05,2014,257,3,1,1160,9750,1,0,0,3,7,1160,0,1967,1967,98077,47.742,122.07,1160,9650,47,0,4,2320,10810
3.745e+05,2015,372,3,1.5,1330,8636,1,0,0,4,7,1330,0,1968,1968,98034,47.729,122.2,1370,7475,47,0,4.5,2700,8805
3.7875e+05,2014,169,3,2.5,2160,3000,1,0,0,3,7,1260,900,1909,2011,98118,47.564,122.29,1060,3500,105,1,5.5,3220,5660
2.675e+05,2014,222,5,3.5,2390,6600,2,0,0,5,7,2390,0,1977,1977,98042,47.374,122.11,1140,6600,37,0,8.5,3530,8990
3.83e+05,2014,245,4,1.75,1830,11090,1,0,0,3,7,1060,770,1962,1962,98028,47.733,122.25,1990,10917,52,0,5.75,3820,12747
3.25e+05,2014,188,2,1,800,7260,1,0,0,3,7,800,0,1953,1953,98126,47.536,122.37,1010,7440,61,0,3,1810,8240
3.3289e+05,2014,181,2,2.5,1050,1029,2,0,0,3,8,950,100,2007,2007,98122,47.602,122.3,1350,3600,7,0,4.5,2400,4650
2.5e+05,2015,486,3,2,1050,18304,1,0,0,4,7,1050,0,1953,1953,98001,47.321,122.27,1690,15675,62,0,5,2740,16725
9.55e+05,2015,444,4,3.25,3720,6765,2,0,0,3,9,3720,0,2012,2012,98053,47.688,122.02,3100,6790,3,0,7.25,6820,10510
2.5e+06,2015,478,4,4,3330,24354,1,0,0,4,10,3330,0,1961,1961,98006,47.571,122.19,3880,25493,54,0,8,7210,28823
3.0995e+05,2014,125,3,2.5,1880,7838,2,0,0,3,7,1880,0,1994,1994,98055,47.444,122.19,1810,7915,20,0,5.5,3690,9795
6.825e+05,2015,381,6,4.5,3500,8504,2,0,0,3,7,3500,0,1980,1980,98155,47.735,122.3,1550,8460,35,0,10.5,5050,11960
6.9e+05,2015,438,3,1.75,2330,16300,2,0,0,3,9,2330,0,1964,1964,98034,47.704,122.24,2330,16300,51,0,4.75,4660,18630
3.3e+05,2014,249,4,2,1590,9100,1,0,0,3,7,1040,550,1967,2014,98058,47.447,122.16,1670,9100,47,1,6,3260,10690
5.4805e+05,2015,394,2,2,1930,5479,1,0,0,3,8,1930,0,2005,2005,98053,47.705,122.01,1900,5479,10,0,4,3830,7409
4.67e+05,2014,310,3,2.5,1690,6642,2,0,0,3,7,1690,0,2004,2004,98053,47.679,122.03,2120,5080,10,0,5.5,3810,6770
1.9999e+05,2014,191,2,1,890,6430,1,0,0,3,6,890,0,1935,1997,98022,47.2,122,1460,6430,79,1,3,2350,7320
5.3e+05,2014,176,3,2,2330,26571,2,0,0,3,8,2330,0,1987,1987,98005,47.601,122.16,2030,20037,27,0,5,4360,22367
1.1498e+05,2014,190,2,1,740,6250,1,0,0,3,6,740,0,1942,1942,98146,47.506,122.33,980,6957,72,0,3,1720,7697
3.15e+05,2014,306,1,1,700,3876,1,0,0,3,6,700,0,1910,1910,98103,47.689,122.35,1150,3952,104,0,2,1850,4652
6.98e+05,2015,444,4,3.5,3630,5670,2,0,0,3,10,3630,0,1970,2008,98056,47.519,122.21,1620,5400,45,1,7.5,5250,9030
1.9e+05,2015,416,3,1.75,1390,7700,1,0,0,5,7,1390,0,1965,1965,98058,47.456,122.18,1260,7700,50,0,4.75,2650,9090
4.05e+05,2014,287,3,1.75,1900,10454,1,0,0,3,7,1390,510,1978,1978,98155,47.775,122.29,2000,12000,36,0,4.75,3900,13900
1.0425e+06,2015,456,3,1.75,1900,9375,1,0,1,4,8,1330,570,1941,1941,98115,47.682,122.27,2760,9375,74,0,4.75,4660,11275
5.9e+05,2014,208,3,2.5,1990,8325,2,0,0,4,8,1310,680,1997,1997,98034,47.705,122.2,2450,10606,17,0,5.5,4440,12596
5.16e+05,2014,237,4,2.75,2210,10800,1,0,0,4,8,1170,1040,1997,1997,98074,47.609,122.06,2210,10800,17,0,6.75,4420,13010
3.9995e+05,2014,278,3,2,2050,9396,1,0,0,5,7,1170,880,1960,1960,98155,47.745,122.33,1680,9391,54,0,5,3730,11441
4.82e+05,2015,415,3,2.5,2950,6545,2,0,0,3,8,2950,0,2003,2003,98059,47.483,122.14,2400,6550,12,0,5.5,5350,9500
6.7e+05,2014,338,5,3.5,3860,9600,1,0,3,4,8,2660,1200,1973,1973,98034,47.714,122.22,2440,9600,41,0,8.5,6300,13460
2.74e+05,2014,215,5,1,1680,9383,1,0,0,3,7,1400,280,1929,1929,98155,47.752,122.31,1680,9458,85,0,6,3360,11138
4.125e+05,2014,217,4,2.25,1630,7969,1,0,0,3,7,1100,530,1977,1977,98034,47.734,122.19,1580,7440,37,0,6.25,3210,9070
4.25e+05,2015,425,2,1,1270,6000,1,0,0,3,7,1270,0,1939,1939,98199,47.648,122.39,1770,6000,76,0,3,3040,7270
3.2995e+05,2015,465,3,1,1000,9170,1,0,0,3,7,1000,0,1980,1980,98058,47.441,122.13,1610,9170,35,0,4,2610,10170
7.3852e+05,2014,249,5,2.75,3360,9200,2,0,0,3,9,3360,0,2014,2014,98011,47.775,122.17,3360,9713,0,0,7.75,6720,13073
7.95e+05,2014,317,5,3.5,3330,3705,2,0,0,3,9,2610,720,2008,2008,98006,47.557,122.12,2810,3971,6,0,8.5,6140,7301
5e+05,2015,392,3,1.75,1690,48096,1,0,0,3,7,1690,0,1973,1973,98053,47.675,122.06,2070,35160,42,0,4.75,3760,36850
2.8e+05,2015,453,3,1.75,1480,8165,1,0,0,4,7,1480,0,1985,1985,98042,47.362,122.08,1450,7939,30,0,4.75,2930,9419
5.7693e+05,2014,319,4,2.5,2630,6100,2,0,0,3,8,2630,0,2004,2004,98072,47.773,122.17,2360,5765,10,0,6.5,4990,8395
3.224e+05,2014,270,3,1.75,1710,15844,1,0,0,4,8,1710,0,1964,1964,98059,47.471,122.1,1990,20359,50,0,4.75,3700,22069
8.525e+05,2014,345,5,3.75,3830,8131,2,0,0,3,10,3830,0,2005,2005,98075,47.584,121.97,3570,7290,9,0,8.75,7400,11120
3.35e+05,2015,433,2,1,1800,5182,1,0,0,3,6,900,900,1942,1942,98108,47.551,122.3,1570,5876,73,0,3,3370,7676
2.695e+05,2014,236,3,2,1640,8395,1,0,0,4,7,1640,0,1991,1991,98038,47.348,122.03,1510,7180,23,0,5,3150,8820
4.05e+05,2014,335,3,1.75,2020,8531,1,0,0,3,7,2020,0,1965,1965,98011,47.769,122.2,1950,8449,49,0,4.75,3970,10469
6.89e+05,2015,438,4,2.5,2240,7350,2,0,0,3,9,2240,0,1989,1989,98029,47.565,122.01,2200,8017,26,0,6.5,4440,10257
1.06e+06,2014,292,4,3.5,3850,8100,2,0,1,3,11,2430,1420,1995,1995,98033,47.685,122.19,2620,9346,19,0,7.5,6470,13196
3.9e+05,2014,139,4,2.5,2490,8290,2,0,0,3,9,2490,0,1999,1999,98092,47.331,122.17,2690,7008,15,0,6.5,5180,9498
3.77e+05,2014,228,3,1.75,1820,34800,1,0,0,4,6,1820,0,1967,1967,98027,47.462,121.98,2570,52707,47,0,4.75,4390,54527
7.25e+05,2014,321,4,2.5,2130,3420,1,0,0,4,7,1730,400,1916,1916,98103,47.649,122.34,1520,3420,98,0,6.5,3650,5550
2.23e+05,2014,162,2,1,910,9869,1,0,0,3,6,910,0,1957,1957,98058,47.457,122.18,1480,9750,57,0,3,2390,10660
5.71e+05,2015,450,3,2.5,2140,2867,2,0,0,3,8,1960,180,2005,2005,98027,47.536,122.07,2280,2836,10,0,5.5,4420,4976
6.49e+05,2014,245,3,2,1810,17006,2,1,4,3,8,1810,0,1913,1987,98166,47.466,122.37,2180,24911,101,1,5,3990,26721
5.1e+05,2014,325,4,2.5,2010,9075,1,0,0,4,8,1310,700,1959,1959,98006,47.553,122.18,1850,9220,55,0,6.5,3860,11230
4.35e+05,2014,208,3,2.5,1840,5680,2,0,0,3,7,1840,0,2008,2008,98053,47.697,122.03,1600,4697,6,0,5.5,3440,6537
2.8765e+05,2014,280,3,1,1050,16050,1,0,0,4,7,1050,0,1960,1981,98038,47.384,122.01,1610,27600,54,1,4,2660,28650
2.55e+05,2014,198,3,2.5,1530,1116,2,0,0,3,7,1530,0,2005,2005,98028,47.739,122.25,1530,7780,9,0,5.5,3060,9310
3.45e+05,2014,236,3,3.25,1600,1882,2,0,0,3,8,1360,240,2000,2000,98133,47.715,122.36,1390,1379,14,0,6.25,2990,2979
8.35e+05,2014,196,4,2.5,3650,7784,2,0,0,3,9,3650,0,2006,2006,98052,47.707,122.1,3150,6442,8,0,6.5,6800,10092
3.45e+05,2015,484,4,2.5,2420,11481,1,0,0,3,8,1370,1050,1985,1985,98003,47.341,122.32,2290,8985,30,0,6.5,4710,11405
2.8e+05,2014,229,2,1.75,1894,52769,1,0,0,4,6,1520,374,1936,1936,98001,47.309,122.27,1820,50529,78,0,3.75,3714,52423
3.325e+05,2015,374,3,1.5,1500,6332,1,0,0,3,7,1500,0,1953,1953,98125,47.727,122.31,1500,6337,62,0,4.5,3000,7837
5.5e+05,2014,236,4,2.5,2470,5954,2,0,0,3,8,2470,0,2013,2013,98028,47.769,122.24,2470,4800,1,0,6.5,4940,7270
7.165e+05,2014,279,5,2.75,3630,38461,2,0,0,3,11,3630,0,2000,2000,98058,47.429,122.09,4440,50378,14,0,7.75,8070,54008
1.97e+05,2015,450,2,1,770,8636,1,0,0,2,6,770,0,1951,1951,98146,47.508,122.36,1110,8636,64,0,3,1880,9406
3.3e+05,2015,409,4,2.5,2180,7210,1,0,0,3,7,1190,990,1972,1972,98011,47.742,122.18,2070,7210,43,0,6.5,4250,9390
5.33e+05,2014,279,3,2.5,2810,4607,2,0,0,3,8,2810,0,2004,2004,98011,47.773,122.23,2540,4871,10,0,5.5,5350,7681
1.728e+06,2014,167,4,3,3700,20570,1,0,0,4,10,1850,1850,1976,1976,98004,47.621,122.22,3080,17595,38,0,7,6780,21295
7.25e+05,2014,175,4,2.5,2490,5170,2,0,0,4,9,2490,0,2000,2000,98052,47.684,122.16,2490,5170,14,0,6.5,4980,7660
2.2e+05,2014,249,5,1,1260,8382,1,0,0,3,7,1260,0,1918,1918,98146,47.506,122.36,910,8382,96,0,6,2170,9642
2.05e+05,2014,181,3,1.75,1170,8239,1,0,0,3,7,1170,0,1981,1981,98042,47.368,122.09,1180,7866,33,0,4.75,2350,9036
3.63e+05,2015,402,4,2.5,2180,9281,2,0,0,3,8,2180,0,2004,2004,98042,47.367,122.07,2520,9520,11,0,6.5,4700,11700
2.9995e+05,2014,318,3,2.5,1570,2577,2,0,0,3,7,1570,0,2005,2005,98019,47.746,121.98,1970,2952,9,0,5.5,3540,4522
5.225e+05,2014,243,2,2.25,1430,1210,2,0,0,3,8,1340,90,2005,2005,98115,47.676,122.3,1430,1016,9,0,4.25,2860,2446
2.799e+05,2015,388,3,2,1410,6600,1,0,0,4,7,1410,0,1990,1990,98042,47.36,122.09,1750,7150,25,0,5,3160,8560
9.6399e+05,2015,440,4,3.5,3915,6364,2,0,0,3,9,3915,0,2014,2014,98053,47.684,122.02,3830,6507,1,0,7.5,7745,10422
4.95e+05,2014,202,3,1.5,2240,13288,1,0,0,3,7,2240,0,1953,1953,98033,47.676,122.17,2150,9900,61,0,4.5,4390,12140
2.567e+05,2014,210,3,2,1670,4441,1,0,0,3,7,1670,0,2014,2014,98022,47.195,121.97,1670,4622,0,0,5,3340,6292
9.5e+05,2014,141,5,3.75,5330,6000,2,0,2,3,10,3570,1760,2006,2006,98027,47.54,122.07,4420,5797,8,0,8.75,9750,11127
4.7e+05,2014,237,5,1.75,2030,12342,2,0,0,4,7,2030,0,1942,1942,98052,47.642,122.11,2500,9433,72,0,6.75,4530,11463
2.78e+05,2014,338,2,2.5,1420,2229,2,0,0,3,7,1420,0,2004,2004,98059,47.487,122.17,1500,2230,10,0,4.5,2920,3650
8.04e+05,2014,263,5,3.5,2770,9305,2,0,0,3,9,2770,0,1985,1985,98006,47.563,122.11,2520,9773,29,0,8.5,5290,12543
8.09e+05,2014,132,5,4.5,4630,6324,2,0,0,3,9,3210,1420,2006,2006,98065,47.538,121.86,4420,6790,8,0,9.5,9050,11420
3.55e+05,2014,148,3,2.5,2400,9701,1,0,0,3,9,2400,0,1990,1990,98023,47.308,122.39,2400,8258,24,0,5.5,4800,10658
6e+05,2014,149,3,1.75,2930,19876,1,0,0,3,9,2030,900,1993,1993,98072,47.744,122.17,2740,11499,21,0,4.75,5670,14429
2.48e+05,2015,477,5,1.75,2190,16788,1,0,2,3,8,1380,810,1978,1978,98030,47.376,122.18,1920,8366,37,0,6.75,4110,10556
9.25e+05,2014,134,4,2.5,2190,7350,2,0,0,5,8,2190,0,1958,1958,98040,47.579,122.24,1880,7350,56,0,6.5,4070,9540
3e+05,2015,410,4,1.75,2200,7600,2,0,0,3,8,2200,0,1978,1978,98092,47.313,122.19,1910,7600,37,0,5.75,4110,9800
3.74e+05,2014,172,4,2.5,2580,6260,2,0,0,3,7,2580,0,2004,2004,98056,47.486,122.19,2160,3600,10,0,6.5,4740,6180
2.8695e+05,2014,331,4,2.5,1610,4052,2,0,0,3,7,1610,0,2013,2013,98042,47.36,122.08,2110,4034,1,0,6.5,3720,5644
2.07e+05,2014,242,3,2.5,1520,2550,2,0,0,3,7,1520,0,2005,2005,98108,47.525,122.33,1460,2550,9,0,5.5,2980,4070
2.2995e+05,2014,249,2,1,920,7716,1,0,0,3,6,920,0,1944,1944,98178,47.503,122.24,1410,7128,70,0,3,2330,8048
5.6e+05,2014,189,3,2.5,1960,6058,2,0,0,3,8,1960,0,2002,2002,98053,47.632,122.01,2480,6656,12,0,5.5,4440,8616
1.74e+06,2015,425,5,3.25,3930,5500,2,0,0,3,9,2910,1020,2014,2014,98033,47.68,122.21,2040,5115,1,0,8.25,5970,9045
2.45e+05,2014,189,3,2.5,1610,7223,2,0,0,3,7,1610,0,1994,1994,98030,47.366,122.17,1610,7162,20,0,5.5,3220,8772
7.5e+05,2015,464,3,2.5,2560,9182,2,0,0,3,9,2560,0,1993,1993,98027,47.536,122.05,2800,8784,22,0,5.5,5360,11344
3.9989e+05,2014,342,4,1,2370,30200,1,0,0,4,7,1570,800,1948,1948,98146,47.511,122.37,1640,9719,66,0,5,4010,12089
1.7325e+05,2014,230,3,2,1210,9097,1,0,0,4,7,1210,0,1954,1954,98168,47.485,122.3,1360,10125,60,0,5,2570,11335
2.06e+05,2014,168,2,1.5,1820,8867,2,0,0,3,7,1820,0,1921,1921,98168,47.476,122.27,1430,9288,93,0,3.5,3250,11108
6.787e+05,2015,403,3,1.75,1970,10548,1,0,0,4,8,1300,670,1973,1973,98033,47.667,122.18,2500,8548,42,0,4.75,4470,10518
4.2e+05,2015,414,4,2,1700,6375,1,0,0,4,7,850,850,1950,1950,98115,47.697,122.3,1470,8360,65,0,6,3170,10060
6.5e+05,2014,133,4,2.5,2210,4861,2,0,0,3,9,2210,0,2013,2013,98117,47.696,122.36,1590,5080,1,0,6.5,3800,7290
9.86e+05,2015,460,3,2.5,2380,16080,1,0,2,4,9,1340,1040,1964,1964,98136,47.526,122.39,2560,10070,51,0,5.5,4940,12450
2.6995e+05,2014,221,4,2.5,2060,13500,1,0,0,3,7,1260,800,1968,1968,98042,47.423,122.15,1610,10714,46,0,6.5,3670,12774
4e+05,2015,467,3,2.5,1910,4408,3,0,0,3,8,1910,0,2007,2007,98133,47.763,122.35,1910,8154,8,0,5.5,3820,10064
5.35e+05,2015,480,4,2.5,3250,6933,2,0,0,3,8,3250,0,2009,2009,98059,47.496,122.15,3030,5308,6,0,6.5,6280,8558
5.4e+05,2015,431,5,1,2480,4400,1,0,0,3,7,1640,840,1919,1919,98122,47.605,122.3,1940,4400,96,0,6,4420,6880
4.33e+05,2014,285,4,1,1710,7000,1,0,0,3,7,1710,0,1950,1950,98125,47.704,122.29,2030,7938,64,0,5,3740,9648
3.455e+05,2014,321,3,2.5,1930,4000,2,0,0,3,8,1930,0,2014,2014,98001,47.352,122.28,2050,4000,0,0,5.5,3980,5930
5.9995e+05,2014,251,4,2.5,2290,6318,2,0,0,4,8,2290,0,1988,1988,98029,47.57,122.02,2150,7350,26,0,6.5,4440,9640
5.715e+05,2014,324,4,1.75,1920,7455,1,0,0,4,7,960,960,1939,1964,98125,47.711,122.29,1920,7455,75,1,5.75,3840,9375
3.3e+05,2014,218,5,2.5,2600,3839,2,0,0,3,7,2600,0,2005,2005,98058,47.432,122.14,2180,4800,9,0,7.5,4780,7400
6.859e+05,2014,217,3,2.5,2290,9142,1,0,0,3,8,2290,0,1972,1972,98117,47.691,122.39,1770,8035,42,0,5.5,4060,10325
4.25e+05,2014,284,3,1,1180,7200,1,0,0,4,7,1180,0,1949,1949,98133,47.712,122.33,2240,7875,65,0,4,3420,9055
7.4995e+05,2014,196,3,2.5,2010,2263,2,0,0,3,8,1340,670,2014,2014,98122,47.609,122.31,1500,2670,0,0,5.5,3510,4680
3.3499e+05,2014,141,4,2.5,2220,4228,2,0,0,3,8,2220,0,2014,2014,98146,47.501,122.34,2220,4157,0,0,6.5,4440,6377
1.75e+06,2014,229,4,3.25,3460,7749,2,0,1,3,10,3020,440,1950,1998,98115,47.685,122.27,3030,8680,64,1,7.25,6490,12140
5.8e+05,2015,476,3,2.75,2650,9752,1,0,0,3,9,2650,0,1989,1989,98028,47.768,122.26,3030,9910,26,0,5.75,5680,12560
2.05e+05,2015,452,4,2.5,1767,4500,2,0,0,3,8,1767,0,2006,2006,98001,47.261,122.25,1949,4636,9,0,6.5,3716,6403
2.2675e+05,2015,472,3,1.75,1070,6315,1,0,0,3,7,1070,0,1992,1992,98023,47.28,122.36,1520,5707,23,0,4.75,2590,6777
8e+05,2014,332,4,2.5,4600,67369,2,0,0,3,10,4600,0,1990,1990,98053,47.642,121.99,4600,67369,24,0,6.5,9200,71969
5.52e+05,2014,251,2,1,1150,5000,1,0,0,4,7,1050,100,1924,1924,98115,47.685,122.32,1463,4320,90,0,3,2613,5470
7.06e+05,2014,346,4,2.5,2510,5436,2,0,0,3,8,2510,0,2011,2011,98053,47.689,122.02,2520,5436,3,0,6.5,5030,7946
3.5e+05,2014,162,4,2.25,2300,4600,1,0,0,4,7,1340,960,1904,1904,98144,47.59,122.31,1540,3000,110,0,6.25,3840,5300
1.88e+05,2015,443,3,1.75,1660,7350,1,0,0,2,8,1660,0,1979,1979,98023,47.312,122.34,1840,7673,36,0,4.75,3500,9333
7.495e+05,2014,242,4,2.75,2490,3840,1,0,0,4,7,1610,880,1922,1922,98103,47.655,122.34,1420,4000,92,0,6.75,3910,6490
6.645e+05,2015,487,4,2.25,3070,9210,2,0,0,3,8,2740,330,2010,2010,98011,47.764,122.2,2580,9660,5,0,6.25,5650,12730
4.199e+05,2015,394,3,1.5,1450,7000,1,0,0,3,7,1450,0,1955,1955,98007,47.598,122.15,1490,7245,60,0,4.5,2940,8695
2.1995e+05,2014,181,3,1.5,1620,9310,1,0,0,4,7,1620,0,1967,1967,98042,47.367,122.11,1610,10640,47,0,4.5,3230,12260
4.7e+05,2015,416,5,2,1900,6000,1,0,0,4,6,1900,0,1920,1920,98033,47.683,122.19,2110,8400,95,0,7,4010,10300
6e+05,2014,321,4,2.5,2990,5122,2,0,0,3,8,2990,0,2004,2004,98075,47.577,122.06,3140,7875,10,0,6.5,6130,10865
8.4645e+05,2015,477,4,2.5,3710,7491,2,0,0,3,9,3710,0,2003,2003,98029,47.56,122.02,3040,7491,12,0,6.5,6750,11201
4.3989e+05,2014,284,2,2,1300,6515,1,0,0,3,8,1300,0,2005,2005,98053,47.708,122.01,1640,6009,9,0,4,2940,7309
2.2995e+05,2014,159,4,1.75,1300,21000,1,0,0,4,7,1300,0,1969,1969,98001,47.307,122.28,2120,9920,45,0,5.75,3420,11220
5.25e+05,2014,129,3,2.5,2030,6970,2,0,0,4,8,2030,0,1991,1991,98029,47.572,122,2000,6140,23,0,5.5,4030,8170
3.182e+05,2015,452,3,2.5,1990,3644,2,0,0,3,7,1990,0,2010,2010,98038,47.353,122.02,2580,3800,5,0,5.5,4570,5790
4.9195e+05,2014,180,3,2.25,2090,10733,1,0,0,3,7,1440,650,1958,1958,98115,47.697,122.28,1740,8100,56,0,5.25,3830,10190
4.05e+05,2014,173,2,1,860,2599,1,0,0,4,6,860,0,1901,1901,98107,47.675,122.38,1300,3900,113,0,3,2160,4760
4.188e+05,2014,175,4,2.25,2100,9984,1,0,0,4,7,1290,810,1973,1973,98028,47.736,122.24,1930,10511,41,0,6.25,4030,12611
3.09e+05,2014,287,3,2.5,1990,3614,2,0,0,3,7,1990,0,2005,2005,98038,47.36,122.04,1980,3800,9,0,5.5,3970,5790
4.5e+05,2015,457,3,1.5,1390,10530,1,0,0,3,7,1390,0,1961,1961,98033,47.703,122.2,1750,10530,54,0,4.5,3140,11920
2.45e+05,2014,218,4,2.5,1700,4268,2,0,0,3,7,1700,0,2000,2000,98001,47.33,122.27,1700,4488,14,0,6.5,3400,6188
5.215e+05,2015,457,3,2.25,1450,1619,2,0,0,3,8,1140,310,2006,2006,98122,47.608,122.3,1580,3472,9,0,5.25,3030,4922
4.95e+05,2014,299,3,2.25,1780,8050,1,0,0,4,7,1230,550,1979,1979,98052,47.698,122.13,1780,7200,35,0,5.25,3560,8980
4.25e+05,2015,486,4,3,2430,5502,2,0,0,3,8,2430,0,2002,2002,98038,47.356,122.01,2000,5702,13,0,7,4430,8132
1.15e+06,2014,276,5,3.5,4350,6218,2,0,2,3,10,3520,830,2007,2007,98027,47.54,122,3260,5989,7,0,8.5,7610,10339
2.2e+05,2014,259,5,1.5,1830,94960,1,0,0,3,7,1830,0,1929,1929,98031,47.422,122.22,1440,16365,85,0,6.5,3270,18195
3.25e+05,2015,408,3,1,1300,9300,1,0,0,4,7,1300,0,1977,1977,98077,47.756,122.07,1300,10064,38,0,4,2600,11364
2e+05,2015,485,2,1.5,1360,1898,2,0,0,3,7,1360,0,1978,1978,98092,47.285,122.19,1360,1898,37,0,3.5,2720,3258
7.4745e+05,2014,230,3,2.5,2110,1339,2,0,0,3,8,1410,700,2014,2014,98122,47.609,122.31,1630,2670,0,0,5.5,3740,4780
1.87e+05,2014,202,3,2.5,1730,1803,2,0,0,3,7,1730,0,2005,2005,98166,47.465,122.33,1190,7980,9,0,5.5,2920,9710
4.4995e+05,2014,149,4,2.75,2320,4344,2,0,0,3,8,2320,0,2012,2012,98059,47.486,122.16,2310,3770,2,0,6.75,4630,6090
2.2e+05,2014,148,3,1,1180,5002,1,0,0,3,7,1180,0,1946,1946,98155,47.753,122.32,1470,8410,68,0,4,2650,9590
5.27e+05,2014,270,4,2.25,2380,5250,1,0,0,4,7,1410,970,1961,1961,98008,47.616,122.11,2150,8560,53,0,6.25,4530,10940
9.95e+05,2014,170,4,4.5,3850,13551,2,0,2,3,10,3000,850,1998,1998,98006,47.552,122.1,3480,10737,16,0,8.5,7330,14587
3.69e+05,2015,417,3,2.25,1820,99752,1,0,0,4,7,1820,0,1969,1969,98092,47.284,122.01,1850,1.1761e+05,46,0,5.25,3670,1.1943e+05
1.474e+05,2014,255,3,2,1080,9225,1,0,0,2,7,1080,0,1955,1955,98146,47.484,122.35,1410,9840,59,0,5,2490,10920
6.925e+05,2014,189,4,2.75,3710,7984,2,0,0,3,9,3710,0,1999,1999,98065,47.535,121.87,2950,7984,15,0,6.75,6660,11694
5.5473e+05,2014,183,4,2.5,2020,4350,2,0,0,5,9,1730,290,1943,1943,98199,47.65,122.41,1620,5800,71,0,6.5,3640,7820
5.35e+05,2014,203,2,3.5,2560,5000,1,0,0,4,6,1280,1280,1944,1944,98107,47.668,122.37,1390,4000,70,0,5.5,3950,6560
4.973e+05,2014,125,6,2.75,3200,9200,1,0,2,4,8,1600,1600,1953,1953,98146,47.492,122.36,2220,9500,61,0,8.75,5420,12700
4.58e+05,2014,208,4,3.5,3217,4000,2,0,0,3,8,2587,630,2008,2008,98055,47.448,122.2,2996,5418,6,0,7.5,6213,8635
7e+05,2014,319,3,2.5,2350,4975,2,0,0,3,8,2350,0,2012,2012,98029,47.542,122.01,2350,3951,2,0,5.5,4700,6301
5.67e+05,2014,141,3,2.5,2540,6093,2,0,0,3,9,2540,0,1999,1999,98034,47.704,122.24,2540,5924,15,0,5.5,5080,8464
3.4995e+05,2014,162,3,1,1060,9525,1,0,0,3,7,1060,0,1966,1966,98052,47.685,122.11,1630,9525,48,0,4,2690,10585
2.7e+05,2014,128,4,2.5,1810,6509,2,0,0,3,7,1810,0,1994,1994,98042,47.353,122.14,1760,7417,20,0,6.5,3570,9227
4.35e+05,2014,304,4,2,2630,9663,1,0,1,4,8,1330,1300,1956,1956,98056,47.484,122.19,1900,8894,58,0,6,4530,11524
5.85e+05,2014,125,2,1,1770,8640,1,0,0,3,6,1520,250,1949,1949,98117,47.693,122.36,1060,4804,65,0,3,2830,6574
3.675e+05,2014,122,4,3,3110,7231,2,0,0,3,8,3110,0,1997,1997,98092,47.328,122.19,2820,7311,17,0,7,5930,10421
2.7505e+05,2014,262,2,1,1060,6504,1,0,0,3,6,1060,0,1950,1950,98155,47.741,122.33,1100,7200,64,0,3,2160,8260
2.5e+05,2014,359,3,1,1520,7800,1,0,0,4,7,1120,400,1967,1967,98032,47.378,122.29,1740,8000,47,0,4,3260,9520
3.19e+05,2015,381,3,1.5,2010,10100,1,0,0,4,7,1110,900,1964,1964,98168,47.474,122.27,1900,10100,51,0,4.5,3910,12110
2.25e+05,2015,451,3,1,960,5512,1,0,0,4,6,960,0,1963,1963,98056,47.494,122.17,1090,5837,52,0,4,2050,6797
6.1e+05,2014,218,3,2.5,2260,33042,1,0,0,3,9,1660,600,1986,1986,98077,47.763,122.09,2600,40115,28,0,5.5,4860,42375
2.27e+05,2014,258,3,1,1130,10018,1,0,0,4,6,1130,0,1954,1954,98032,47.373,122.28,1770,7700,60,0,4,2900,8830
2.82e+05,2015,451,4,1,1200,11111,1,0,0,3,7,1200,0,1949,1949,98155,47.753,122.31,1350,9113,66,0,5,2550,10313
6.75e+05,2014,294,4,3,2780,5000,1,0,0,5,7,1710,1070,1919,1919,98116,47.572,122.38,1150,5000,95,0,7,3930,7780
5.55e+05,2014,331,4,1.75,2260,11000,1,0,0,3,8,1620,640,1976,1976,98008,47.622,122.11,1960,10000,38,0,5.75,4220,12260
7.25e+05,2015,426,4,1,1600,4500,1,0,0,4,7,1600,0,1926,1926,98115,47.68,122.32,1720,4500,89,0,5,3320,6100
1.54e+05,2014,249,2,1,1040,20524,1,0,3,3,6,1040,0,1949,1989,98014,47.698,121.88,1880,38996,65,1,3,2920,40036
4.35e+05,2014,298,3,2.25,1380,3015,2,0,0,3,7,1380,0,2009,2009,98052,47.678,122.16,1930,3612,5,0,5.25,3310,4992
3.4e+05,2014,252,4,2.5,2360,7475,2,0,0,3,8,2360,0,1992,1992,98031,47.405,122.17,2280,7570,22,0,6.5,4640,9930
7.8e+05,2014,180,4,2.5,3500,7048,2,0,0,3,9,3500,0,2005,2005,98053,47.681,122.03,3920,7864,9,0,6.5,7420,11364
5.5e+05,2014,200,4,3.5,3820,17745,2,0,2,3,8,2440,1380,1955,1955,98108,47.557,122.3,2520,9640,59,0,7.5,6340,13460
1.13e+06,2014,141,4,3.25,3810,8519,1,0,1,3,10,2680,1130,2007,2007,98033,47.699,122.21,3240,10748,7,0,7.25,7050,14558
2.4042e+05,2015,467,3,1.75,1120,10187,1,0,0,3,7,1120,0,1968,1968,98198,47.369,122.31,1900,8736,47,0,4.75,3020,9856
2.6795e+05,2015,470,4,1,1730,7350,1,0,0,4,6,1730,0,1970,1970,98003,47.347,122.31,1440,7752,45,0,5,3170,9482
8.6e+05,2014,229,5,1.75,2510,6000,1,0,0,5,8,2010,500,1920,1920,98144,47.58,122.29,2240,5000,94,0,6.75,4750,7510
5.05e+05,2014,181,4,2.75,2200,9778,1,0,0,4,8,1100,1100,1962,1962,98006,47.547,122.18,2140,11321,52,0,6.75,4340,13521
4.38e+05,2015,438,2,1,1120,6380,1,0,0,3,7,1120,0,1942,1994,98115,47.695,122.32,1230,6380,73,1,3,2350,7500
1.365e+05,2014,126,3,1.5,1420,8580,1,0,0,3,6,1420,0,1962,1962,98023,47.308,122.36,1200,8580,52,0,4.5,2620,10000
7.5495e+05,2014,147,3,2.5,2610,7256,2,0,0,3,9,2610,0,2014,2014,98033,47.695,122.18,2610,7206,0,0,5.5,5220,9816
2.99e+05,2014,203,3,2.25,1940,9100,1,0,0,4,8,1630,310,1966,1966,98023,47.313,122.36,2080,9100,48,0,5.25,4020,11040
3.3e+05,2015,464,3,1,960,7218,1,0,0,4,7,960,0,1969,1969,98034,47.728,122.23,1580,9104,46,0,4,2540,10064
2.499e+05,2014,173,3,2,1310,6738,1,0,0,4,7,1310,0,1990,1990,98042,47.369,122.08,1290,8067,24,0,5,2600,9377
3.142e+05,2015,459,1,1,610,6000,1,0,0,4,5,610,0,1918,1918,98117,47.691,122.37,970,5000,97,0,2,1580,5610
6.8889e+05,2015,439,3,3.25,2580,9825,1,0,1,4,9,1760,820,1978,1978,98027,47.531,122.05,2140,10270,37,0,6.25,4720,12850
3.95e+05,2015,478,2,1,1440,7808,1,0,0,4,7,860,580,1949,1949,98133,47.743,122.34,1550,7682,66,0,3,2990,9122
2.9995e+05,2015,423,3,2.5,1740,4497,2,0,0,3,7,1740,0,2012,2012,98042,47.37,122.12,1950,4486,3,0,5.5,3690,6226
6.65e+05,2014,249,4,3.5,2650,3474,2,0,0,3,8,2230,420,2011,2011,98027,47.538,122.05,2330,3474,3,0,7.5,4980,6124
2.95e+05,2015,472,3,1.75,1060,8100,2,0,0,4,7,1060,0,1983,1983,98038,47.362,122.05,1410,8100,32,0,4.75,2470,9160
5.825e+05,2014,134,2,1.5,1159,4800,1,0,0,3,7,1159,0,1948,1948,98199,47.659,122.4,1640,4800,66,0,3.5,2799,5959
4.54e+05,2014,229,3,2.5,1590,4094,2,0,0,3,7,1590,0,1991,1991,98122,47.61,122.29,1940,3924,23,0,5.5,3530,5514
2.83e+05,2015,467,3,1.75,1830,7600,2,0,0,3,7,1490,340,1947,1947,98106,47.532,122.35,1300,4000,68,0,4.75,3130,5830
3.87e+05,2014,140,2,2.25,1230,1280,2,0,0,3,8,960,270,2012,2012,98144,47.594,122.3,1130,1357,2,0,4.25,2360,2587
1.485e+06,2014,272,4,3.5,3930,6120,2,0,0,3,10,3310,620,2007,2007,98105,47.665,122.28,3390,6120,7,0,7.5,7320,10050
5.55e+05,2014,125,3,2.5,1940,3211,2,0,0,3,8,1940,0,2009,2009,98027,47.564,122.09,1880,3078,5,0,5.5,3820,5018
2.3e+05,2014,294,3,1.75,1420,3000,1,0,0,3,5,710,710,1931,2014,98178,47.493,122.27,1960,5000,83,1,4.75,3380,6420
2e+05,2014,170,3,2.25,1230,7420,1,0,0,5,7,1230,0,1913,1913,98002,47.318,122.22,1260,7556,101,0,5.25,2490,8786
2.75e+05,2014,250,2,1,1140,10404,1,0,0,3,5,1140,0,1935,1935,98155,47.75,122.29,2200,11550,79,0,3,3340,12690
4.575e+05,2014,174,3,2.25,1430,2003,2,0,0,3,8,980,450,1996,1996,98144,47.591,122.29,2210,4000,18,0,5.25,3640,5430
3.95e+05,2015,433,3,2.5,1630,15200,1,0,0,3,7,1120,510,1988,1988,98072,47.745,122.1,2050,15200,27,0,5.5,3680,16830
8.1e+05,2014,163,3,1.75,1980,13503,1,0,2,4,9,1320,660,1952,1952,98008,47.587,122.11,2450,10890,62,0,4.75,4430,12870
4.25e+05,2015,460,4,2.5,1920,9000,2,0,0,2,7,1920,0,1989,1989,98126,47.515,122.37,1530,10474,26,0,6.5,3450,12394
8.65e+05,2014,154,3,1.75,2090,4725,2,0,0,3,7,1610,480,1947,2013,98199,47.657,122.39,1280,4725,67,1,4.75,3370,6815
4.17e+05,2014,135,3,1.5,1340,10224,1,0,0,4,7,1340,0,1956,1956,98006,47.575,122.16,1340,10440,58,0,4.5,2680,11780
8.62e+05,2015,459,4,2.25,2220,4200,1,0,0,5,8,1310,910,1932,1932,98199,47.642,122.39,2020,4940,83,0,6.25,4240,7160
8.4e+05,2015,463,4,2.5,2480,4602,2,0,0,3,9,2480,0,2000,2000,98052,47.684,122.16,3480,5739,15,0,6.5,5960,8219
3.83e+05,2014,265,3,1,1150,10196,1,0,0,4,7,1150,0,1957,1957,98052,47.679,122.16,1410,8925,57,0,4,2560,10075
3.32e+05,2015,446,2,1,1150,8138,1,0,0,3,7,1150,0,1954,1954,98155,47.737,122.33,1300,8139,61,0,3,2450,9289
3.675e+05,2014,221,4,2.25,1930,7925,1,0,0,3,8,1300,630,1960,1960,98155,47.763,122.31,1930,7200,54,0,6.25,3860,9130
6.23e+05,2014,256,4,2.5,2980,9235,1,0,0,4,8,1690,1290,1977,1977,98006,47.551,122.16,2690,10046,37,0,6.5,5670,13026
7.4e+05,2014,298,3,2.5,2960,9350,2,0,2,4,9,2960,0,1978,1978,98008,47.622,122.09,2960,11745,36,0,5.5,5920,14705
1.355e+06,2014,175,3,1.5,2680,4775,2,0,2,5,8,1880,800,1913,1913,98109,47.633,122.35,2280,5947,101,0,4.5,4960,8627
2.59e+05,2014,142,3,2.5,1550,3569,2,0,0,3,7,1550,0,2011,2011,98002,47.353,122.21,2095,3402,3,0,5.5,3645,4952
8.94e+05,2015,473,4,2.5,3800,22029,2,0,0,3,9,3800,0,1993,1993,98053,47.673,122.03,3170,24979,22,0,6.5,6970,28779
3.53e+05,2014,306,4,1.75,1780,9794,1,0,0,3,7,1780,0,1967,1967,98077,47.742,122.07,1160,9750,47,0,5.75,2940,11530
3.15e+05,2014,191,3,1.75,1660,37642,1,0,0,4,7,1660,0,1991,1991,98022,47.256,122.01,2070,54450,23,0,4.75,3730,56110
4.25e+05,2015,410,4,1.5,2290,8773,1,0,0,4,7,1330,960,1947,1947,98133,47.717,122.33,1740,7058,68,0,5.5,4030,9348
9.3e+05,2014,128,3,3.25,2640,4080,2,0,0,3,9,1840,800,1912,2000,98105,47.664,122.33,1990,4080,102,1,6.25,4630,6720
3.4995e+05,2014,252,3,2.5,2240,7565,2,0,0,3,8,2240,0,1999,1999,98003,47.349,122.3,2190,8254,15,0,5.5,4430,10494
2.55e+05,2014,354,3,1,1580,8206,1,0,0,3,7,1100,480,1962,1962,98198,47.368,122.31,1600,8196,52,0,4,3180,9776
7.3e+05,2014,341,4,2.5,2030,4080,1,0,0,4,8,1730,300,1921,1921,98115,47.675,122.31,1980,4080,93,0,6.5,4010,6110
4.85e+05,2015,399,4,2.75,2720,51396,2,0,0,4,8,2720,0,1977,1977,98059,47.478,122.1,1960,51366,38,0,6.75,4680,54086
6.3e+05,2015,437,3,3,1880,2200,2,0,0,3,8,1520,360,2007,2007,98107,47.667,122.37,1500,1426,8,0,6,3380,3306
4.67e+05,2014,243,3,2.25,1420,990,3,0,0,3,8,1420,0,2008,2008,98103,47.68,122.35,1350,1415,6,0,5.25,2770,2835
1.65e+05,2015,365,3,1,970,7503,1,0,0,4,6,970,0,1967,1967,98058,47.469,122.16,1230,9504,48,0,4,2200,10474
3.461e+05,2014,197,3,2.5,1400,2036,2,0,0,3,7,1400,0,2003,2003,98136,47.552,122.38,1500,2036,11,0,5.5,2900,3436
2.82e+05,2014,236,3,2.5,1610,6000,2,0,0,4,7,1610,0,1993,1993,98038,47.349,122.04,1570,6000,21,0,5.5,3180,7610
4.5e+05,2014,300,5,2.75,2710,6220,2,0,0,3,8,2710,0,2014,2014,98038,47.355,122.06,2530,4759,0,0,7.75,5240,7469
1.901e+06,2014,154,3,2.5,2660,13367,2,0,2,3,10,2660,0,1992,1992,98004,47.65,122.22,2660,13367,22,0,5.5,5320,16027
3.1495e+05,2014,209,2,2.5,1860,6359,2,0,0,3,7,1860,0,2003,2003,98038,47.385,122.03,1860,6359,11,0,4.5,3720,8219
3.5e+05,2014,149,4,2.5,2040,22653,2,0,0,3,7,2040,0,2011,2011,98168,47.499,122.3,2020,20502,3,0,6.5,4060,22542
4e+05,2014,159,4,3.5,2370,3692,2,0,0,3,8,2370,0,2013,2013,98056,47.504,122.17,2520,5425,1,0,7.5,4890,7795
1.15e+06,2015,374,3,1.75,1760,6788,2,1,4,3,7,1760,0,1940,1960,98125,47.734,122.28,1630,7588,75,1,4.75,3390,9348
5.45e+05,2014,239,4,2.5,2080,8504,2,0,0,3,8,2080,0,1991,1991,98029,47.57,122,2000,6773,23,0,6.5,4080,8853
1.35e+05,2015,477,2,1,750,5217,1,0,0,4,6,750,0,1943,1943,98106,47.519,122.35,760,4440,72,0,3,1510,5190
6.195e+05,2014,136,3,2.5,2170,5000,2,0,0,3,9,2170,0,2003,2003,98029,47.546,122,2170,5000,11,0,5.5,4340,7170
3.85e+05,2014,331,4,2.5,1950,7350,1,0,0,3,7,1150,800,1963,1963,98052,47.656,122.13,2050,9068,51,0,6.5,4000,11018
4e+05,2015,459,4,1.75,1770,12875,1,0,0,3,8,1770,0,1988,1988,98028,47.744,122.25,2150,12875,27,0,5.75,3920,14645
4.6e+05,2015,431,2,1,1030,5934,1,0,0,4,7,1030,0,1928,1928,98115,47.683,122.29,1420,5588,87,0,3,2450,6618
1.5e+05,2014,166,3,1.5,1230,8056,1,0,0,4,6,1230,0,1949,1949,98168,47.488,122.31,850,6714,65,0,4.5,2080,7944
4.513e+05,2014,205,3,2.5,1420,814,2,0,0,3,8,1140,280,2008,2008,98136,47.543,122.39,1340,1382,6,0,5.5,2760,2802
3.3485e+05,2014,198,2,1,870,5635,1,0,0,3,7,870,0,1948,1948,98116,47.568,122.4,1310,5750,66,0,3,2180,6620
3.8e+05,2015,424,3,2.5,2150,25705,1,0,0,3,6,2150,0,1980,2009,98058,47.451,122.09,1850,20160,35,1,5.5,4000,22310
1.81e+05,2015,467,2,1,1310,4000,1,0,0,3,7,950,360,1942,1942,98144,47.58,122.31,1310,4000,73,0,3,2620,5310
7.75e+05,2014,325,4,1.75,2090,5050,1,0,0,4,7,1090,1000,1916,1916,98117,47.68,122.36,1760,5000,98,0,5.75,3850,7090
1.688e+06,2014,162,4,2.5,3000,7500,2,0,0,3,9,3000,0,1937,1994,98105,47.657,122.28,2580,5000,77,1,6.5,5580,8000
2.44e+05,2015,450,3,1.5,1360,9625,1,0,0,3,7,1360,0,1963,1963,98030,47.38,122.21,1890,9625,52,0,4.5,3250,10985
2.2695e+05,2014,279,2,1,930,6600,1,0,0,3,6,930,0,1957,1957,98168,47.487,122.33,1250,6600,57,0,3,2180,7530
2.14e+05,2014,249,3,1,1020,9147,1,0,0,4,6,1020,0,1900,1965,98010,47.313,122,1600,9700,114,1,4,2620,10720
1.425e+06,2014,359,5,3,2840,6240,2,0,0,5,9,2440,400,1905,1905,98112,47.629,122.31,2940,6000,109,0,8,5780,8840
3.59e+05,2014,224,3,1.75,2200,11520,1,0,0,4,7,2200,0,1952,1952,98133,47.766,122.34,1690,8038,62,0,4.75,3890,10238
2.9e+05,2014,310,3,2.5,1420,3542,2,0,0,3,8,1310,110,2007,2007,98133,47.773,122.34,1180,1622,7,0,5.5,2600,3042
4.95e+05,2015,493,4,3.5,2490,18042,2,0,0,3,8,2490,0,2003,2003,98070,47.416,122.44,1960,21107,12,0,7.5,4450,23597
3.88e+05,2015,457,3,1.75,1350,2325,3,0,0,3,7,1350,0,1999,1999,98103,47.697,122.35,1520,1652,16,0,4.75,2870,3002
6.95e+05,2014,160,3,2.75,2540,4694,2,0,0,3,9,2540,0,2005,2005,98074,47.621,122.02,2600,6344,9,0,5.75,5140,8884
3.2e+05,2015,456,4,1.75,1820,7381,1,0,0,5,7,1150,670,1962,1962,98058,47.457,122.17,1610,8462,53,0,5.75,3430,10282
7.5e+05,2014,169,3,3.5,3390,10078,2,0,0,3,10,3040,350,2012,2012,98056,47.537,122.19,3290,12332,2,0,6.5,6680,15722
6.08e+05,2014,299,3,2.5,1760,1472,3,0,0,3,8,1640,120,2006,2006,98119,47.647,122.37,1760,5400,8,0,5.5,3520,7160
8.81e+05,2014,161,5,3,2510,4125,1,0,3,5,8,1590,920,1925,1925,98144,47.597,122.29,2190,5415,89,0,8,4700,7925
4.5e+05,2015,479,2,1.75,1760,2275,1,0,0,3,6,1040,720,1912,1912,98116,47.58,122.39,1380,3750,103,0,3.75,3140,5510
5.39e+05,2014,290,7,2.25,2620,6890,2,0,0,4,7,2620,0,1961,1961,98007,47.612,122.13,2070,7910,53,0,9.25,4690,10530
1.715e+06,2014,204,4,3.75,4490,7623,2,0,0,4,10,3090,1400,1941,1941,98112,47.632,122.29,3760,7653,73,0,7.75,8250,12143
5.77e+05,2014,359,3,2.5,2560,5238,2,0,0,3,8,2560,0,2001,2001,98053,47.689,122.04,2560,5185,13,0,5.5,5120,7745
2.5e+05,2014,183,3,1.75,1770,8868,1,0,0,4,7,1770,0,1959,1959,98002,47.319,122.21,1630,9706,55,0,4.75,3400,11476
2.48e+05,2014,293,1,1,790,12000,1,0,0,3,6,790,0,1918,1918,98118,47.515,122.27,1900,6000,96,0,2,2690,6790
4.175e+05,2014,276,5,3,2270,6664,1,0,0,3,7,1340,930,1995,1995,98125,47.719,122.31,1870,6187,19,0,8,4140,8457
1.95e+05,2014,235,3,1.5,1190,8726,1,0,0,3,7,1190,0,1956,1956,98146,47.489,122.34,1390,8741,58,0,4.5,2580,9931
4.835e+05,2014,230,3,2,1200,2016,1,0,1,4,7,600,600,1931,1931,98116,47.581,122.4,1730,4520,83,0,5,2930,5720
1.45e+06,2014,187,4,3.25,3770,4103,2,0,0,5,9,2710,1060,1925,1925,98109,47.641,122.35,2560,4160,89,0,7.25,6330,7930
4.55e+05,2014,303,4,2.5,1320,7000,1,0,0,4,7,1320,0,1956,1956,98008,47.601,122.13,1550,8610,58,0,6.5,2870,9930
3.35e+05,2014,248,2,1,1360,69260,1,0,0,4,5,1360,0,1937,1937,98065,47.523,121.84,1460,69260,77,0,3,2820,70620
5.7e+05,2014,242,3,1.5,1980,10203,1,0,0,4,7,1680,300,1946,1946,98010,47.34,122.05,1980,13664,68,0,4.5,3960,15644
3.1e+05,2015,437,4,2.75,2060,8100,1,0,0,4,7,1310,750,1988,1988,98198,47.358,122.32,1540,8100,27,0,6.75,3600,10160
7.5e+05,2014,223,3,2.25,2250,5301,2,0,0,4,8,1510,740,1975,1975,98115,47.674,122.27,2240,7200,39,0,5.25,4490,9450
4.85e+05,2015,478,4,2.75,1830,8384,1,0,0,3,7,1320,510,1979,1979,98034,47.733,122.22,2190,7695,36,0,6.75,4020,9525
3.45e+05,2015,467,3,2.75,2190,7258,2,0,0,3,8,2190,0,2000,2000,98003,47.349,122.3,2190,8645,15,0,5.75,4380,10835
6.85e+05,2014,300,3,2,2210,5000,1,0,2,3,7,1710,500,1909,1909,98103,47.675,122.36,1920,5000,105,0,5,4130,7210
4.47e+05,2015,436,3,2.5,1800,3074,2,0,0,3,7,1800,0,2003,2003,98072,47.763,122.15,1610,2929,12,0,5.5,3410,4729
3.415e+05,2014,313,3,1.5,1130,7223,1,0,0,4,7,1130,0,1961,1961,98056,47.509,122.19,1320,7356,53,0,4.5,2450,8486
4.29e+05,2014,141,3,2.5,2420,49928,2,0,0,3,8,1860,560,1985,1985,98027,47.463,122.01,2620,37301,29,0,5.5,5040,39721
2.7e+05,2014,269,4,2.75,2440,7150,1,0,0,3,7,1200,1240,1963,1985,98032,47.366,122.28,1790,7150,51,1,6.75,4230,9590
7.9e+05,2014,312,4,2.5,2560,12760,1,0,0,4,7,1760,800,1949,1949,98115,47.695,122.3,1760,6384,65,0,6.5,4320,8944
4.325e+05,2014,346,3,2.5,2390,6435,1,0,0,3,8,1600,790,1978,1978,98034,47.726,122.19,2020,7300,36,0,5.5,4410,9690
4.775e+05,2014,252,2,2,2090,6000,2,0,1,3,7,2090,0,1918,1985,98116,47.573,122.41,1600,5400,96,1,4,3690,7490
4.95e+05,2014,122,4,1.75,1600,6380,1,0,0,3,8,1130,470,1959,1959,98125,47.701,122.31,1090,6380,55,0,5.75,2690,7980
2.15e+05,2014,202,4,2.25,1500,5393,2,0,0,3,7,1500,0,1999,1999,98001,47.338,122.26,1500,5952,15,0,6.25,3000,7452
3.5e+05,2015,416,3,1,2480,8906,1,0,0,3,7,1240,1240,1969,1969,98118,47.537,122.29,1800,8906,46,0,4,4280,11386
6.9e+05,2014,319,3,2,1770,1800,3,0,0,3,8,1770,0,1999,1999,98122,47.61,122.31,1890,3200,15,0,5,3660,4970
3.2945e+05,2014,174,2,1.5,830,1119,2,0,0,3,7,830,0,2005,2005,98144,47.583,122.31,1480,3622,9,0,3.5,2310,4452
6.64e+05,2014,293,4,2.5,1870,16200,1,0,0,5,8,1250,620,1974,1974,98033,47.665,122.17,2000,11250,40,0,6.5,3870,13120
3.95e+05,2015,431,3,2.5,2300,8938,2,0,0,3,9,2300,0,1989,1989,98031,47.418,122.21,2570,9694,26,0,5.5,4870,11994
6.25e+05,2014,195,3,2,1880,4000,1,0,2,3,8,1280,600,1950,1950,98199,47.638,122.39,1920,4000,64,0,5,3800,5880
3.25e+05,2015,362,3,2.5,1870,3480,2,0,0,3,7,1870,0,2002,2002,98056,47.483,122.18,2160,3480,13,0,5.5,4030,5350
6.65e+05,2014,142,4,2.5,2600,17388,2,0,0,3,9,2600,0,1996,1996,98059,47.528,122.15,2950,11553,18,0,6.5,5550,14153
4.5e+05,2015,459,4,2.5,2070,3982,2,0,0,3,7,2070,0,2004,2004,98065,47.531,121.85,2340,4067,11,0,6.5,4410,6137
7.155e+05,2014,278,3,2.25,2410,9668,1,0,1,4,8,1540,870,1965,1965,98117,47.7,122.39,2510,5250,49,0,5.25,4920,7660
4.457e+05,2014,122,3,2.5,1270,1180,3,0,0,3,8,1270,0,2001,2001,98107,47.67,122.39,1320,1180,13,0,5.5,2590,2450
4.548e+05,2014,215,4,2.25,2490,10720,1,0,1,4,7,1400,1090,1979,1979,98074,47.614,122.06,3080,10720,35,0,6.25,5570,13210
4.79e+05,2015,376,3,2.5,1690,3322,2,0,0,3,7,1690,0,2003,2003,98053,47.682,122.04,1650,3446,12,0,5.5,3340,5136
9.25e+05,2015,470,4,4.25,3770,13058,2,0,0,4,8,3770,0,1983,1983,98028,47.752,122.22,2200,12255,32,0,8.25,5970,16025
2.863e+05,2015,415,3,2.75,2000,6405,1,0,0,3,8,1260,740,1964,1964,98178,47.507,122.26,2130,6510,51,0,5.75,4130,8510
1.56e+05,2015,389,2,1,920,5889,1,0,0,4,6,920,0,1950,1950,98002,47.301,122.22,1210,6180,65,0,3,2130,7100
8e+05,2014,293,4,3.75,2540,20662,2,0,0,3,10,2540,0,1998,1998,98075,47.588,122.01,2490,37731,16,0,7.75,5030,40271
1.7e+05,2014,203,4,1.75,1920,7500,1,0,0,4,7,1920,0,1962,1962,98198,47.422,122.32,1490,8000,52,0,5.75,3410,9920
7.75e+05,2014,195,5,1.5,1720,5000,1,0,0,3,8,1720,0,1915,1915,98103,47.663,122.36,1720,5000,99,0,6.5,3440,6720
1.85e+05,2014,317,3,1,980,9135,1,0,0,3,7,980,0,1955,1955,98001,47.35,122.29,1780,9135,59,0,4,2760,10115
5e+05,2015,437,3,2.75,3410,9360,1,0,0,4,8,3410,0,1967,1967,98058,47.45,122.15,2260,10128,48,0,5.75,5670,13538
4.65e+05,2014,161,4,2.5,2090,9702,1,0,0,5,7,1320,770,1965,1965,98133,47.747,122.34,1850,7200,49,0,6.5,3940,9290
8.5e+05,2014,162,4,2.25,2130,11843,2,0,0,4,9,2130,0,1972,1972,98040,47.536,122.22,2380,11643,42,0,6.25,4510,13773
7.9995e+05,2014,307,3,3,2900,11769,2,0,0,3,10,2900,0,1997,1997,98052,47.699,122.12,2900,9611,17,0,6,5800,12511
3.709e+05,2014,265,3,1.5,1200,8560,1,0,0,4,7,1200,0,1975,1975,98011,47.739,122.19,1550,7800,39,0,4.5,2750,9000
8e+05,2014,223,2,1,1050,8750,1,0,0,4,7,1050,0,1951,1951,98004,47.629,122.22,3360,20115,63,0,3,4410,21165
6.32e+05,2014,237,5,2.5,2260,10087,1,0,0,3,8,1520,740,1967,1967,98008,47.598,122.13,2500,9440,47,0,7.5,4760,11700
2.15e+05,2015,395,3,1,1060,7900,1,0,0,3,7,1060,0,1961,2001,98058,47.46,122.18,1310,7900,54,1,4,2370,8960
3.625e+05,2014,174,4,1.75,1450,8450,1,0,0,3,7,1450,0,1960,1960,98027,47.529,122.03,1540,8450,54,0,5.75,2990,9900
1.25e+06,2014,292,5,2.75,2960,28300,1,0,3,4,9,2160,800,1959,1959,98177,47.761,122.37,2940,23250,55,0,7.75,5900,26210
7.39e+05,2014,259,4,2.5,2780,6737,2,0,0,3,9,2780,0,2002,2002,98006,47.566,122.12,2750,7950,12,0,6.5,5530,10730
2.6e+05,2014,256,4,2.75,2250,7345,1,0,0,4,8,1320,930,1984,1984,98023,47.289,122.37,1800,6950,30,0,6.75,4050,9200
3.05e+05,2014,285,2,1,1030,6000,1,0,0,3,7,1030,0,1925,1925,98118,47.567,122.28,1510,5000,89,0,3,2540,6030
2.1e+05,2014,318,4,2.25,1500,5393,2,0,0,3,7,1500,0,1999,1999,98001,47.338,122.26,1700,5917,15,0,6.25,3200,7417
2.95e+05,2015,465,3,2.5,1940,10350,1,0,0,3,7,1420,520,1979,1979,98001,47.339,122.26,1810,7800,36,0,5.5,3750,9740
3.365e+05,2014,174,3,1,1480,7284,1,0,0,3,7,970,510,1963,1963,98133,47.776,122.35,2020,7920,51,0,4,3500,9400
2.65e+05,2015,462,2,1.5,1084,3427,2,0,0,3,7,1084,0,1976,1976,98125,47.712,122.33,1084,6250,39,0,3.5,2168,7334
9.4e+05,2015,459,4,1.5,2430,3600,2,0,0,3,8,2430,0,1980,1980,98112,47.635,122.28,2020,4800,35,0,5.5,4450,7230
6.25e+05,2014,259,2,1.75,1460,1500,2,0,0,3,8,1000,460,2008,2008,98103,47.685,122.36,1440,4120,6,0,3.75,2900,5580
4.57e+05,2014,301,2,2.5,1380,1329,2,0,0,3,8,1050,330,2008,2008,98117,47.69,122.37,1360,3750,6,0,4.5,2740,5130
4.3e+05,2015,451,3,2.5,2000,35438,2,0,0,3,7,2000,0,1968,2005,98027,47.473,121.99,2000,51836,47,1,5.5,4000,53836
6.5e+05,2014,252,3,2.5,2690,11575,1,0,3,3,8,2130,560,1957,1957,98028,47.761,122.27,2390,11782,57,0,5.5,5080,14472
2.735e+05,2014,190,3,2.5,1550,3402,2,0,0,3,7,1550,0,2009,2009,98002,47.352,122.21,2095,3402,5,0,5.5,3645,4952
3.37e+05,2014,173,3,1.75,1310,12750,1,0,0,3,7,1310,0,1993,1993,98059,47.469,122.07,1790,13500,21,0,4.75,3100,14810
5.71e+05,2014,160,4,2,2750,7807,1,0,0,5,7,2250,500,1916,1916,98125,47.717,122.29,1510,7807,98,0,6,4260,10557
6.59e+05,2014,182,4,2,2090,10800,1,0,0,4,7,2090,0,1951,1951,98040,47.576,122.22,2090,10800,63,0,6,4180,12890
3.5e+05,2014,190,4,1,1170,8147,1,0,0,3,6,1170,0,1959,1959,98125,47.728,122.29,1260,8147,55,0,5,2430,9317
4.38e+05,2015,479,2,2.25,1950,29347,1,0,0,3,8,1350,600,1953,1953,98133,47.739,122.35,2125,7751,62,0,4.25,4075,9701
6.5e+05,2014,215,3,1.75,1840,2310,1,0,2,4,8,1140,700,1914,1914,98109,47.646,122.35,1670,4000,100,0,4.75,3510,5840
4.45e+05,2014,181,4,2.5,2280,42077,2,0,0,3,8,2280,0,1994,1994,98042,47.342,122.08,2280,36236,20,0,6.5,4560,38516
4.35e+05,2014,216,3,1,1400,4800,1,0,0,4,6,700,700,1917,1917,98136,47.55,122.39,1470,6000,97,0,4,2870,7400
2.4e+05,2014,272,4,2.25,1830,7614,2,0,0,3,7,1830,0,1991,1991,98030,47.368,122.18,1860,6930,23,0,6.25,3690,8760
2.8e+05,2015,426,3,2.25,1700,7210,1,0,0,4,7,1250,450,1974,1974,98003,47.355,122.32,2070,7300,41,0,5.25,3770,9000
3.0321e+05,2014,160,4,2.5,2009,5000,2,0,0,3,8,2009,0,2014,2014,98092,47.258,122.2,2009,5182,0,0,6.5,4018,7191
1.1e+06,2014,287,4,2.75,3590,5625,2,0,0,3,10,3590,0,2012,2012,98052,47.696,122.13,3590,5625,2,0,6.75,7180,9215
2.785e+05,2015,410,4,1,1540,8400,1,0,0,3,7,770,770,1971,1971,98058,47.428,122.15,1520,9891,44,0,5,3060,11431
3.23e+05,2014,129,4,2.75,1970,7213,1,0,0,3,8,1170,800,1977,1977,98058,47.442,122.13,1980,7045,37,0,6.75,3950,9015
4.55e+05,2015,479,2,1.5,1090,6750,1,0,0,3,7,950,140,1942,1942,98117,47.684,122.4,1640,6750,73,0,3.5,2730,7840
6.12e+05,2015,465,3,2.5,2180,5496,2,0,0,3,8,2180,0,1994,1994,98029,47.572,122.01,2120,5496,21,0,5.5,4300,7676
1.87e+06,2014,126,5,4,4510,15175,2,0,0,3,10,4510,0,1969,2002,98040,47.531,122.23,3510,13500,45,1,9,8020,18010
3.6e+06,2014,318,3,3.25,5020,12431,2,1,4,3,10,3420,1600,1941,2002,98144,47.593,122.29,3680,12620,73,1,6.25,8700,17640
4.59e+05,2014,277,3,1.5,1160,1031,3,0,0,3,8,1160,0,2008,2008,98103,47.654,122.36,1268,1688,6,0,4.5,2428,2848
1.98e+05,2014,217,2,1,790,14200,1,0,0,3,7,790,0,1951,1951,98188,47.459,122.28,1430,10000,63,0,3,2220,10790
4.6e+05,2014,228,3,2.25,1650,7313,1,0,0,3,7,1220,430,1975,1975,98011,47.737,122.19,1690,7252,39,0,5.25,3340,8902
4e+05,2014,229,3,2.25,1740,11040,2,0,0,3,8,1740,0,1980,1980,98028,47.738,122.24,1720,11778,34,0,5.25,3460,13518
3.1e+05,2014,354,2,1,1400,4500,1,0,0,3,7,900,500,1922,1922,98055,47.487,122.22,1400,5500,92,0,3,2800,6900
8.65e+05,2015,464,4,2.5,3560,13981,2,0,0,3,10,3560,0,2000,2000,98075,47.6,121.98,3840,13624,15,0,6.5,7400,17184
3.59e+05,2014,248,4,1.75,1680,9244,2,0,0,3,8,1680,0,1991,1991,98166,47.461,122.35,1840,9387,23,0,5.75,3520,11067
3.7e+05,2014,148,4,2.5,3090,18645,2,0,0,3,9,3090,0,1995,1995,98023,47.29,122.34,3610,20114,19,0,6.5,6700,23204
4.74e+05,2014,183,3,1.75,1530,8000,2,0,0,3,7,1530,0,1978,1978,98052,47.697,122.13,1530,7500,36,0,4.75,3060,9030
7.1995e+05,2014,318,3,2.25,2190,2416,3,0,0,3,8,2190,0,2014,2014,98117,47.676,122.38,1510,3615,0,0,5.25,3700,5805
2.6385e+05,2014,244,4,2.25,2300,7524,2,0,0,4,8,2300,0,1978,1978,98023,47.313,122.39,2270,8025,36,0,6.25,4570,10325
7.4995e+05,2014,189,4,2.75,2910,18700,1,0,0,3,9,2210,700,1957,1995,98177,47.756,122.37,2420,26140,57,1,6.75,5330,29050
3.65e+05,2014,321,2,1,920,6600,1,0,0,4,6,920,0,1910,1910,98118,47.557,122.28,1370,5500,104,0,3,2290,6420
4.45e+05,2015,473,4,2.5,2990,6383,2,0,0,3,7,2990,0,2003,2003,98038,47.35,122.03,2640,6454,12,0,6.5,5630,9444
7.55e+05,2014,332,3,2.75,2870,6600,2,0,2,3,8,2870,0,1984,1984,98008,47.575,122.11,2570,7925,30,0,5.75,5440,10795
5e+05,2014,252,3,2,1550,6394,1,0,0,5,8,1550,0,1918,1918,98126,47.522,122.38,1440,6387,96,0,5,2990,7937
4.125e+05,2014,293,3,2,1680,5246,1,0,0,3,7,1680,0,2007,2007,98065,47.521,121.87,2430,6883,7,0,5,4110,8563
6.67e+05,2014,166,3,1.5,1720,8100,2,0,0,3,8,1720,0,1907,1907,98107,47.675,122.4,2210,8100,107,0,4.5,3930,9820
2.82e+05,2014,310,4,2.5,1785,2552,2,0,0,3,8,1785,0,2009,2009,98030,47.358,122.2,1691,2700,5,0,6.5,3476,4485
7.8e+05,2015,486,5,2.5,3480,74052,1,0,0,4,8,1980,1500,1972,1972,98027,47.496,122.06,2610,65775,43,0,7.5,6090,69255
3.53e+05,2015,485,3,2,1678,13862,1,0,0,3,7,1678,0,1994,1994,98030,47.374,122.19,1550,11753,21,0,5,3228,13431
7.8e+05,2014,188,2,2.5,2560,2500,2,0,0,5,8,1690,870,1901,1901,98112,47.623,122.3,1890,5000,113,0,4.5,4450,7560
6.1e+05,2014,231,3,2.5,2060,8893,2,0,0,3,8,2060,0,1987,1987,98006,47.562,122.17,2650,8500,27,0,5.5,4710,10560
2.68e+05,2014,147,4,2,1930,6600,1,0,0,4,7,1030,900,1967,1967,98168,47.482,122.33,1220,6600,47,0,6,3150,8530
5.5e+05,2015,474,3,2.5,2250,7752,2,0,0,4,8,2250,0,1988,1988,98011,47.749,122.19,2080,7033,27,0,5.5,4330,9283
2.79e+05,2014,339,4,2.5,2009,4800,2,0,0,3,8,2009,0,2012,2012,98092,47.259,122.2,1798,4800,2,0,6.5,3807,6809
4.92e+05,2014,127,4,2.5,3305,16164,1,0,0,5,7,2245,1060,1922,1956,98133,47.756,122.34,1620,8883,92,1,6.5,4925,12188
5.32e+05,2015,466,3,1,2360,5012,1,0,0,3,7,1560,800,1964,1964,98116,47.571,122.38,1690,4800,51,0,4,4050,7160
9.09e+05,2014,224,4,2.5,3680,11648,2,0,0,3,10,3680,0,1986,1986,98006,47.56,122.11,2830,11251,28,0,6.5,6510,14931
2.29e+05,2014,239,3,1,1030,7800,1,0,0,3,7,1030,0,1954,1954,98168,47.473,122.32,1630,12664,60,0,4,2660,13694
5e+05,2014,217,3,1.75,1560,16194,1,0,0,3,8,1560,0,1961,1961,98005,47.597,122.17,2430,16193,53,0,4.75,3990,17753
4.75e+05,2014,225,3,2.5,2770,98881,2,0,0,3,9,2770,0,1991,1991,98022,47.257,121.95,1830,74923,23,0,5.5,4600,77693
3.2e+05,2014,294,2,1,1380,5820,1,0,0,3,7,1380,0,1918,1976,98117,47.688,122.39,1540,4076,96,1,3,2920,5456
4.4e+05,2014,163,4,2.25,2010,7575,1,0,0,3,7,1220,790,1974,1974,98034,47.733,122.2,1820,7831,40,0,6.25,3830,9841
6.15e+05,2014,122,3,1.75,2360,7291,1,0,0,4,8,1360,1000,1948,1948,98136,47.527,122.38,1860,5499,66,0,4.75,4220,7859
5.55e+05,2014,331,4,2.25,1720,2300,1,0,0,3,7,860,860,1940,2014,98116,47.576,122.41,1720,4680,74,1,6.25,3440,6400
2.478e+05,2014,212,3,2.5,1580,2170,2,0,0,3,7,1580,0,2003,2003,98118,47.542,122.29,1610,1917,11,0,5.5,3190,3497
2.62e+05,2015,396,4,2.5,1560,7800,2,0,0,3,7,1560,0,1997,1997,98168,47.514,122.32,1160,7800,18,0,6.5,2720,9360
5e+05,2014,156,4,1,1720,4011,1,0,0,4,7,1720,0,1904,1904,98107,47.672,122.4,1580,3784,110,0,5,3300,5504
1.225e+06,2014,132,4,2.25,3070,16028,1,0,3,3,9,1870,1200,1976,1976,98040,47.527,122.23,3070,19822,38,0,6.25,6140,22892
5.05e+05,2014,129,3,2.5,2100,5824,2,0,2,3,8,2100,0,1999,1999,98065,47.533,121.87,1890,4140,15,0,5.5,3990,6240
6.86e+05,2014,206,4,2.25,2130,10650,2,0,0,4,8,2130,0,1977,1977,98006,47.557,122.16,3380,10050,37,0,6.25,5510,12180
5.62e+05,2015,472,2,2.25,1300,1314,3,0,0,3,8,1300,0,2008,2008,98103,47.654,122.36,1300,1312,7,0,4.25,2600,2612
2.36e+05,2014,300,4,2.5,1630,3060,2,0,0,3,7,1630,0,2003,2003,98146,47.507,122.34,1270,4590,11,0,6.5,2900,6220
6.9e+05,2014,215,4,2,1760,7800,1,0,0,3,8,1760,0,1954,1954,98117,47.694,122.38,1950,7800,60,0,6,3710,9560
2.0998e+05,2014,250,3,1,1170,6134,1,0,0,4,7,1170,0,1948,1948,98168,47.494,122.31,1440,9823,66,0,4,2610,10993
6.5e+05,2015,376,3,1.75,2800,19386,1,1,4,3,8,1400,1400,1965,1965,98198,47.355,122.32,3270,31450,50,0,4.75,6070,34250
8.2e+05,2014,287,3,2.5,2980,18935,1,0,0,3,11,2980,0,1990,1990,98077,47.713,122.08,3670,18225,24,0,5.5,6650,21205
2.35e+05,2015,377,3,1.75,1480,6592,1,0,0,4,7,1080,400,1978,1978,98023,47.298,122.38,1660,7150,37,0,4.75,3140,8630
5.9895e+05,2015,414,3,2.5,1480,1531,3,0,0,3,8,1480,0,2014,2014,98107,47.669,122.4,1530,1321,1,0,5.5,3010,2801
6.95e+05,2014,321,3,3.5,2630,4713,2,0,2,3,9,2030,600,2008,2008,98027,47.547,122.02,2450,4187,6,0,6.5,5080,6817
6e+05,2014,174,4,3.25,4690,14930,2,0,2,3,10,3680,1010,1995,1995,98155,47.772,122.28,2910,13320,19,0,7.25,7600,18010
3.83e+05,2014,222,4,2.5,2370,10580,2,0,0,3,8,2370,0,1966,1966,98055,47.464,122.19,1590,8584,48,0,6.5,3960,10954
3.99e+05,2015,463,4,1,1500,6388,1,0,0,4,7,1500,0,1951,1951,98126,47.53,122.38,980,5366,64,0,5,2480,6866
6.72e+05,2014,204,4,2.5,2440,10049,2,0,0,4,9,2440,0,1989,1989,98029,47.574,121.99,2820,8484,25,0,6.5,5260,10924
7.825e+05,2015,474,3,2.5,3750,7821,2,0,0,3,9,3750,0,2001,2001,98074,47.633,122.06,3210,8405,14,0,5.5,6960,12155
2.72e+05,2014,167,3,2,1380,7476,1,0,0,3,7,1380,0,1989,1989,98001,47.334,122.27,1600,7227,25,0,5,2980,8607
5.25e+05,2015,458,3,2.75,2130,1400,2,0,0,3,9,1080,1050,2010,2010,98118,47.566,122.29,1880,3132,5,0,5.75,4010,5262
9.98e+05,2014,243,4,2.5,3030,6820,2,0,0,3,9,2530,500,1947,2000,98105,47.669,122.27,2070,6820,67,1,6.5,5100,9850
1.999e+05,2014,314,1,1,720,7140,1,0,0,3,6,720,0,1930,1930,98146,47.512,122.34,1140,7577,84,0,2,1860,8297
3.1e+05,2014,290,3,1,1330,3740,1,0,0,3,6,1330,0,1903,1903,98118,47.55,122.27,1330,5053,111,0,4,2660,6383
4.25e+05,2014,251,3,2.5,1960,4709,2,0,0,3,7,1960,0,2003,2003,98065,47.532,121.87,1700,4444,11,0,5.5,3660,6404
4.15e+05,2014,273,3,1.75,2650,7500,1,0,0,4,7,1590,1060,1962,1962,98155,47.772,122.32,1340,7500,52,0,4.75,3990,10150
4.099e+05,2014,175,2,2.5,1590,1845,2,0,0,3,9,1590,0,1997,1997,98033,47.69,122.17,2320,3174,17,0,4.5,3910,4764
7.75e+05,2014,173,4,2.5,2300,6158,2,0,0,3,9,2300,0,1999,1999,98115,47.694,122.3,2170,6434,15,0,6.5,4470,8734
6.3e+05,2014,248,4,2.5,2540,4727,2,0,0,3,9,2540,0,1999,1999,98034,47.703,122.24,3640,5129,15,0,6.5,6180,7669
5.7e+05,2015,452,3,3.25,1550,1280,2,0,0,3,9,1220,330,2013,2013,98199,47.649,122.38,1550,1579,2,0,6.25,3100,3129
4e+05,2014,280,2,2,1520,5010,1,0,0,3,7,1520,0,1999,1999,98117,47.695,122.36,1110,5040,15,0,4,2630,6560
8.5517e+05,2015,425,4,2.5,2970,5050,2,0,0,3,8,2970,0,2014,2014,98052,47.704,122.12,2810,4998,1,0,6.5,5780,7968
9.6e+05,2015,392,4,2.5,3180,10105,2,0,0,4,9,3180,0,1986,1986,98040,47.533,122.23,2670,10355,29,0,6.5,5850,13535
4.8e+05,2014,136,4,2.5,2430,5000,2,0,0,3,7,2430,0,2009,2009,98065,47.515,121.87,2430,5441,5,0,6.5,4860,7871
3.59e+05,2015,390,3,2.25,1990,4331,2,0,0,3,7,1990,0,1997,1997,98056,47.492,122.17,1690,3688,18,0,5.25,3680,5678
9.41e+05,2014,174,4,1.75,2320,3825,1,0,0,5,8,1820,500,1926,1926,98105,47.666,122.33,1940,3825,88,0,5.75,4260,6145
3.56e+05,2015,480,4,2.5,2470,5074,2,0,0,3,8,2470,0,2004,2004,98038,47.346,122.04,2470,5078,11,0,6.5,4940,7548
4.299e+05,2014,304,4,3.25,3760,4675,2,0,0,3,8,2740,1020,2007,2007,98038,47.386,122.05,3280,4033,7,0,7.25,7040,7793
3.15e+05,2015,459,4,3,2210,4191,2,0,0,3,7,2210,0,2004,2004,98002,47.296,122.22,890,4288,11,0,7,3100,6498
3.15e+05,2014,160,4,2.5,1930,9643,2,0,0,4,7,1930,0,1992,1992,98031,47.407,122.18,1930,7525,22,0,6.5,3860,9455
3.9e+05,2015,473,4,2.5,1940,3864,2,0,0,3,8,1940,0,2003,2003,98058,47.451,122.12,1900,3864,12,0,6.5,3840,5804
3.71e+05,2014,154,3,1.5,1420,4500,1,0,0,3,7,1420,0,1959,1959,98103,47.694,122.33,1540,6375,55,0,4.5,2960,7795
4.47e+05,2015,401,3,1,1220,7200,1,0,0,4,7,1220,0,1965,1965,98008,47.622,122.12,1320,7200,50,0,4,2540,8420
4.15e+05,2014,290,3,1,1500,3399,2,0,0,5,7,1300,200,1926,1926,98103,47.684,122.35,1360,3588,88,0,4,2860,5088
3.43e+05,2014,334,2,1.5,1040,8526,1,0,0,5,6,1040,0,1953,1953,98155,47.735,122.3,1310,8504,61,0,3.5,2350,9544
7.9995e+05,2014,222,3,2.25,1860,1386,3,0,0,3,9,1860,0,2014,2014,98112,47.637,122.28,1680,3080,0,0,5.25,3540,4940
5.35e+05,2014,250,4,2.5,2200,1.1064e+05,1,0,0,5,7,1330,870,1979,1979,98077,47.741,122.05,2290,51400,35,0,6.5,4490,53600
5.9e+05,2014,163,4,2.5,2010,7972,2,0,0,4,8,2010,0,1989,1989,98029,47.578,122.02,2100,8511,25,0,6.5,4110,10521
2.85e+05,2015,430,4,2,2120,6865,1,0,0,3,7,1060,1060,1954,1954,98133,47.778,122.34,1460,7780,61,0,6,3580,9900
1.9995e+05,2014,221,1,1.5,1048,4800,1,0,0,3,7,1048,0,1942,1942,98055,47.476,122.21,950,4800,72,0,2.5,1998,5848
4.34e+05,2014,236,4,3,2010,8171,2,0,0,3,8,2010,0,1973,1973,98011,47.769,122.22,2090,8203,41,0,7,4100,10213
3.06e+05,2014,162,4,2.5,2490,8124,2,0,0,3,7,2490,0,2001,2001,98092,47.335,122.17,2760,6300,13,0,6.5,5250,8790
1.6e+05,2014,127,2,1,1040,13100,1,0,0,5,6,1040,0,1912,1912,98032,47.388,122.23,910,5080,102,0,3,1950,6120
5.65e+05,2015,432,4,2.5,2980,10459,2,0,0,3,9,2980,0,2001,2001,98019,47.735,121.97,2920,7700,14,0,6.5,5900,10680
5.5e+05,2014,218,3,1.75,1830,9720,1,0,1,3,7,1150,680,1928,1976,98040,47.551,122.23,3380,10854,86,1,4.75,5210,12684
4.85e+05,2014,284,4,1.75,3220,7392,1,0,0,4,8,2010,1210,1959,1959,98177,47.772,122.36,1660,8363,55,0,5.75,4880,11583
6.1495e+05,2014,258,3,1,1500,2400,1,0,0,5,7,1500,0,1900,1900,98119,47.633,122.36,1780,3600,114,0,4,3280,5100
6.5e+05,2015,459,3,2.5,1480,2159,3,0,0,3,8,1480,0,2007,2007,98103,47.653,122.34,1480,1554,8,0,5.5,2960,3034
4.6e+05,2014,205,4,2.5,2200,6400,2,0,0,3,8,2200,0,2010,2010,98059,47.486,122.16,2600,5870,4,0,6.5,4800,8070
3.13e+05,2014,317,3,1.5,1550,7260,1,0,0,2,6,1550,0,1925,1925,98166,47.469,122.35,1190,7620,89,0,4.5,2740,9170
6.15e+05,2015,443,5,3.25,3090,7069,2,0,0,3,9,3090,0,2012,2012,98056,47.511,122.2,2480,8000,3,0,8.25,5570,11090
4.35e+05,2014,223,6,3.5,2400,8620,2,0,0,3,8,1640,760,1987,1987,98034,47.715,122.16,1940,7350,27,0,9.5,4340,9750
2.05e+05,2015,381,4,1.5,1420,8063,1,0,0,3,7,940,480,1962,1962,98198,47.417,122.32,1330,7515,53,0,5.5,2750,8935
4.29e+05,2014,205,3,2.5,1430,9240,2,0,0,3,7,1430,0,1984,1984,98074,47.626,122.06,1480,8125,30,0,5.5,2910,9555
5e+05,2014,290,4,2.25,2080,8000,1,0,0,3,8,1390,690,1964,1964,98008,47.626,122.11,1800,7700,50,0,6.25,3880,9780
7.9999e+05,2014,211,4,2.75,3110,6050,2,0,0,3,9,3110,0,2014,2014,98052,47.705,122.13,3590,6054,0,0,6.75,6700,9164
4.04e+05,2014,143,4,3,4060,35621,1,0,0,3,9,2030,2030,1989,1989,98092,47.306,122.11,2950,35259,25,0,7,7010,39319
3.55e+05,2014,143,3,2,1220,1186,3,0,0,3,8,1220,0,2007,2007,98103,47.697,122.34,1280,1251,7,0,5,2500,2471
7.4e+05,2014,150,5,3.75,3990,18897,2,0,0,3,8,3090,900,1937,2010,98125,47.723,122.31,2080,9793,77,1,8.75,6070,13783
1.35e+05,2014,148,2,1,780,6685,1,0,0,4,5,780,0,1948,1948,98002,47.305,122.22,880,6695,66,0,3,1660,7475
4.65e+05,2014,312,3,2.25,2560,1.1718e+05,1,0,0,4,9,1280,1280,1977,1977,98027,47.465,122.03,2760,57063,37,0,5.25,5320,59623
7.15e+05,2015,394,4,2.5,2927,12171,2,0,0,3,10,2927,0,1998,1998,98075,47.595,121.98,2967,12166,17,0,6.5,5894,15093
6.3e+05,2014,290,4,2,1610,5000,2,0,0,5,7,1610,0,1946,1946,98117,47.678,122.4,1300,4950,68,0,6,2910,6560
6.75e+05,2014,211,3,2.25,1780,4252,2,0,0,4,8,1540,240,1989,1989,98144,47.6,122.29,2220,4000,25,0,5.25,4000,5780
3.1e+05,2014,217,3,1.5,1140,3104,2,0,0,3,7,1140,0,1988,1988,98029,47.571,122.02,1150,2981,26,0,4.5,2290,4121
5.35e+05,2014,168,3,2,2120,4080,2,0,0,3,7,2120,0,2003,2003,98053,47.682,122.04,2280,4080,11,0,5,4400,6200
8.52e+05,2014,232,5,2.75,1990,3750,1,0,0,4,7,1990,0,1913,1913,98107,47.673,122.36,1820,5000,101,0,7.75,3810,6990
3.89e+05,2015,486,6,4.5,3560,14010,2,0,0,3,7,3560,0,1989,1989,98002,47.324,122.22,1710,11116,26,0,10.5,5270,14676
1.95e+05,2015,452,4,1.75,1320,7694,1,0,0,3,7,1320,0,1928,1972,98148,47.43,122.33,1620,8468,87,1,5.75,2940,9788
2.2e+05,2014,266,4,2,1620,5200,1,0,0,4,7,1620,0,1978,1978,98042,47.363,122.09,1500,5200,36,0,6,3120,6820
6.8e+05,2015,430,3,2.5,1610,8064,1,0,2,4,7,1160,450,1981,1981,98033,47.682,122.19,2260,8328,34,0,5.5,3870,9938
4.24e+05,2014,279,3,1,1580,13912,1,0,0,4,8,1580,0,1955,1955,98155,47.755,122.28,2130,16420,59,0,4,3710,18000
2.735e+05,2015,367,3,1.5,2000,15265,1,0,0,3,8,1540,460,1967,1967,98032,47.387,122.28,1920,15265,48,0,4.5,3920,17265
3.5995e+05,2014,194,3,1,1400,4980,1,0,0,3,6,950,450,1943,1943,98133,47.704,122.34,990,4980,71,0,4,2390,6380
6e+05,2014,297,3,3.5,2710,3290,2,0,0,3,8,1650,1060,2006,2006,98027,47.537,122.07,2440,3290,8,0,6.5,5150,6000
1.99e+05,2015,449,3,1,1390,21262,1,0,0,3,7,1390,0,1958,1958,98058,47.445,122.19,1560,10800,57,0,4,2950,12190
5.8e+05,2015,433,2,1,860,4013,1,0,0,3,7,860,0,1925,1925,98103,47.665,122.34,1490,4013,90,0,3,2350,4873
1.43e+06,2014,299,5,4.25,3350,3600,2,0,0,3,10,2260,1090,2014,2014,98119,47.635,122.36,1810,3600,0,0,9.25,5160,6950
3.15e+05,2015,453,3,1.75,1860,9629,1,0,0,4,7,1240,620,1961,1961,98059,47.491,122.14,1940,9629,54,0,4.75,3800,11489
2.2e+05,2014,311,3,1.75,1290,8250,1,0,0,3,7,1290,0,1983,1983,98001,47.335,122.27,1410,7823,31,0,4.75,2700,9113
8.17e+05,2014,215,4,2.25,2600,10660,2,0,0,4,8,2600,0,1979,1979,98006,47.553,122.16,3150,10660,35,0,6.25,5750,13260
6.194e+05,2014,161,4,2,2090,3610,1,0,0,5,7,1790,300,1927,1927,98115,47.688,122.31,1660,3767,87,0,6,3750,5857
3.5e+05,2015,414,3,2.75,1650,5700,2,0,0,4,7,1650,0,1988,1988,98166,47.456,122.35,1320,7620,27,0,5.75,2970,9270
2.1e+05,2015,410,2,1,900,5000,1,0,0,5,6,900,0,1930,1990,98022,47.201,122,1150,5000,85,1,3,2050,5900
3.11e+05,2014,217,2,1,860,3300,1,0,0,5,6,860,0,1903,1903,98118,47.55,122.28,1380,4400,111,0,3,2240,5260
3.825e+05,2014,187,2,1,1190,4440,1,0,0,3,6,1190,0,1981,1981,98125,47.714,122.29,1060,5715,33,0,3,2250,6905
2e+05,2015,383,2,1,1010,7200,1,0,0,3,6,1010,0,1956,1956,98166,47.481,122.34,1290,9000,59,0,3,2300,10010
3.409e+05,2014,359,2,1,920,8612,1,0,0,5,7,920,0,1947,1947,98155,47.734,122.3,1500,7956,67,0,3,2420,8876
4.64e+05,2014,161,4,2.5,2180,7203,2,0,0,4,8,2180,0,1989,1989,98059,47.512,122.15,2350,7334,25,0,6.5,4530,9514
4.625e+05,2014,270,2,2,1690,4200,2,0,0,3,7,1690,0,1906,1906,98112,47.621,122.3,1540,4200,108,0,4,3230,5890
1.538e+06,2014,167,3,2.25,2880,7599,1,0,2,3,9,1710,1170,1958,2002,98033,47.694,122.22,2920,12401,56,1,5.25,5800,15281
1.99e+05,2014,194,3,1,1510,9100,1,0,0,3,7,1510,0,1966,1966,98003,47.333,122.32,1180,7220,48,0,4,2690,8730
3.3e+05,2014,172,4,2.5,2380,13550,2,0,0,3,7,2380,0,1999,1999,98188,47.449,122.29,1230,9450,15,0,6.5,3610,11830
6.4e+05,2014,310,3,1,1210,3720,2,0,0,4,8,1210,0,1930,1930,98112,47.632,122.3,1560,6000,84,0,4,2770,7210
2.42e+05,2014,215,3,1.75,1580,6099,1,0,0,5,7,790,790,1944,1944,98168,47.481,122.29,1330,6099,70,0,4.75,2910,7679
4.5e+05,2014,134,3,2.5,2910,17172,2,0,0,3,10,2910,0,1989,1989,98003,47.279,122.33,2910,20048,25,0,5.5,5820,22958
5.325e+05,2015,407,2,1,820,3000,1,0,0,4,7,820,0,1924,1924,98103,47.684,122.35,1490,3000,91,0,3,2310,3820
3.75e+05,2014,229,3,1,1230,9877,1,0,0,3,7,1230,0,1954,1954,98006,47.575,122.14,1240,9965,60,0,4,2470,11195
4.95e+05,2014,211,3,2,1340,2550,2,0,0,3,7,1340,0,1984,1984,98117,47.679,122.38,1370,5100,30,0,5,2710,6440
6.5e+05,2015,463,3,1,1520,10227,1,0,0,4,6,1520,0,1951,1951,98004,47.587,122.2,2710,10912,64,0,4,4230,12432
9.15e+05,2014,311,4,2.5,3510,28052,2,0,0,3,10,3510,0,1988,1988,98053,47.667,122.06,2890,28295,26,0,6.5,6400,31805
1.7995e+05,2014,307,3,1,960,10125,1,0,0,4,7,960,0,1952,1952,98003,47.334,122.31,1250,9769,62,0,4,2210,10729
2.55e+05,2015,430,2,1.75,1950,8200,1,0,0,3,8,1950,0,1975,1975,98023,47.316,122.38,2370,8000,40,0,3.75,4320,9950
4.2e+05,2014,170,5,3,2630,3149,2,0,0,3,8,1670,960,2013,2013,98056,47.507,122.17,2240,4825,1,0,8,4870,7455
2.35e+05,2014,173,3,1,1170,11100,1,0,0,4,6,1170,0,1968,1968,98059,47.495,122.16,2080,8481,46,0,4,3250,9651
3.08e+05,2014,272,3,1.75,1680,8629,1,0,0,3,8,1200,480,1977,1977,98198,47.366,122.32,1990,8400,37,0,4.75,3670,10080
3.725e+05,2014,223,4,2.25,1920,9660,1,0,0,4,8,1920,0,1968,1968,98058,47.454,122.14,1890,7800,46,0,6.25,3810,9720
5.1785e+05,2014,208,5,2.75,3050,7500,1,0,0,4,8,1800,1250,1966,1966,98034,47.725,122.19,2060,7848,48,0,7.75,5110,10898
1.34e+06,2014,201,4,3,2760,4905,2,0,1,4,9,1840,920,1938,1938,98105,47.659,122.27,3200,5424,76,0,7,5960,8184
6.85e+05,2015,426,5,2.5,1900,7843,2,0,0,5,7,1900,0,1966,1966,98008,47.627,122.12,1900,7350,49,0,7.5,3800,9250
5.8e+05,2014,167,5,2,2700,10875,1,0,0,4,7,1540,1160,1962,1962,98007,47.616,122.14,2040,7464,52,0,7,4740,10164
2.35e+05,2014,192,3,1.75,1420,7920,1,0,0,4,7,1420,0,1962,1962,98092,47.293,122.19,1420,7920,52,0,4.75,2840,9340
3.275e+05,2014,180,3,2.25,2310,7200,2,0,0,3,8,2310,0,1990,1990,98031,47.405,122.19,1960,7201,24,0,5.25,4270,9511
6e+05,2015,369,3,2.75,2080,16740,1,0,3,3,8,1580,500,1966,1966,98198,47.363,122.32,2175,7568,49,0,5.75,4255,9648
3.6e+05,2014,278,3,2,1970,79714,1,0,0,3,7,1070,900,1979,1979,98058,47.467,122.11,1890,36626,35,0,5,3860,38596
2.84e+05,2014,122,3,1.75,1800,23103,1,0,0,3,7,1800,0,1968,1968,98014,47.652,121.91,1410,18163,46,0,4.75,3210,19963
1.86e+05,2015,387,3,1.75,1460,7967,1,0,0,3,7,1040,420,1977,1977,98023,47.32,122.37,1460,6835,38,0,4.75,2920,8295
3.9995e+05,2015,430,3,2.5,2000,30605,2,0,0,4,8,2000,0,1989,1989,98042,47.344,122.06,1930,35350,26,0,5.5,3930,37350
5.419e+05,2015,470,3,2.5,1880,3054,2,0,0,3,8,1880,0,1988,1988,98007,47.609,122.15,1840,3815,27,0,5.5,3720,5695
2.45e+05,2015,466,2,1,1020,7679,1,0,0,5,6,1020,0,1942,1942,98056,47.492,122.19,1280,6497,73,0,3,2300,7517
5.462e+05,2014,297,3,2.5,2678,6607,2,0,0,3,9,2678,0,1998,1998,98028,47.738,122.23,2780,6607,16,0,5.5,5458,9285
3.28e+05,2014,187,3,2,2250,7904,1,0,0,3,8,2250,0,1998,1998,98001,47.316,122.25,2460,8622,16,0,5,4710,10872
5.05e+05,2014,190,2,1,1240,57000,1,0,0,3,7,1240,0,1962,1962,98075,47.597,122.06,3050,25545,52,0,3,4290,26785
1.1e+06,2014,197,4,3.25,3190,11774,2,1,4,3,8,2610,580,1956,1991,98178,47.503,122.22,2240,8725,58,1,7.25,5430,11915
5.5995e+05,2014,128,2,2,1870,4950,1,0,0,3,8,1870,0,2006,2006,98053,47.719,122.02,1670,4800,8,0,4,3540,6670
4.15e+05,2015,451,4,2.5,2544,4071,2,0,0,3,9,2544,0,2013,2013,98030,47.341,122.18,2358,4179,2,0,6.5,4902,6723
7.29e+05,2015,492,3,2.5,2440,4244,2,0,0,3,8,2440,0,2011,2011,98052,47.706,122.11,2690,4556,4,0,5.5,5130,6996
1.6295e+05,2014,191,2,1,950,2784,1,0,0,4,8,950,0,1972,1972,98198,47.379,122.32,1080,3899,42,0,3,2030,4849
2.1e+05,2014,332,3,2,1440,10111,1,0,0,3,7,1440,0,1963,1963,98001,47.345,122.28,1580,10200,51,0,5,3020,11640
4.95e+05,2015,383,4,2.5,2370,15336,2,0,0,3,8,2370,0,1995,1995,98024,47.563,121.9,2110,15925,20,0,6.5,4480,18295
2.258e+05,2015,451,4,1,1100,7110,1,0,0,4,7,880,220,1907,1907,98030,47.386,122.23,1150,7110,108,0,5,2250,8210
9.5299e+05,2015,383,4,2.75,3550,6558,2,0,0,3,9,3550,0,2013,2013,98052,47.708,122.11,3140,5617,2,0,6.75,6690,9167
5.7e+05,2015,374,3,2.75,2730,11936,2,0,2,3,8,1530,1200,1978,1978,98034,47.699,122.23,2810,12333,37,0,5.75,5540,15063
3.25e+05,2014,217,4,1.5,1870,7220,2,0,0,3,7,1870,0,1956,1956,98155,47.77,122.32,1550,7592,58,0,5.5,3420,9462
2.8e+05,2014,264,3,1,1720,9605,1,0,0,3,7,860,860,1969,1969,98028,47.744,122.24,1720,9998,45,0,4,3440,11718
4.0643e+05,2014,244,3,2,1380,15426,1,0,0,4,7,1380,0,1968,1968,98075,47.595,122.04,1380,15426,46,0,5,2760,16806
1.6e+05,2014,360,4,1,1540,7350,1,0,0,4,6,770,770,1969,1969,98023,47.332,122.34,910,8000,45,0,5,2450,9540
2.93e+05,2015,432,2,2.25,1610,1968,2,0,0,4,7,1610,0,1979,1979,98056,47.518,122.2,1950,1968,36,0,4.25,3560,3578
90000,2015,423,1,1,780,4000,1,0,0,3,5,780,0,1905,1905,98108,47.542,122.32,1150,4000,110,0,2,1930,4780
2.375e+05,2014,248,2,1,810,8494,1,0,0,3,6,810,0,1949,1949,98155,47.739,122.32,1050,7975,65,0,3,1860,8785
7.63e+05,2015,477,4,1.75,1850,4388,2,0,0,5,8,1850,0,1941,1941,98117,47.688,122.38,1410,4107,74,0,5.75,3260,5957
3.3e+05,2014,307,4,1.5,2500,9448,1,0,0,4,7,1250,1250,1966,1966,98106,47.521,122.34,1640,9490,48,0,5.5,4140,11990
3.5e+05,2014,360,3,1,1920,6710,1,0,0,3,7,1320,600,1959,1959,98118,47.535,122.29,1810,5600,55,0,4,3730,7520
3.3e+05,2014,353,4,2.25,2380,1.2204e+05,2,0,0,4,8,2380,0,1984,1984,98022,47.262,122.02,2030,48000,30,0,6.25,4410,50380
1.21e+06,2014,148,4,2.75,3650,6982,2,0,2,4,9,2530,1120,1951,2003,98115,47.676,122.28,3140,7894,63,1,6.75,6790,11544
6.075e+05,2014,214,4,2.5,3000,8100,2,0,0,3,8,3000,0,1992,1992,98125,47.715,122.31,1550,8100,22,0,6.5,4550,11100
5.7e+05,2014,180,3,2,1890,29185,1,0,0,3,7,1470,420,1949,2013,98006,47.562,122.17,2580,11600,65,1,5,4470,13490
4.15e+05,2014,324,3,1,1570,11752,1,0,0,5,8,1570,0,1930,1930,98133,47.769,122.35,2010,8291,84,0,4,3580,9861
8.1e+05,2014,286,4,1,2150,3588,2,0,3,4,8,1850,300,1926,1926,98126,47.577,122.38,1950,3588,88,0,5,4100,5738
2.499e+05,2014,320,3,1.75,1380,14000,1,0,0,4,5,1380,0,1939,1957,98001,47.294,122.28,1490,18503,75,1,4.75,2870,19883
4.761e+05,2014,273,4,2.5,1850,1836,2,0,0,3,7,1600,250,2005,2005,98029,47.553,122,1770,2236,9,0,6.5,3620,4086
5.19e+05,2014,175,4,2.5,1950,2617,1,0,0,4,7,1250,700,1910,1910,98107,47.67,122.37,1520,1438,104,0,6.5,3470,3388
1.95e+05,2014,260,3,1.5,1050,5525,1,0,0,5,6,1050,0,1969,1969,98042,47.361,122.08,1100,5200,45,0,4.5,2150,6250
2.7e+06,2014,141,5,4.75,5305,8401,2,0,2,3,11,3745,1560,2005,2005,98033,47.686,122.22,2960,7200,9,0,9.75,8265,12505
4e+05,2014,135,3,1,1630,10304,1,0,0,5,7,1630,0,1953,1953,98155,47.755,122.32,1480,8515,61,0,4,3110,10145
4.39e+05,2014,279,4,2.25,2240,8300,2,0,0,3,8,2240,0,1978,1978,98011,47.775,122.2,2340,8500,36,0,6.25,4580,10740
5.599e+05,2014,152,3,2.75,2930,5569,1,0,0,3,9,1860,1070,2004,2004,98072,47.765,122.16,2580,11045,10,0,5.75,5510,13975
7.25e+05,2015,407,3,1.75,1920,3300,1,0,0,4,8,960,960,1913,1913,98112,47.624,122.3,1740,4000,102,0,4.75,3660,5920
4.33e+05,2014,160,3,1.75,1870,7189,1,0,0,3,7,1270,600,1959,1959,98118,47.541,122.27,1780,6200,55,0,4.75,3650,8070
9.15e+05,2014,222,4,2.5,3210,8532,2,0,0,3,10,3210,0,1998,1998,98007,47.625,122.14,2950,6753,16,0,6.5,6160,9963
3.705e+05,2014,222,4,2.5,1790,6120,2,0,0,3,7,1790,0,2005,2005,98059,47.483,122.13,1950,5660,9,0,6.5,3740,7450
1.118e+06,2014,208,4,2.5,3840,16619,2,0,1,4,10,3840,0,1983,1983,98040,47.563,122.21,3600,16553,31,0,6.5,7440,20393
4.27e+05,2015,474,4,1.75,1460,9750,1,0,0,4,7,1460,0,1967,1967,98008,47.62,122.1,1820,9840,48,0,5.75,3280,11300
4.12e+05,2014,191,4,1.75,1430,10500,1,0,0,4,7,1130,300,1960,1960,98007,47.608,122.13,2070,8640,54,0,5.75,3500,10070
1e+06,2014,214,5,2.5,4670,15857,2,0,0,3,11,4670,0,1998,1998,98074,47.63,122.01,3810,14824,16,0,7.5,8480,19494
6.1e+05,2014,306,4,1,1390,3708,1,0,0,4,7,1390,0,1926,1926,98117,47.685,122.36,1430,3708,88,0,5,2820,5098
2.85e+05,2015,415,4,1.75,2130,8151,1,0,0,4,7,1330,800,1967,1967,98031,47.393,122.2,1600,8587,48,0,5.75,3730,10717
4.5e+05,2014,217,4,2.5,2500,36254,1,0,0,4,8,1590,910,1978,1978,98027,47.468,122,2360,36254,36,0,6.5,4860,38754
3e+05,2014,127,2,1,760,3001,1,0,0,3,6,760,0,1913,1913,98144,47.587,122.31,1750,5000,101,0,3,2510,5760
3.9e+05,2014,295,3,2.5,1610,10292,1,0,0,4,7,1190,420,1969,1969,98056,47.535,122.17,1940,8700,45,0,5.5,3550,10310
3.325e+05,2015,372,4,2.5,2220,4720,2,0,0,3,7,2220,0,1998,1998,98038,47.354,122.02,2090,4717,17,0,6.5,4310,6937
3.9495e+05,2015,477,3,2.5,2050,8172,2,0,0,3,8,2050,0,2002,2002,98168,47.481,122.28,2140,5664,13,0,5.5,4190,7714
3.85e+05,2015,463,3,2,1010,7380,1,0,0,3,7,1010,0,1982,1982,98074,47.627,122.06,1650,9030,33,0,5,2660,10040
3.55e+05,2014,170,2,1,1240,27042,1,0,1,3,6,1000,240,1943,1943,98070,47.503,122.47,2140,20059,71,0,3,3380,21299
7.82e+05,2015,383,4,2.5,3510,24604,2,0,0,3,10,3510,0,1997,1997,98053,47.677,122.06,3530,26673,18,0,6.5,7040,30183
3.45e+05,2014,229,4,2.5,2382,5899,2,0,0,3,8,2382,0,2011,2011,98003,47.279,122.3,2382,5897,3,0,6.5,4764,8279
2.472e+05,2014,291,3,1.5,1910,10583,1,0,0,4,7,1910,0,1922,1967,98002,47.278,122.21,1770,9068,92,1,4.5,3680,10978
1.636e+06,2014,187,3,2.5,3110,6765,2,0,1,4,9,2550,560,1946,1946,98115,47.689,122.28,2630,7626,68,0,5.5,5740,10736
4.45e+05,2015,432,3,2,1540,67953,1,0,0,3,7,1540,0,1997,1997,98059,47.502,122.13,1250,9100,18,0,5,2790,10640
6.23e+05,2015,470,4,2.5,2710,49044,2,0,0,3,9,2710,0,1988,1988,98077,47.774,122.08,2560,38190,27,0,6.5,5270,40900
4.4e+05,2014,167,4,2,1450,8400,1,0,0,4,7,1450,0,1962,1962,98034,47.728,122.24,1450,7440,52,0,6,2900,8890
2.85e+05,2014,163,3,1.75,1840,8601,1,0,0,3,7,920,920,1905,2014,98118,47.536,122.28,1390,7452,109,1,4.75,3230,9292
4.275e+05,2014,298,4,2.5,3160,8726,2,0,0,3,9,3160,0,1999,1999,98092,47.258,122.22,2500,8648,15,0,6.5,5660,11808
5.91e+05,2014,133,3,1.75,1680,2400,1,0,0,5,7,870,810,1922,1922,98122,47.615,122.3,1440,3600,92,0,4.75,3120,5280
3.845e+05,2014,214,3,2.5,1600,2610,2,0,0,3,8,1600,0,2005,2005,98027,47.534,122.07,1445,1288,9,0,5.5,3045,2888
3.5995e+05,2014,231,2,1,1240,7590,1,0,0,4,7,1040,200,1939,1939,98133,47.706,122.34,1190,5692,75,0,3,2430,6932
5e+05,2015,414,3,2.25,2210,7680,1,0,2,3,8,1730,480,1972,1972,98177,47.773,122.39,2390,7680,43,0,5.25,4600,9890
3.02e+05,2014,132,5,2.25,2180,7813,2,0,0,3,7,2180,0,1986,1986,98038,47.365,122.05,1880,8649,28,0,7.25,4060,10829
2.37e+05,2014,222,3,2,1210,6634,1,0,0,4,7,1210,0,1985,1985,98031,47.41,122.19,1560,7200,29,0,5,2770,8410
3.4e+05,2014,210,4,2.5,2160,5455,2,0,0,3,7,2160,0,2003,2003,98056,47.48,122.18,2160,5257,11,0,6.5,4320,7417
4.5e+05,2015,447,3,1,1160,36831,1,0,0,3,7,1160,0,1938,1938,98028,47.751,122.24,1800,15640,77,0,4,2960,16800
5.4e+05,2014,317,3,1.75,1610,3478,1,0,0,4,7,1060,550,1929,1929,98117,47.677,122.37,1610,3478,85,0,4.75,3220,5088
1.015e+06,2014,314,3,3.5,2880,11340,1,0,0,3,8,1690,1190,1980,2013,98074,47.611,122.06,2530,11340,34,1,6.5,5410,14220
3.8995e+05,2014,191,4,2.5,2240,5500,2,0,0,3,8,2240,0,2013,2013,98056,47.496,122.17,700,5500,1,0,6.5,2940,7740
8.25e+05,2015,444,4,2.75,2220,11925,1,0,0,3,7,1560,660,1953,1985,98004,47.638,122.2,2500,11377,62,1,6.75,4720,13597
1.88e+05,2015,387,2,1.5,1120,17487,1,0,0,3,6,1120,0,1924,1924,98178,47.502,122.27,1690,8056,91,0,3.5,2810,9176
3.56e+05,2014,259,3,1,920,3863,1,0,0,3,6,920,0,1970,1970,98118,47.552,122.27,1080,5150,44,0,4,2000,6070
4.9995e+05,2014,148,4,2.5,2798,4473,2,0,0,3,9,2798,0,2012,2012,98055,47.429,122.2,2358,4593,2,0,6.5,5156,7391
6e+05,2014,338,3,2.5,2680,43995,2,0,0,3,9,2680,0,1986,1986,98077,47.766,122.09,2520,37277,28,0,5.5,5200,39957
9.5e+05,2014,324,5,2,2940,5500,2,0,0,4,9,2340,600,1909,1909,98102,47.647,122.32,2940,5500,105,0,7,5880,8440
7.8e+05,2014,286,3,2,2610,6000,1,0,0,5,7,1310,1300,1941,1941,98115,47.675,122.29,2330,4800,73,0,5,4940,7410
1.45e+05,2014,149,3,1,1010,5490,1,0,0,3,6,1010,0,1954,1954,98168,47.476,122.29,1740,10658,60,0,4,2750,11668
5.925e+05,2014,339,3,2,1170,6750,1,0,0,5,7,800,370,1947,1947,98115,47.675,122.28,1330,6750,67,0,5,2500,7920
9.1e+05,2014,176,4,3.5,4040,50479,2,0,0,3,11,4040,0,1987,1987,98077,47.72,122.05,3770,40899,27,0,7.5,7810,44939
2.89e+05,2015,477,2,1,710,6300,1,0,0,3,6,710,0,1942,1942,98126,47.516,122.37,740,6300,73,0,3,1450,7010
4.5e+05,2014,252,4,2.5,3236,9608,2,0,0,3,10,3236,0,2005,2005,98030,47.384,122.19,3236,9660,9,0,6.5,6472,12896
7.05e+05,2014,326,3,3,1970,20978,2,1,3,4,9,1770,200,1980,1980,98070,47.384,122.44,2280,75396,34,0,6,4250,77366
5.3e+05,2014,224,3,2.5,3150,21893,2,0,0,3,9,3150,0,2006,2006,98014,47.645,121.9,2280,21886,8,0,5.5,5430,25036
3.5495e+05,2015,444,3,1,970,5922,1,0,0,3,7,970,0,1949,1949,98125,47.719,122.32,1730,6128,66,0,4,2700,7098
6.12e+05,2014,326,3,3,2330,10327,1,0,0,3,9,2330,0,1998,1998,98034,47.724,122.16,2200,4629,16,0,6,4530,6959
5.85e+05,2015,422,4,1.75,2500,7000,1,0,0,3,7,1250,1250,1947,1947,98199,47.648,122.39,1680,7000,68,0,5.75,4180,9500
4.45e+05,2014,211,3,1.75,1120,4000,1,0,0,4,7,870,250,1916,1916,98107,47.668,122.37,1470,4000,98,0,4.75,2590,5120
5.85e+05,2015,485,4,1.75,2430,7559,1,0,0,4,8,1580,850,1981,1981,98052,47.721,122.11,1980,8750,34,0,5.75,4410,11180
5.7e+05,2015,487,3,1,1030,4089,1,0,0,3,7,1030,0,1927,1927,98116,47.574,122.39,1440,4917,88,0,4,2470,5947
2.4e+06,2014,129,3,2.25,3000,11665,1,1,4,3,11,3000,0,2001,2001,98075,47.588,122.09,3000,15959,13,0,5.25,6000,18959
4.55e+05,2015,415,5,2,1510,3000,2,0,0,3,6,1510,0,1983,1983,98122,47.603,122.3,1610,3600,32,0,7,3120,5110
5.9e+05,2014,209,3,2.5,2110,3870,2,0,0,3,9,2110,0,2004,2004,98029,47.551,121.99,2300,3870,10,0,5.5,4410,5980
7e+05,2014,155,3,2.5,2050,4185,2,0,0,3,9,2050,0,2011,2011,98117,47.692,122.37,1150,5000,3,0,5.5,3200,7050
4.8e+05,2014,263,3,2.25,1820,13362,1,0,0,3,8,1220,600,1977,1977,98075,47.59,122.05,2050,15000,37,0,5.25,3870,16820
4.375e+05,2014,333,2,1,990,3120,1,0,2,5,7,790,200,1907,1907,98103,47.68,122.35,1930,3120,107,0,3,2920,4110
6e+05,2014,310,4,3.5,4300,70407,2,0,0,3,10,2710,1590,1992,1992,98058,47.447,122.09,3520,26727,22,0,7.5,7820,31027
3.98e+05,2014,159,3,2.5,1720,1715,2,0,0,3,7,1240,480,2004,2004,98136,47.548,122.38,1610,1626,10,0,5.5,3330,3346
6.35e+05,2015,399,4,2.5,2500,4000,2,0,0,3,8,2500,0,2014,2014,98144,47.59,122.31,1480,4300,1,0,6.5,3980,6800
4e+05,2014,134,2,1,980,2130,1,0,0,4,6,860,120,1918,1918,98117,47.677,122.37,980,2800,96,0,3,1960,3780
6.2e+05,2014,155,4,2.25,2400,5350,1,0,0,4,7,1460,940,1929,1929,98117,47.676,122.37,1250,4880,85,0,6.25,3650,7280
3.15e+05,2015,402,4,2,1210,4250,1,0,0,4,7,1210,0,1941,1941,98108,47.528,122.32,1210,6000,74,0,6,2420,7210
3.5e+05,2015,386,3,2.5,2040,13590,2,0,0,3,8,2040,0,2009,2009,98042,47.312,122.04,1850,12485,6,0,5.5,3890,14525
7.11e+05,2014,195,4,2.5,2770,9532,2,0,0,4,9,2770,0,1988,1988,98029,47.569,122.01,2770,9219,26,0,6.5,5540,11989
2.289e+05,2014,347,4,1.5,1570,8775,1,0,0,3,7,1570,0,1943,1943,98166,47.479,122.33,980,8775,71,0,5.5,2550,10345
2.5e+05,2014,136,3,2,1900,6660,1,0,0,5,7,950,950,1966,1966,98038,47.359,122.05,1690,8111,48,0,5,3590,10011
4.1e+05,2014,132,3,2.25,2200,16921,2,0,0,3,8,2200,0,1987,1987,98038,47.373,122.05,2060,16921,27,0,5.25,4260,19121
2.26e+05,2015,424,2,1,1510,19874,1,0,0,3,7,1510,0,1951,1951,98146,47.492,122.34,1540,10000,64,0,3,3050,11510
6.9e+05,2014,192,4,2.5,2900,23488,2,0,0,3,9,2900,0,1992,1992,98053,47.673,122.03,2900,34589,22,0,6.5,5800,37489
5.1e+05,2014,202,6,4.5,3300,7561,2,0,0,3,8,3300,0,1980,1980,98052,47.679,122.1,2470,7561,34,0,10.5,5770,10861
2.3e+05,2014,208,3,0.75,1040,15000,1,0,0,3,6,1040,0,1941,1941,98028,47.764,122.23,1410,19000,73,0,3.75,2450,20040
1.028e+06,2015,443,3,3,2800,5800,1,0,0,3,9,1580,1220,1953,2010,98199,47.649,122.41,2580,5800,62,1,6,5380,8600
3.79e+05,2015,439,3,1,1140,10320,1,0,0,4,7,1140,0,1963,1963,98034,47.717,122.2,1140,10412,52,0,4,2280,11552
2.9995e+05,2014,150,3,1,1210,9525,1,0,0,3,7,1210,0,1955,1955,98106,47.527,122.34,1680,7620,59,0,4,2890,8830
5.6325e+05,2015,383,3,1.75,1370,2800,1,0,0,5,7,800,570,1982,1982,98122,47.616,122.29,2270,3773,33,0,4.75,3640,5143
1.568e+06,2015,362,3,2.75,2340,8828,1,0,0,4,9,2340,0,1954,1954,98112,47.632,122.29,3480,8526,61,0,5.75,5820,10866
4.967e+05,2014,144,3,2.5,1740,5782,2,0,0,4,8,1740,0,1989,1989,98029,47.578,122,2080,5782,25,0,5.5,3820,7522
6.64e+05,2015,436,4,2.75,2510,11880,1,0,0,5,8,1630,880,1978,1978,98006,47.543,122.18,2390,11211,37,0,6.75,4900,13721
3.98e+05,2014,293,5,2.5,3004,5700,2,0,0,3,9,3004,0,2006,2006,98030,47.38,122.19,2665,5700,8,0,7.5,5669,8704
8.95e+05,2014,216,3,2.5,2500,7746,2,0,0,4,10,1910,590,1993,1993,98112,47.639,122.31,2480,5099,21,0,5.5,4980,7599
2.244e+05,2014,223,3,1.75,1070,7200,1,0,0,3,7,1070,0,1994,1994,98010,47.313,122.02,1280,7200,20,0,4.75,2350,8270
1.8028e+06,2015,451,5,3.25,3890,20005,1,0,0,3,10,2260,1630,1977,1977,98004,47.631,122.22,3450,20176,38,0,8.25,7340,24066
4.03e+05,2015,438,3,1,1400,6879,1,0,0,3,7,1400,0,1951,1951,98155,47.751,122.29,1950,7400,64,0,4,3350,8800
4.35e+05,2015,376,4,2.5,2650,9065,2,0,0,3,7,2650,0,2000,2000,98019,47.726,121.96,2590,13218,15,0,6.5,5240,15868
5.65e+05,2015,415,3,1.75,1490,5000,1,0,1,3,8,1250,240,1954,1954,98136,47.526,122.39,1980,5000,61,0,4.75,3470,6490
1.595e+06,2014,257,4,2.5,2980,13341,1,1,4,5,8,1800,1180,1928,1928,98034,47.704,122.25,2340,19810,86,0,6.5,5320,22790
5.65e+05,2014,346,3,2,2290,9450,1,0,0,3,9,1670,620,1979,1979,98008,47.569,122.1,2750,11700,35,0,5,5040,13990
3.43e+05,2014,265,3,1,1400,5662,1,0,0,5,5,1400,0,1920,1920,98027,47.527,122.04,1250,14375,94,0,4,2650,15775
7.59e+05,2014,300,3,2,2260,7200,1,0,3,3,7,1130,1130,1941,1941,98144,47.589,122.29,2260,6000,73,0,5,4520,8260
6.95e+05,2014,197,3,1.75,2080,5687,1,0,0,4,8,2080,0,1924,1924,98144,47.578,122.29,2300,5995,90,0,4.75,4380,8075
7.3e+05,2015,485,5,3,2500,11779,1,0,0,4,8,1550,950,1971,1971,98006,47.57,122.13,2580,12055,44,0,8,5080,14555
4.75e+05,2014,279,5,2.5,2340,7200,1,0,0,3,7,1300,1040,1975,1975,98034,47.721,122.21,1930,7221,39,0,7.5,4270,9561
4.75e+05,2015,486,2,1.5,1170,1250,3,0,0,3,8,1170,0,2000,2000,98107,47.672,122.38,1310,1308,15,0,3.5,2480,2478
3.595e+05,2014,280,4,1.75,2030,7210,1,0,0,3,7,1450,580,1968,1968,98059,47.507,122.16,1750,8387,46,0,5.75,3780,10417
2.6e+05,2015,410,3,2.25,1489,2800,2,0,0,3,7,1489,0,2011,2011,98002,47.345,122.22,1584,3200,4,0,5.25,3073,4689
5.9e+05,2015,443,3,2.5,2830,5788,2,0,0,3,9,2830,0,2001,2001,98028,47.76,122.23,2500,5802,14,0,5.5,5330,8632
2.84e+05,2014,313,2,1,860,7204,1,0,0,3,7,860,0,1918,1918,98106,47.536,122.35,1200,7500,96,0,3,2060,8360
2.645e+05,2015,383,3,1.75,1650,16200,1,0,0,3,7,1650,0,1976,1976,98031,47.393,122.17,1650,8680,39,0,4.75,3300,10330
90000,2014,143,2,1,580,7500,1,0,0,3,5,580,0,1943,1943,98178,47.485,122.25,1700,11250,71,0,3,2280,11830
1.25e+06,2014,334,5,2.75,3710,13874,1,0,3,4,9,2340,1370,1977,1977,98006,47.569,122.15,3370,13874,37,0,7.75,7080,17584
7.35e+05,2015,415,3,1.75,1880,1.089e+05,1,0,0,3,7,1880,0,1978,1978,98075,47.591,122.01,2730,37731,37,0,4.75,4610,39611
4.59e+05,2015,452,4,2,2360,7080,1,0,0,5,6,1180,1180,1925,1925,98126,47.526,122.38,1340,7200,90,0,6,3700,9560
4.81e+05,2014,243,2,2.25,1290,1137,3,0,0,3,8,1290,0,2007,2007,98107,47.672,122.38,1290,1332,7,0,4.25,2580,2622
4.5e+05,2015,488,2,2,1730,4248,2,0,0,3,7,1730,0,1905,1905,98144,47.593,122.31,1380,4000,110,0,4,3110,5730
5.82e+05,2014,263,4,3,1670,1189,3,0,0,3,8,1427,243,2000,2000,98122,47.618,122.3,1700,1401,14,0,7,3370,3071
6.2e+05,2014,159,3,2.5,2590,7237,2,0,0,3,8,2590,0,2004,2004,98125,47.711,122.31,1670,7648,10,0,5.5,4260,10238
2.03e+05,2015,375,3,1.75,1610,9000,1,0,0,4,7,1100,510,1978,1978,98092,47.319,122.18,1610,8000,37,0,4.75,3220,9610
3.42e+05,2014,299,3,3,1260,1634,3,0,0,3,8,1260,0,1998,1998,98103,47.697,122.35,1260,1135,16,0,6,2520,2395
5.85e+05,2014,342,4,2.5,2430,6766,2,0,0,3,8,2430,0,1999,1999,98177,47.729,122.36,1820,6772,15,0,6.5,4250,9202
3.425e+05,2014,162,3,2,2080,11375,1,0,0,3,8,2080,0,2002,2002,98022,47.214,121.99,1080,12899,12,0,5,3160,14979
7e+05,2014,310,3,1.75,2100,5000,1,0,0,3,8,2100,0,1916,1916,98117,47.678,122.36,1830,4200,98,0,4.75,3930,6300
4.958e+05,2014,339,4,1.5,1710,4600,1,0,0,3,7,1710,0,1924,1924,98115,47.685,122.32,1740,4455,90,0,5.5,3450,6165
5.1e+05,2015,437,2,1,810,6480,1,0,0,5,6,810,0,1942,1942,98199,47.649,122.4,1920,6000,73,0,3,2730,6810
9.95e+05,2014,175,3,4.5,4380,47044,2,1,3,3,9,3720,660,1968,1990,98166,47.473,122.36,2460,18512,46,1,7.5,6840,22892
3.5e+05,2014,217,3,1,1390,4820,1,0,0,4,7,910,480,1926,1926,98133,47.704,122.34,1320,4820,88,0,4,2710,6210
4.38e+05,2014,147,3,1.75,1650,12940,1,0,0,4,7,1650,0,1961,1961,98028,47.763,122.27,2830,12600,53,0,4.75,4480,14250
4.35e+05,2015,439,4,2.25,1780,2684,2,0,0,3,7,1780,0,2002,2002,98072,47.764,122.15,1670,2426,13,0,6.25,3450,4206
5.4e+05,2014,258,3,2.5,1720,11656,2,0,0,3,8,1720,0,1987,1999,98052,47.679,122.11,1890,10336,27,1,5.5,3610,12056
5.42e+05,2015,430,2,2.25,1800,2819,2,0,2,4,9,1800,0,1979,1979,98008,47.61,122.11,1800,2755,36,0,4.25,3600,4555
4.325e+05,2014,152,3,2.5,2240,6396,2,0,0,3,7,2240,0,2002,2002,98065,47.536,121.88,2610,5128,12,0,5.5,4850,7368
5.37e+05,2015,380,4,1.75,1580,3635,1,0,0,4,7,790,790,1910,1910,98117,47.679,122.37,1190,3638,105,0,5.75,2770,5218
5.15e+05,2014,209,3,1.75,1570,10939,1,0,0,3,8,1200,370,1974,1974,98052,47.639,122.1,1760,10200,40,0,4.75,3330,11770
2.825e+05,2015,366,4,1,1170,34925,1,0,0,4,6,1170,0,1942,1942,98065,47.531,121.84,1610,28108,73,0,5,2780,29278
3.925e+05,2015,463,3,1,1100,7650,1,0,0,3,7,1100,0,1952,1952,98133,47.722,122.35,1430,7650,63,0,4,2530,8750
2.599e+05,2014,230,4,2.75,1560,8820,1,0,3,3,7,1060,500,1979,1979,98001,47.338,122.26,2140,7800,35,0,6.75,3700,9360
2.72e+05,2015,366,4,1.75,2520,10890,1,0,0,3,7,1260,1260,1979,1979,98023,47.322,122.34,2090,12375,36,0,5.75,4610,14895
4.999e+05,2015,425,3,2.5,2100,5112,2,0,0,3,8,2100,0,1999,1999,98065,47.534,121.87,2100,4370,16,0,5.5,4200,6470
2.08e+05,2014,338,2,1,960,13438,1,0,0,3,7,960,0,1951,1951,98168,47.474,122.3,1630,11656,63,0,3,2590,12616
4e+05,2014,222,4,1.75,1810,9750,2,0,0,4,7,1810,0,1977,1977,98155,47.768,122.31,1570,10000,37,0,5.75,3380,11810
4.25e+05,2014,314,2,1,1670,6212,1,0,0,4,7,1670,0,1947,1947,98125,47.715,122.28,1670,7272,67,0,3,3340,8942
4.52e+05,2014,141,4,2,1660,6150,1,0,0,3,6,850,810,1945,1945,98126,47.537,122.37,1110,6250,69,0,6,2770,7910
7.17e+05,2014,133,3,1.5,1310,3880,1,0,0,3,7,1090,220,1956,1956,98117,47.682,122.39,1570,3880,58,0,4.5,2880,5190
5.4e+05,2014,168,3,1.75,1970,8200,1,0,0,5,8,1420,550,1963,1963,98177,47.76,122.36,2140,8000,51,0,4.75,4110,9970
1.58e+05,2015,484,3,1,1140,10477,1,0,0,3,6,1140,0,1942,1942,98168,47.487,122.31,1190,9750,73,0,4,2330,10890
2.19e+05,2014,126,2,1,900,5160,1,0,0,3,6,900,0,1952,1952,98106,47.525,122.36,900,5160,62,0,3,1800,6060
1.87e+05,2014,225,2,1.75,1050,2926,1,0,0,4,8,1050,0,1974,1974,98198,47.381,122.32,1150,3802,40,0,3.75,2200,4852
4.9e+05,2014,250,3,1.75,1510,11120,1,0,0,4,8,1510,0,1984,1984,98005,47.593,122.16,2660,10800,30,0,4.75,4170,12310
6.89e+05,2014,174,3,1.75,2200,9840,1,0,0,5,8,1500,700,1978,1978,98006,47.559,122.14,2410,9623,36,0,4.75,4610,11823
2.55e+05,2014,198,3,2,1590,8670,1,0,0,3,7,1590,0,1994,1994,98042,47.373,122.07,1590,9253,20,0,5,3180,10843
7.38e+05,2014,333,3,1.75,1520,5500,1,0,0,5,7,1520,0,1936,1936,98116,47.584,122.38,2310,5500,78,0,4.75,3830,7020
4.25e+05,2014,269,2,2.5,1320,1329,2,0,0,3,8,1180,140,2007,2007,98107,47.673,122.37,1490,5000,7,0,4.5,2810,6320
6.53e+05,2015,478,3,2.25,2800,17300,1,0,0,4,8,1420,1380,1971,1971,98006,47.572,122.13,2140,12650,44,0,5.25,4940,15450
4.75e+05,2015,425,3,3,2540,18900,1,0,0,3,7,1580,960,1978,1978,98072,47.754,122.14,2270,16000,37,0,6,4810,18540
6.45e+05,2014,196,3,1.75,2340,6750,1,0,0,5,7,1620,720,1914,1914,98103,47.696,122.33,1410,3388,100,0,4.75,3750,5728
3.1e+05,2014,341,3,1.75,1880,30346,1,0,0,3,8,1880,0,1988,1988,98001,47.352,122.29,2260,5883,26,0,4.75,4140,7763
4.1e+05,2014,203,3,2.25,1790,5794,1,0,0,3,7,1380,410,1985,1985,98072,47.748,122.17,2140,7769,29,0,5.25,3930,9559
5.75e+05,2014,248,3,1.75,1890,11141,1,0,0,4,8,1890,0,1968,1968,98006,47.57,122.16,2720,11144,46,0,4.75,4610,13034
3e+05,2014,341,3,2.25,2000,7560,1,0,0,3,7,1400,600,1979,1979,98055,47.48,122.23,2040,6949,35,0,5.25,4040,8949
8.25e+05,2014,264,4,1,2290,6300,1,0,4,4,7,2150,140,1921,1921,98144,47.592,122.29,2390,6300,93,0,5,4680,8590
3.4e+05,2014,205,3,2.5,2270,7917,2,0,0,3,8,2270,0,1986,1986,98092,47.264,122.22,2160,7917,28,0,5.5,4430,10187
2.3e+05,2014,178,2,1.75,1910,3376,2,0,0,3,8,1910,0,1980,1980,98038,47.373,122.06,1470,3623,34,0,3.75,3380,5533
2.97e+05,2014,221,3,2.25,1450,7562,2,0,0,3,7,1450,0,1994,1994,98056,47.504,122.19,1650,7625,20,0,5.25,3100,9075
3.775e+05,2014,136,3,2.25,1410,1377,2,0,0,3,7,1290,120,2005,2005,98027,47.534,122.07,1445,1370,9,0,5.25,2855,2780
2.79e+05,2014,222,3,1.5,1780,16000,1,0,0,2,7,1240,540,1960,1960,98198,47.419,122.32,1860,9775,54,0,4.5,3640,11555
3e+05,2014,341,4,2.5,2400,7215,2,0,0,3,8,2400,0,1992,1992,98023,47.294,122.37,2220,7760,22,0,6.5,4620,10160
5.55e+05,2014,349,3,2,2080,7020,1,0,0,4,7,1040,1040,1951,1951,98115,47.677,122.28,1920,7000,63,0,5,4000,9080
8.8e+05,2014,294,4,2.5,2340,10800,1,0,0,3,8,2340,0,1953,2007,98040,47.572,122.22,2650,13500,61,1,6.5,4990,15840
4.66e+05,2014,195,2,1.5,1140,1058,3,0,0,3,7,1140,0,2005,2005,98103,47.661,122.33,1170,1116,9,0,3.5,2310,2256
1.9e+05,2014,225,2,1,840,12252,1,0,0,3,6,840,0,1994,1994,98010,47.307,122.01,1010,11876,20,0,3,1850,12716
6.2e+05,2014,132,3,1.5,1620,6630,1,0,0,3,8,1280,340,1954,1954,98117,47.695,122.39,1880,5100,60,0,4.5,3500,6720
3.85e+05,2014,194,3,1,1030,3000,1,0,0,3,7,830,200,1924,1924,98115,47.681,122.32,1830,3000,90,0,4,2860,4030
3.8e+05,2014,249,2,2.5,2110,1.1413e+05,1,0,0,4,8,1590,520,1975,1975,98031,47.414,122.21,1960,11250,39,0,4.5,4070,13360
7.32e+05,2014,277,4,1.75,2360,11300,1,0,0,4,9,2360,0,1974,1974,98006,47.573,122.16,2290,11951,40,0,5.75,4650,14311
6.5e+05,2014,160,4,2.25,2560,9731,2,0,0,4,7,2560,0,1973,1973,98034,47.726,122.25,1860,9731,41,0,6.25,4420,12291
8.5e+05,2015,431,3,2.25,3000,18450,1,0,0,3,10,3000,0,1983,1983,98077,47.727,122.06,2980,12304,32,0,5.25,5980,15304
4.31e+05,2015,472,2,1.5,1300,4000,1,0,0,4,6,1300,0,1900,1900,98144,47.594,122.3,1480,4000,115,0,3.5,2780,5300
2.63e+05,2014,190,3,1.75,1580,9187,1,0,0,3,8,1180,400,1993,1993,98038,47.354,122.05,1620,6397,21,0,4.75,3200,7977
5.55e+05,2014,160,3,2,2180,4976,1,0,2,4,8,1680,500,1930,1930,98126,47.573,122.38,1850,5000,84,0,5,4030,7180
6.15e+05,2014,197,3,2.5,1910,3427,2,0,0,3,8,1910,0,2001,2001,98052,47.632,122.11,2240,3720,13,0,5.5,4150,5630
2.305e+05,2015,437,2,1,740,8853,1,0,0,3,6,740,0,1943,1943,98166,47.479,122.34,850,8775,72,0,3,1590,9515
7.9e+05,2015,376,4,3,3120,1.5788e+05,2,0,0,4,8,3120,0,1977,1977,98058,47.444,122.19,1580,7050,38,0,7,4700,10170
3.3495e+05,2014,201,4,2.5,2410,7846,2,0,0,3,8,2410,0,1992,1992,98003,47.264,122.31,2380,7914,22,0,6.5,4790,10324
2.72e+05,2014,304,4,2.25,1880,6160,2,0,0,3,7,1880,0,1993,1993,98023,47.321,122.35,1580,6405,21,0,6.25,3460,8285
1.42e+06,2015,451,5,3.25,3950,11438,2,0,2,3,10,3430,520,2006,2006,98033,47.69,122.19,2070,10751,9,0,8.25,6020,14701
8.8e+05,2014,256,4,3.5,2800,6750,2,0,0,3,9,1890,910,1951,2002,98105,47.669,122.28,2370,6120,63,1,7.5,5170,8920
4.9995e+05,2014,160,2,2.25,1060,1208,2,0,0,3,8,940,120,2005,2005,98102,47.637,122.33,1300,1169,9,0,4.25,2360,2229
6.5e+05,2015,479,4,2.5,2240,9934,1,0,0,4,8,1490,750,1968,1968,98005,47.615,122.17,2640,11622,47,0,6.5,4880,13862
4.05e+05,2014,149,3,2,1240,14404,1,0,0,3,7,1240,0,1988,1988,98053,47.661,122.06,1350,9990,26,0,5,2590,11230
5.65e+05,2014,326,4,2.5,2520,13156,1,0,0,3,8,1520,1000,1979,1979,98052,47.656,122.14,2050,10940,35,0,6.5,4570,13460
2.46e+05,2015,437,4,1.5,2120,7110,1,0,0,3,6,2120,0,1919,1919,98030,47.385,122.23,1540,7110,96,0,5.5,3660,9230
2.8001e+05,2015,464,3,1.5,1130,7200,1,0,0,3,7,1130,0,1954,1954,98178,47.504,122.25,1130,7200,61,0,4.5,2260,8330
3.4813e+05,2015,407,3,1,1400,8451,1,0,0,3,7,1400,0,1953,1953,98133,47.772,122.34,1590,8433,62,0,4,2990,9833
4.11e+05,2014,283,5,1.75,2860,12293,1,0,0,4,8,1430,1430,1947,1947,98133,47.739,122.35,1920,18110,67,0,6.75,4780,20970
7.915e+05,2014,214,4,2.5,3250,8970,2,0,0,3,10,3250,0,1994,1994,98075,47.586,122.04,3240,8449,20,0,6.5,6490,11699
8.3e+05,2014,153,3,3,2080,10521,1,0,0,3,9,2080,0,2004,2004,98034,47.699,122.23,3730,11840,10,0,6,5810,13920
5.89e+05,2015,414,3,1.75,920,3600,1,0,0,4,6,820,100,1904,1904,98119,47.639,122.36,1620,3600,111,0,4.75,2540,4520
8.1e+05,2015,403,6,2.75,3970,9500,1,0,0,4,10,2180,1790,1970,1970,98005,47.596,122.18,2490,9775,45,0,8.75,6460,13745
3.88e+05,2014,218,3,2.5,2198,6222,2,0,2,3,8,2198,0,2010,2010,98198,47.391,122.3,2198,7621,4,0,5.5,4396,9819
2.12e+05,2015,479,3,1.5,1010,10000,1,0,0,4,7,1010,0,1973,1973,98003,47.288,122.29,2420,34637,42,0,4.5,3430,35647
6.2e+05,2014,162,2,1,1430,3000,1,0,0,3,7,1300,130,1929,1929,98112,47.642,122.3,1750,4000,85,0,3,3180,5430
7.8e+05,2015,365,4,2.5,3020,15164,1,0,0,4,8,1730,1290,1976,1976,98004,47.588,122.19,2600,11556,39,0,6.5,5620,14576
1.691e+05,2014,224,3,2,1050,18304,1,0,0,4,7,1050,0,1953,1953,98001,47.321,122.27,1690,15675,61,0,5,2740,16725
1.699e+05,2014,256,3,1,910,5800,1,0,0,4,5,910,0,1900,1900,98022,47.207,121.99,1400,6766,114,0,4,2310,7676
2.6495e+05,2015,369,2,1,770,7434,1,0,0,3,6,770,0,1947,1947,98155,47.761,122.32,1060,7453,68,0,3,1830,8223
5e+05,2014,273,4,2.75,2630,15000,1,0,0,4,7,1690,940,1976,1976,98072,47.742,122.09,1800,16500,38,0,6.75,4430,19130
4.5e+05,2014,170,3,2,1430,3480,1,0,0,3,7,980,450,1947,1947,98103,47.687,122.34,1450,4650,67,0,5,2880,6080
1.04e+06,2014,252,5,3.25,4770,50094,1,0,0,4,11,3070,1700,1973,1973,98005,47.653,122.16,3530,38917,41,0,8.25,8300,43687
3.35e+05,2014,307,3,1.75,2390,30409,1,0,0,3,7,1560,830,1953,1953,98168,47.479,122.3,1750,13500,61,0,4.75,4140,15890
4.075e+05,2014,218,2,1,770,2971,1,0,2,3,7,770,0,1923,1923,98102,47.636,122.32,1440,4000,91,0,3,2210,4770
1.388e+06,2014,262,4,2.5,3450,17400,1,0,0,4,9,2180,1270,1964,1964,98004,47.597,122.21,3770,19530,50,0,6.5,7220,22980
5.5e+05,2015,484,3,2.5,1980,9061,2,0,0,4,8,1980,0,1987,1987,98074,47.637,122.03,1930,8869,28,0,5.5,3910,10849
3.94e+05,2014,232,3,2.5,1370,4400,1,0,0,3,8,1370,0,1988,1988,98034,47.714,122.2,1630,4400,26,0,5.5,3000,5770
5.468e+05,2014,269,4,1.5,1520,5910,1,0,0,3,7,1020,500,1946,1946,98115,47.69,122.3,1710,5910,68,0,5.5,3230,7430
7.5e+05,2014,215,3,3.25,4610,81935,2,0,0,4,9,4610,0,1984,1984,98074,47.622,122.02,2900,43500,30,0,6.25,7510,48110
3.725e+05,2014,132,5,3,2480,10090,1,0,0,3,7,1300,1180,2004,2004,98178,47.496,122.26,2290,9900,10,0,8,4770,12380
4.2e+05,2014,359,5,1.5,1890,10880,1,0,0,3,7,1890,0,1962,1962,98034,47.72,122.2,1670,9750,52,0,6.5,3560,11640
3.5995e+05,2015,478,5,2.75,2844,3990,2,0,0,3,8,2844,0,2013,2013,98092,47.326,122.17,2273,3900,2,0,7.75,5117,6744
4.2e+05,2015,380,3,2.25,2520,26943,1,0,0,3,7,1760,760,1977,1977,98028,47.773,122.25,2300,10004,38,0,5.25,4820,12524
4.7e+05,2014,195,3,2.25,1780,8784,1,0,0,3,7,1230,550,1977,1977,98033,47.701,122.17,1780,7704,37,0,5.25,3560,9484
5.7e+05,2014,347,4,2.25,2380,36446,2,0,0,4,8,2380,0,1977,1977,98077,47.764,122.07,2790,40005,37,0,6.25,5170,42385
2.775e+05,2015,408,2,1.5,1190,1236,3,0,0,3,7,1190,0,2005,2005,98133,47.727,122.36,1390,1756,10,0,3.5,2580,2946
2.465e+05,2015,443,2,1,940,6000,1,0,0,2,7,940,0,1954,1954,98148,47.463,122.33,1890,8547,61,0,3,2830,9487
3.4e+05,2014,195,4,1.75,1800,5210,1,0,0,5,7,1080,720,1979,1979,98118,47.53,122.28,1870,5365,35,0,5.75,3670,7165
7.78e+05,2014,290,3,2.25,2260,33080,1,0,0,5,9,1690,570,1974,1974,98005,47.639,122.18,3020,35291,40,0,5.25,5280,37551
4.4989e+05,2014,341,3,2.25,2520,78408,2,0,0,3,9,2520,0,1988,1988,98001,47.351,122.28,1490,29972,26,0,5.25,4010,32492
1.085e+06,2015,436,3,2.5,3630,11019,1,0,0,4,9,2150,1480,1972,1972,98040,47.561,122.23,3150,13555,43,0,5.5,6780,17185
5.9e+05,2014,291,3,2.25,2210,5742,1,0,0,3,8,1460,750,1951,1951,98115,47.689,122.32,1900,4590,63,0,5.25,4110,6800
6e+05,2014,232,3,2.5,4930,77536,2,0,0,3,9,3930,1000,1981,1981,98072,47.763,122.14,2760,7351,33,0,5.5,7690,12281
4.5e+05,2014,166,6,2.25,3550,11780,1,0,0,4,8,2960,590,1948,1948,98125,47.722,122.31,2360,8850,66,0,8.25,5910,12400
2.4e+05,2015,414,4,2,1750,7800,1,0,0,4,6,1750,0,1944,1944,98166,47.479,122.35,1270,7800,71,0,6,3020,9550
3.275e+05,2014,345,3,2.5,2090,12027,2,0,0,3,8,2090,0,1991,1991,98031,47.408,122.21,2090,12666,23,0,5.5,4180,14756
1.93e+05,2015,440,2,1.75,1280,6774,1,0,0,3,7,1280,0,1991,1991,98002,47.292,122.22,1450,7810,24,0,3.75,2730,9090
4.15e+05,2015,429,3,1.5,1220,835,1,0,0,4,6,1220,0,1950,1950,98103,47.698,122.34,1360,1251,65,0,4.5,2580,2471
3.399e+05,2015,379,4,1.75,2600,18042,1,0,0,4,8,2020,580,1969,1969,98092,47.297,122.19,2200,9408,46,0,5.75,4800,12008
2.26e+05,2014,197,4,1,1270,6459,1,0,0,3,7,1270,0,1918,1918,98118,47.544,122.27,1300,4100,96,0,5,2570,5370
2.7e+05,2015,429,3,1.75,2840,9800,1,0,0,4,7,1420,1420,1977,1977,98042,47.352,122.12,1650,9590,38,0,4.75,4490,12430
7.07e+05,2014,325,4,2.25,2920,17023,1,0,0,4,9,1690,1230,1977,1977,98006,47.559,122.13,2710,10681,37,0,6.25,5630,13601
1.385e+06,2014,251,3,3,2490,3600,2,0,3,4,8,1790,700,1911,1911,98119,47.631,122.37,2490,3600,103,0,6,4980,6090
4.1919e+05,2014,125,2,2.5,1590,1426,2,0,0,3,8,1590,0,2014,2014,98029,47.544,122.01,1590,1426,0,0,4.5,3180,3016
9.6e+05,2014,221,3,1.75,2460,4800,1,0,0,4,7,1230,1230,1938,1938,98112,47.634,122.28,2860,4800,76,0,4.75,5320,7260
3.3e+05,2014,150,2,2.5,1240,1546,2,0,0,3,7,1240,0,2007,2007,98108,47.563,122.3,1520,2468,7,0,4.5,2760,3708
3.46e+05,2014,333,3,2,1060,1184,2,0,0,3,7,730,330,2006,2006,98136,47.544,122.39,1270,1601,8,0,5,2330,2661
4.255e+05,2015,415,4,1.75,1520,10630,1,0,0,4,7,1520,0,1967,1967,98034,47.735,122.19,1550,8039,48,0,5.75,3070,9559
3.745e+05,2014,175,3,2.25,1400,11400,2,0,0,3,8,1400,0,1984,1984,98028,47.743,122.23,2180,9248,30,0,5.25,3580,10648
2.7e+05,2015,381,4,1,1430,5909,1,0,0,3,6,1070,360,1947,1947,98155,47.762,122.31,1460,8433,68,0,5,2890,9863
4.75e+05,2014,230,3,1.5,1750,12632,1,0,0,4,7,1750,0,1952,1952,98033,47.674,122.18,1740,12196,62,0,4.5,3490,13946
5e+05,2014,347,4,2.5,2230,8560,2,0,0,3,8,2230,0,2002,2002,98059,47.488,122.14,2400,7756,12,0,6.5,4630,9986
2.67e+05,2014,235,1,1,800,2480,1,0,0,4,6,800,0,1919,1919,98108,47.558,122.32,1490,4650,95,0,2,2290,5450
7.83e+05,2015,444,4,2.75,2080,5000,1,0,0,5,8,1470,610,1940,1940,98199,47.642,122.4,1970,5000,75,0,6.75,4050,7080
4.4e+05,2014,297,2,2.75,1100,1088,2,0,0,3,7,750,350,2006,2006,98102,47.641,122.32,2090,4125,8,0,4.75,3190,5225
5.35e+05,2014,230,4,2.75,2360,15100,1,0,0,3,8,2360,0,2014,2014,98146,47.512,122.36,1440,13346,0,0,6.75,3800,15706
8.18e+05,2015,436,4,2.25,2460,8001,2,0,0,4,8,2460,0,1984,1984,98006,47.548,122.15,2460,9126,31,0,6.25,4920,11586
7.365e+05,2014,232,3,2,2230,4800,1,0,0,4,7,1290,940,1915,1915,98199,47.645,122.39,1650,5040,99,0,5,3880,7270
5.3e+05,2015,372,3,1,1440,27505,1,0,0,3,8,1440,0,1951,1951,98177,47.755,122.37,2430,16400,64,0,4,3870,17840
2.66e+05,2014,128,3,2.5,1940,8547,1,0,0,3,7,1460,480,1989,1989,98030,47.349,122.18,1750,7803,25,0,5.5,3690,9743
2.67e+05,2014,232,3,1,940,4700,1,0,0,4,6,940,0,1942,1942,98146,47.512,122.38,1020,5700,72,0,4,1960,6640
2.25e+05,2015,484,2,1,1010,5408,1,0,0,4,6,1010,0,1926,1926,98032,47.376,122.24,980,7800,89,0,3,1990,8810
1.156e+06,2014,307,4,3.5,4270,12305,2,0,2,3,10,4270,0,1994,1994,98006,47.549,122.12,4190,13137,20,0,7.5,8460,17407
2.44e+05,2014,340,3,2,1350,8587,1,0,0,3,7,1350,0,1998,1998,98022,47.207,122.01,1350,8587,16,0,5,2700,9937
5.6e+05,2014,154,3,2.5,2070,12708,2,0,0,3,8,2070,0,1996,1996,98056,47.529,122.18,2620,9617,18,0,5.5,4690,11687
1.5e+05,2015,475,3,1,1240,5200,1,0,0,3,6,1240,0,1969,1969,98042,47.37,122.08,870,5200,46,0,4,2110,6440
2.5e+05,2014,188,3,1.75,1140,10400,1,0,0,4,7,1140,0,1983,1983,98003,47.26,122.31,1280,9800,31,0,4.75,2420,10940
7.116e+05,2014,188,4,3,3580,9316,2,0,0,3,10,2370,1210,1991,1991,98007,47.595,122.13,2580,9242,23,0,7,6160,12822
7.205e+05,2014,189,4,2.5,3350,35298,2,0,0,4,9,3350,0,1985,1985,98053,47.651,122.04,2620,35604,29,0,6.5,5970,38954
8.25e+05,2014,298,3,2.5,3760,5260,2,0,0,3,9,3230,530,2002,2002,98029,47.549,122.01,3080,5312,12,0,5.5,6840,9072
4.255e+05,2014,195,3,2.5,1970,2752,2,0,0,3,8,1970,0,1978,1978,98052,47.635,122.11,1850,2778,36,0,5.5,3820,4748
3.5e+05,2015,452,4,2.5,2140,7095,2,0,0,3,8,2140,0,1992,1992,98038,47.353,122.06,1600,7182,23,0,6.5,3740,9322
2.62e+05,2014,182,5,1,1870,7800,1,0,0,3,7,1580,290,1962,1962,98168,47.513,122.32,1740,7808,52,0,6,3610,9678
3.4e+05,2014,348,3,2.5,2360,8093,2,0,0,3,8,2360,0,1995,1995,98092,47.326,122.17,1860,6762,19,0,5.5,4220,9122
3.69e+05,2015,429,2,1,1320,6135,1,0,0,4,7,880,440,1942,1942,98126,47.526,122.38,1050,4693,73,0,3,2370,6013
5.8e+05,2014,250,4,2.25,2570,36465,2,0,0,4,8,2570,0,1980,1980,98053,47.656,122.04,2390,41454,34,0,6.25,4960,44024
2.86e+05,2015,459,3,1,950,8400,1,0,0,3,7,950,0,1958,1958,98056,47.51,122.17,1250,8400,57,0,4,2200,9350
4.95e+05,2014,269,4,2.5,2460,4774,2,0,0,3,8,2460,0,2006,2006,98059,47.491,122.14,2510,4399,8,0,6.5,4970,6859
6.55e+05,2015,426,4,2.25,2420,7725,1,0,0,4,8,1890,530,1972,1972,98052,47.629,122.09,1740,7944,43,0,6.25,4160,10364
5.475e+05,2014,161,3,3.5,1650,2262,3,0,0,3,8,1650,0,2010,2010,98103,47.682,122.35,1620,3166,4,0,6.5,3270,4816
2.73e+05,2014,273,2,0.5,1180,7750,1,0,0,4,6,590,590,1945,1945,98155,47.769,122.32,1380,8976,69,0,2.5,2560,10156
4.77e+05,2015,457,3,2.25,1260,3000,2,0,0,3,7,1260,0,2003,2003,98029,47.546,122,1630,3023,12,0,5.25,2890,4283
3e+05,2014,181,3,2.25,1660,5128,2,0,0,3,7,1660,0,2001,2001,98019,47.736,121.97,1680,4652,13,0,5.25,3340,6312
2.995e+05,2014,238,3,1.75,1810,34500,1,0,0,3,8,1230,580,1980,1980,98032,47.371,122.28,2090,9735,34,0,4.75,3900,11545
2.65e+05,2015,399,3,2.5,1660,5250,2,0,0,4,8,1660,0,1988,1988,98003,47.354,122.3,1630,5505,27,0,5.5,3290,7165
4.045e+05,2014,300,2,1,1270,3700,1,0,0,3,7,1270,0,1909,1909,98144,47.595,122.31,1980,3200,105,0,3,3250,4470
4.968e+05,2015,446,4,2.25,1850,2340,2,0,0,3,8,1850,0,2014,2014,98126,47.543,122.37,1850,2340,1,0,6.25,3700,4190
7.65e+05,2015,474,3,1.75,2190,6450,1,0,0,3,8,1480,710,1957,1957,98136,47.528,122.39,2190,6450,58,0,4.75,4380,8640
3.05e+05,2015,437,3,1,1710,19115,1,0,0,3,6,1710,0,1986,1986,98014,47.656,121.91,1650,15144,29,0,4,3360,16854
1.25e+06,2014,160,4,2.5,3700,21755,1,0,4,3,11,2620,1080,1988,1988,98006,47.566,122.11,3480,13786,26,0,6.5,7180,17486
3.2e+05,2015,445,3,1,960,6180,1,0,0,4,6,960,0,1910,1910,98118,47.552,122.28,1250,4120,105,0,4,2210,5080
5.15e+05,2015,472,5,2.5,1690,2402,1,0,0,3,7,990,700,1930,1930,98117,47.69,122.38,1200,4005,85,0,7.5,2890,5695
3.8e+05,2015,386,4,1.75,2260,7200,1,0,0,5,7,1360,900,1924,1924,98056,47.512,122.19,1410,7465,91,0,5.75,3670,9725
2.6e+05,2014,292,3,2,1030,7260,1,0,0,3,6,1030,0,1947,1947,98146,47.511,122.35,1380,8100,67,0,5,2410,9130
3.3e+05,2014,188,3,2.25,2220,4060,1,0,0,3,7,1330,890,1993,1993,98118,47.519,122.27,1930,5625,21,0,5.25,4150,7845
4.16e+05,2014,269,2,1,880,6650,1,0,0,5,6,880,0,1918,1918,98117,47.691,122.37,1250,6650,96,0,3,2130,7530
7.05e+05,2015,463,3,2.5,2500,10359,2,0,0,3,10,2500,0,1986,1986,98074,47.629,122.05,2580,10142,29,0,5.5,5080,12642
6.7e+05,2015,437,4,1.75,1930,9310,1,0,0,4,9,1930,0,1968,1968,98008,47.616,122.11,2110,10290,47,0,5.75,4040,12220
5.85e+05,2014,256,3,3.5,1700,2197,2,0,0,3,8,1260,440,2010,2010,98116,47.577,122.41,1360,1418,4,0,6.5,3060,3118
6.49e+05,2014,211,3,2.5,3410,13809,1,0,3,4,10,2450,960,1973,1973,98003,47.342,122.33,3410,14245,41,0,5.5,6820,17655
1.93e+05,2015,446,2,1.75,910,2550,1,0,0,3,6,910,0,2004,2004,98038,47.349,122.02,1310,2550,11,0,3.75,2220,3460
8.6e+05,2015,486,4,2.75,2720,3840,2,0,0,3,8,1790,930,1920,2009,98107,47.662,122.36,1360,3880,95,1,6.75,4080,6600
6.3e+05,2014,314,3,3.25,3800,13995,2,0,3,3,9,3800,0,1983,1983,98011,47.774,122.2,2480,8434,31,0,6.25,6280,12234
1.65e+06,2015,369,4,3.25,3910,7500,2,0,0,3,10,3910,0,2006,2006,98033,47.653,122.2,2600,9235,9,0,7.25,6510,13145
6.3e+05,2015,472,3,2.5,2460,38794,2,0,0,3,9,2460,0,1999,1999,98077,47.76,122.02,2470,51400,16,0,5.5,4930,53860
6.75e+05,2014,205,3,2.5,2550,4954,1,0,0,4,7,1850,700,1924,1924,98144,47.576,122.29,1700,4954,90,0,5.5,4250,7504
8.85e+05,2014,132,4,2.5,2830,5000,2,0,0,3,9,2830,0,1995,1995,98105,47.66,122.29,1950,5000,19,0,6.5,4780,7830
1.24e+05,2014,273,1,0.75,840,7203,1,0,0,3,6,840,0,1949,1949,98168,47.476,122.3,1560,8603,65,0,1.75,2400,9443
4.61e+05,2014,224,3,2.25,1850,7923,1,0,0,4,7,1150,700,1977,1977,98033,47.701,122.17,1780,7420,37,0,5.25,3630,9270
5.15e+05,2015,373,2,2.25,2690,15000,1,0,2,3,8,1870,820,1987,1987,98023,47.336,122.35,2690,15000,28,0,4.25,5380,17690
2.075e+05,2014,229,3,1.75,1320,12528,1,0,0,4,7,1320,0,1970,1970,98042,47.323,122.14,1340,11039,44,0,4.75,2660,12359
3.19e+05,2014,354,3,2.5,1610,8544,2,0,0,5,7,1610,0,1994,1994,98038,47.371,122.05,1840,8190,20,0,5.5,3450,9800
4.3e+05,2014,205,2,1,990,4920,1,0,0,3,6,990,0,1931,1931,98117,47.694,122.37,990,4960,83,0,3,1980,5950
3.08e+05,2014,318,4,2.25,1960,12243,2,0,0,3,8,1960,0,1989,1989,98042,47.34,122.06,1910,12230,25,0,6.25,3870,14190
8.05e+05,2014,176,3,2.75,2600,5875,1,0,2,5,8,1600,1000,1929,1929,98116,47.577,122.41,2260,5492,85,0,5.75,4860,8092
7.85e+05,2014,161,3,3.5,4500,21870,2,0,0,3,10,4500,0,2004,2004,98092,47.304,122.16,4670,23058,10,0,6.5,9170,27558
1.4e+06,2015,477,4,3.5,4380,66613,1,0,0,3,11,4380,0,1993,1993,98077,47.728,122.05,4010,70109,22,0,7.5,8390,74489
1.175e+06,2015,483,2,2.5,1770,7155,2,1,4,3,8,1770,0,1957,2004,98155,47.734,122.28,2410,10476,58,1,4.5,4180,12246
6.85e+05,2014,224,4,2.5,2650,25248,1,0,2,3,9,2330,320,1954,1954,98177,47.754,122.37,3020,23135,60,0,6.5,5670,25785
1.052e+06,2015,446,3,1,1860,44431,1,0,0,4,6,1860,0,1947,1947,98074,47.606,122.04,2000,44431,68,0,4,3860,46291
2.99e+05,2015,486,4,2.5,2300,8100,1,0,0,4,8,1360,940,1979,1979,98023,47.298,122.37,1910,7630,36,0,6.5,4210,9930
6.05e+05,2014,182,4,2.25,2940,48788,1,0,0,5,7,1520,1420,1961,1961,98028,47.742,122.25,2470,14900,53,0,6.25,5410,17840
1.85e+05,2014,135,3,1,1150,8100,1,0,0,3,6,1150,0,1932,1932,98168,47.494,122.31,1120,8100,82,0,4,2270,9250
1.6e+05,2014,294,3,1.75,1010,5355,1,0,0,3,6,1010,0,1950,1950,98106,47.52,122.35,750,4515,64,0,4.75,1760,5525
4.25e+05,2015,457,4,2.5,2460,5440,2,0,0,3,9,2460,0,2003,2003,98058,47.448,122.12,2460,5124,12,0,6.5,4920,7584
9.9795e+05,2014,297,4,3.5,4270,1.1718e+05,2,0,0,3,9,4270,0,2008,2008,98024,47.535,121.88,2610,5251,6,0,7.5,6880,9521
4.5e+05,2015,478,3,2.25,1960,10682,1,0,0,3,7,1960,0,1957,1957,98008,47.632,122.12,1540,10682,58,0,5.25,3500,12642
6.2e+05,2014,293,2,1,990,4332,1,0,0,3,7,990,0,1909,1909,98103,47.653,122.33,1920,3420,105,0,3,2910,4410
2.75e+05,2014,297,3,1.25,1230,4500,1,0,0,4,7,1230,0,1913,1913,98118,47.53,122.27,1310,5000,101,0,4.25,2540,6230
3.65e+05,2014,278,4,1.5,1820,12327,1,0,0,4,7,1380,440,1955,1955,98006,47.577,122.14,1450,9256,59,0,5.5,3270,11076
3.1e+05,2014,195,3,1,1210,9730,1,0,0,4,7,1210,0,1953,1953,98133,47.762,122.36,1470,9730,61,0,4,2680,10940
3e+05,2015,389,3,2.75,2340,12282,1,0,2,3,8,1470,870,1978,1978,98155,47.738,122.29,2640,8887,37,0,5.75,4980,11227
2.35e+05,2014,153,2,1,720,4840,1,0,0,4,6,720,0,1947,1947,98126,47.553,122.38,1510,4840,67,0,3,2230,5560
4.2695e+05,2014,303,4,2.75,2350,5589,2,0,0,3,7,2350,0,2001,2001,98059,47.51,122.16,2014,6365,13,0,6.75,4364,8715
2.905e+05,2014,340,4,3.25,2510,7686,2,0,0,3,9,2510,0,2003,2003,98055,47.478,122.23,2510,6732,11,0,7.25,5020,9242
4.6e+05,2015,373,4,2.75,3460,13168,2,0,0,4,8,3460,0,1932,1986,98022,47.205,122,1500,7670,83,1,6.75,4960,11130
2.25e+05,2015,445,3,1,1250,7820,1,0,0,3,7,1250,0,1967,1967,98001,47.34,122.29,1300,7920,48,0,4,2550,9170
6.1e+05,2014,227,3,2.5,3440,18167,2,0,0,3,11,3440,0,1991,1991,98023,47.291,122.34,3990,20239,23,0,5.5,7430,23679
6.66e+05,2015,395,3,2.5,2140,2868,2,0,0,3,8,1770,370,2007,2007,98052,47.667,122.13,2140,2527,8,0,5.5,4280,4667
6.75e+05,2015,431,3,2.75,2740,5735,2,0,0,3,9,2740,0,2004,2004,98052,47.686,122.09,2210,5026,11,0,5.75,4950,7766
5.1e+05,2015,459,3,2,1420,11325,1,0,0,3,7,1420,0,1980,1980,98027,47.536,122.05,2330,3474,35,0,5,3750,4894
1.8867e+06,2014,150,5,3.5,4180,17935,2,0,0,3,11,4180,0,2004,2004,98004,47.587,122.2,2950,13760,10,0,8.5,7130,17940
1.384e+06,2014,168,4,3.25,4290,12103,1,0,3,3,11,2690,1600,1997,1997,98006,47.55,122.1,3860,11244,17,0,7.25,8150,15534
2.6e+05,2014,182,4,2,1620,7992,2,0,0,4,7,1620,0,1975,1975,98031,47.395,122.18,1710,7500,39,0,6,3330,9120
1.699e+06,2014,224,3,3.25,4160,35153,3,0,2,3,12,3690,470,2001,2001,98040,47.575,122.21,3290,11533,13,0,6.25,7450,15693
3.4858e+05,2014,142,3,1,1220,7876,1,0,0,3,7,1220,0,1966,1966,98034,47.732,122.2,1340,7876,48,0,4,2560,9096
4.23e+05,2015,365,4,2.25,2200,9351,1,0,0,5,7,1290,910,1962,1962,98133,47.745,122.33,1910,8660,53,0,6.25,4110,10860
4.5e+05,2015,458,3,2,1680,4886,2,0,0,3,7,1180,500,1940,1940,98118,47.554,122.29,1400,4900,75,0,5,3080,6580
4.49e+05,2015,467,4,2,1560,5220,1,0,0,3,7,1560,0,1959,1959,98115,47.691,122.31,1300,5220,56,0,6,2860,6780
8.89e+05,2014,301,4,2.5,2570,4480,1,0,0,4,8,1580,990,1927,1927,98105,47.67,122.29,2070,4480,87,0,6.5,4640,7050
2.64e+05,2014,231,3,1.5,1820,10608,1,0,0,4,7,1820,0,1962,1962,98003,47.337,122.31,1380,8976,52,0,4.5,3200,10796
4.5e+05,2014,155,4,1,2000,4676,1,0,0,3,7,1250,750,1916,1986,98118,47.553,122.27,1140,4676,98,1,5,3140,6676
6.01e+05,2015,486,4,2.5,2050,8094,1,0,0,3,8,1050,1000,1976,1976,98052,47.661,122.14,1990,9020,39,0,6.5,4040,11070
5.0901e+05,2015,436,3,1.75,1800,7620,1,0,0,3,8,1350,450,1951,1951,98177,47.717,122.36,1770,7620,64,0,4.75,3570,9420
6.2e+05,2014,176,6,3.5,3600,6875,2,0,0,3,8,2740,860,2004,2004,98065,47.54,121.88,3150,6663,10,0,9.5,6750,10263
9.425e+05,2014,195,5,3.5,3750,9612,1,0,2,4,9,2030,1720,1981,1981,98006,47.551,122.16,3270,9688,33,0,8.5,7020,13438
3.85e+05,2015,424,1,1,620,5100,1,0,0,3,6,620,0,1954,1954,98144,47.57,122.29,1540,2676,61,0,2,2160,3296
2.79e+05,2015,488,4,1.75,1840,7275,1,0,0,3,7,1090,750,1976,1976,98031,47.4,122.19,1840,7275,39,0,5.75,3680,9115
2.6995e+05,2015,389,3,2.25,1510,6000,1,0,0,4,7,1150,360,1993,1993,98038,47.348,122.04,1510,6000,22,0,5.25,3020,7510
6.225e+05,2014,237,3,2.5,2260,4550,1,0,0,4,7,1380,880,1928,1928,98126,47.571,122.38,1870,4582,86,0,5.5,4130,6842
3.25e+05,2014,332,2,2.25,1230,1078,2,0,0,3,7,1160,70,2008,2008,98027,47.532,122.07,1240,817,6,0,4.25,2470,2047
1.1574e+06,2014,174,3,2.5,2740,5925,2,0,2,3,10,2740,0,1913,1992,98112,47.631,122.3,2740,5948,101,1,5.5,5480,8688
5.775e+05,2014,278,3,1.75,2140,13286,1,0,0,4,8,1220,920,1964,1964,98006,47.572,122.13,2250,13286,50,0,4.75,4390,15426
2.51e+05,2014,236,3,2,1300,8400,1,0,0,4,7,1300,0,1967,1967,98198,47.368,122.31,1300,7500,47,0,5,2600,8800
8.11e+05,2014,182,3,3,2470,7410,2,0,0,5,8,1860,610,1977,1977,98117,47.694,122.39,2390,7800,37,0,6,4860,10270
2.837e+05,2014,223,1,1.75,1010,10900,1,0,0,4,6,1010,0,1968,1968,98019,47.739,121.98,1410,8359,46,0,2.75,2420,9369
5.35e+05,2014,168,4,2.5,2610,4595,2,0,0,3,8,2610,0,2008,2008,98028,47.773,122.23,2440,4588,6,0,6.5,5050,7198
3.25e+05,2014,174,3,1,850,6906,1,0,0,3,6,850,0,1948,1948,98155,47.744,122.31,1150,6907,66,0,4,2000,7757
5.32e+05,2014,154,3,2.5,1820,4910,2,0,0,3,8,1820,0,1993,1993,98029,47.57,122,2090,6668,21,0,5.5,3910,8488
4.16e+05,2014,198,2,1.75,1270,7560,1,0,0,4,7,1270,0,1932,1932,98133,47.708,122.36,1480,7560,82,0,3.75,2750,8830
3.55e+05,2014,294,3,1,1210,6650,1,0,0,3,6,1210,0,1959,1959,98008,47.621,122.12,990,7590,55,0,4,2200,8800
3.85e+05,2014,166,2,1,830,26329,1,1,3,4,6,830,0,1928,1928,98070,47.401,122.42,2030,27338,86,0,3,2860,28168
6.73e+05,2014,188,3,2.75,2830,3496,2,0,0,3,8,2830,0,2012,2012,98029,47.561,122.01,2160,3501,2,0,5.75,4990,6331
3.4995e+05,2015,487,3,2,1640,4714,1,0,0,3,8,1640,0,2009,2009,98038,47.354,122.02,1770,4802,6,0,5,3410,6442
3.05e+05,2015,485,3,2.5,2030,8000,2,0,0,3,7,2030,0,1997,1997,98031,47.402,122.22,2290,7945,18,0,5.5,4320,9975
2.31e+05,2014,149,4,2,1530,6375,2,0,0,3,7,1530,0,1942,1983,98058,47.469,122.16,1500,8712,72,1,6,3030,10242
2.63e+05,2014,198,3,2.5,1720,6847,2,0,0,3,7,1720,0,1987,1987,98001,47.327,122.27,1610,7790,27,0,5.5,3330,9510
5.085e+05,2014,319,4,1.5,1800,6750,1,0,0,4,7,1800,0,1950,1950,98115,47.687,122.28,1420,5900,64,0,5.5,3220,7700
2.525e+05,2014,345,3,2,1150,6000,1,0,0,5,7,1150,0,1956,1956,98178,47.498,122.26,1980,6360,58,0,5,3130,7510
5.14e+05,2014,225,2,1,920,4000,1,0,0,4,7,920,0,1906,1906,98105,47.671,122.33,1300,4000,108,0,3,2220,4920
3.3e+05,2014,361,3,2.5,1990,9995,2,0,0,3,7,1990,0,1996,1996,98198,47.383,122.31,1680,7511,18,0,5.5,3670,9501
3.9e+05,2014,169,3,2.25,1600,10240,1,0,0,3,7,1090,510,1979,1979,98034,47.728,122.23,1520,9394,35,0,5.25,3120,10994
4.6575e+05,2014,135,3,1.5,1260,10350,1,0,0,3,7,1260,0,1959,1959,98008,47.636,122.12,1800,10350,55,0,4.5,3060,11610
5.95e+05,2015,473,4,2.5,2030,10722,1,0,0,3,7,1100,930,1967,1967,98115,47.696,122.3,1610,9134,48,0,6.5,3640,11164
4.775e+05,2015,433,3,2,1860,5146,2,0,0,3,8,1860,0,1991,1991,98029,47.571,122,1950,5146,24,0,5,3810,7006
4.99e+05,2015,457,4,2.75,2250,14149,2,0,0,3,9,2250,0,1992,1992,98019,47.735,121.96,2450,14027,23,0,6.75,4700,16277
4.952e+05,2014,335,5,2.25,2710,22120,1,0,0,3,7,1410,1300,1955,1955,98011,47.764,122.19,2850,12224,59,0,7.25,5560,14934
2.525e+05,2014,313,3,2,1810,10684,2,0,0,3,8,1810,0,1987,1987,98058,47.462,122.15,2140,9657,27,0,5,3950,11467
3.08e+05,2014,194,4,2.75,2420,8438,2,0,0,3,8,2420,0,1996,1996,98022,47.209,122.01,2420,8580,18,0,6.75,4840,11000
6.18e+05,2014,272,4,1,1260,4080,1,0,0,4,7,1260,0,1911,1911,98105,47.664,122.32,1340,4080,103,0,5,2600,5340
4.83e+05,2014,191,3,3,2440,15540,2,0,0,3,9,2440,0,1992,1992,98074,47.61,122.06,2440,15283,22,0,6,4880,17723
5.9e+05,2015,473,3,2.5,2140,3628,2,0,0,3,8,1960,180,2006,2006,98027,47.537,122.07,2280,2812,9,0,5.5,4420,4952
3.35e+05,2014,341,2,1,1070,6678,1,0,0,4,7,1070,0,1951,1951,98133,47.731,122.36,1680,7788,63,0,3,2750,8858
1.595e+06,2014,151,5,3,3640,8239,2,0,3,3,10,2540,1100,1982,1982,98008,47.584,122.11,3330,10643,32,0,8,6970,14283
6.25e+05,2014,245,3,1.75,1580,20588,1,0,0,3,8,1580,0,1970,1970,98125,47.706,122.29,2080,7800,44,0,4.75,3660,9380
6.65e+05,2014,125,4,2.5,2800,5900,1,0,0,3,8,1660,1140,1963,1963,98115,47.681,122.29,2580,5900,51,0,6.5,5380,8700
2.699e+05,2014,305,3,1.5,1420,22100,1,0,0,5,7,1420,0,1957,1957,98042,47.419,122.15,1540,21780,57,0,4.5,2960,23200
2.17e+05,2015,417,2,1,770,9715,1,0,0,4,6,770,0,1942,1942,98168,47.492,122.31,1140,9715,73,0,3,1910,10485
3.54e+05,2014,273,2,1,1390,7740,1,0,0,4,6,1390,0,1925,1925,98126,47.523,122.37,1290,7740,89,0,3,2680,9130
2.79e+05,2015,466,6,1.75,2240,11180,2,0,0,4,7,2240,0,1955,1955,98198,47.42,122.32,1590,7955,60,0,7.75,3830,10195
2.5e+05,2014,195,4,2.75,1910,7700,1,0,0,4,7,1000,910,1980,1980,98030,47.369,122.17,1880,7875,34,0,6.75,3790,9785
3.615e+05,2014,297,2,1,840,3860,1,0,0,4,6,840,0,1909,1909,98117,47.684,122.36,1390,3860,105,0,3,2230,4700
1.2067e+06,2014,252,5,4.25,4150,12015,2,0,0,3,10,4150,0,2014,2014,98075,47.582,122.02,3230,27520,0,0,9.25,7380,31670
8.75e+05,2014,190,5,3,2960,15152,2,0,0,3,9,2960,0,2004,2004,98033,47.669,122.18,1850,9453,10,0,8,4810,12413
5.8995e+05,2014,174,4,2.5,3190,8195,2,0,0,3,10,3190,0,2006,2006,98038,47.355,122,3400,7607,8,0,6.5,6590,10797
2.75e+05,2014,169,3,1.75,1860,15681,1,0,0,4,7,1860,0,1971,1971,98023,47.319,122.34,1860,22979,43,0,4.75,3720,24839
1.795e+06,2014,147,4,3.25,4060,13000,2,0,3,3,11,4060,0,2000,2000,98040,47.581,122.25,3220,13800,14,0,7.25,7280,17860
2.6e+05,2014,197,4,2.25,2160,8811,1,0,0,3,8,1360,800,1978,1978,98023,47.313,122.39,2090,8400,36,0,6.25,4250,10560
3.25e+05,2014,170,2,1,840,4239,1,0,0,3,7,840,0,1948,1948,98126,47.532,122.38,1120,4494,66,0,3,1960,5334
5.318e+05,2015,409,3,2.5,1930,5344,2,0,0,3,7,1930,0,2004,2004,98053,47.678,122.03,2410,5080,11,0,5.5,4340,7010
5.5e+05,2014,133,4,2,2250,7500,1,0,0,5,7,1200,1050,1956,1956,98005,47.588,122.16,1440,7500,58,0,6,3690,9750
4.2e+05,2014,258,3,1,1320,5500,1,0,0,3,7,1320,0,1955,1955,98116,47.571,122.4,1480,5250,59,0,4,2800,6570
4.75e+05,2014,280,4,3,2410,8284,1,0,0,5,7,1210,1200,1969,1969,98034,47.72,122.22,2050,7940,45,0,7,4460,10350
6.3275e+05,2015,457,4,2,1800,4800,1,0,0,3,7,1800,0,1918,1918,98112,47.639,122.3,1950,4800,97,0,6,3750,6600
2.88e+05,2014,348,3,1,1410,40500,1,0,0,4,7,1410,0,1961,1961,98092,47.32,122.1,1570,40500,53,0,4,2980,41910
4.45e+05,2014,300,3,1.75,2110,4800,1,0,0,3,8,1210,900,1956,1956,98108,47.567,122.32,1660,4800,58,0,4.75,3770,6910
3.0206e+05,2015,413,4,2,1390,745,3,0,0,3,7,1390,0,2008,2008,98027,47.539,122.03,1390,942,7,0,6,2780,2332
1.005e+06,2014,306,5,2,2440,3080,2,0,0,4,8,2440,0,1910,1910,98112,47.624,122.31,1640,3077,104,0,7,4080,5517
7.8e+05,2014,133,3,1.75,2340,10495,1,0,0,4,8,2340,0,1967,1967,98040,47.539,122.23,3120,11068,47,0,4.75,5460,13408
2.6e+05,2014,348,4,1.75,1360,7700,1,0,0,4,7,1360,0,1966,1966,98058,47.456,122.18,1321,7756,48,0,5.75,2681,9116
4.425e+05,2014,173,3,1.75,1600,10280,1,0,0,3,7,1050,550,1977,1977,98034,47.725,122.17,1590,8100,37,0,4.75,3190,9700
3.4e+05,2014,136,3,1,1250,4800,1,0,0,4,7,1250,0,1951,1951,98126,47.552,122.38,1404,4800,63,0,4,2654,6050
3.15e+05,2015,459,6,2,1750,17685,1,0,0,4,5,1750,0,1943,1943,98056,47.51,122.18,1750,9209,72,0,8,3500,10959
3.5e+05,2014,216,2,1,1430,8157,1,0,0,3,7,1150,280,1944,1944,98177,47.726,122.36,1820,8157,70,0,3,3250,9587
4.1995e+05,2014,259,4,2.5,2220,6800,2,0,0,3,7,2220,0,2002,2002,98059,47.49,122.15,2220,5303,12,0,6.5,4440,7523
4.26e+05,2014,317,2,1,1630,7680,1,0,0,3,7,830,800,1947,1947,98125,47.709,122.29,1250,7740,67,0,3,2880,9370
6e+05,2015,464,4,2.5,2420,7744,2,0,0,3,9,2420,0,1994,1994,98056,47.534,122.18,2820,11129,21,0,6.5,5240,13549
5.18e+05,2014,126,3,1.5,1430,8000,1,0,0,4,7,1430,0,1956,1956,98007,47.587,122.14,1450,8000,58,0,4.5,2880,9430
4.89e+05,2014,236,2,1.75,1810,4220,2,0,0,3,8,1810,0,2004,2004,98053,47.718,122.03,1350,4479,10,0,3.75,3160,6289
3.7495e+05,2014,224,4,1.5,1970,14490,1,0,0,4,7,1970,0,1963,1963,98059,47.461,122.07,1880,14880,51,0,5.5,3850,16850
1.175e+06,2015,480,4,2,2590,7220,2,0,2,4,10,2590,0,1930,1930,98199,47.647,122.41,2530,6380,85,0,6,5120,8970
4.47e+05,2015,414,2,1,720,7500,1,0,2,3,6,720,0,1925,1925,98136,47.519,122.39,1390,5000,90,0,3,2110,5720
3.8289e+05,2015,437,1,1,620,2380,1,0,0,3,6,620,0,1900,1900,98115,47.675,122.33,980,3570,115,0,2,1600,4190
8.2e+05,2015,447,3,2.5,3030,46538,2,0,0,3,10,3030,0,1997,1997,98053,47.664,122.04,3370,51450,18,0,5.5,6400,54480
4.675e+05,2015,412,2,1.75,1490,4800,1,0,0,4,7,750,740,1918,1918,98136,47.55,122.39,1400,6000,97,0,3.75,2890,7490
3.83e+05,2014,175,3,1.75,1500,13430,1,0,0,3,7,1500,0,1977,1977,98072,47.753,122.08,1500,13430,37,0,4.75,3000,14930
1.09e+05,2015,374,2,0.5,580,6900,1,0,0,3,5,580,0,1941,1941,98118,47.514,122.26,1570,5040,74,0,2.5,2150,5620
2.6995e+05,2014,349,3,1.75,1400,7735,1,0,0,4,7,1400,0,1989,1989,98038,47.357,122.04,1530,7754,25,0,4.75,2930,9154
4.67e+05,2014,287,5,2.25,2500,13500,1,0,0,3,7,1850,650,1979,1979,98072,47.756,122.14,2300,9750,35,0,7.25,4800,12250
2.6e+05,2014,250,3,1,1690,13184,1,0,0,4,7,1690,0,1959,1959,98166,47.476,122.34,1130,13451,55,0,4,2820,15141
3.679e+05,2014,258,3,2.5,2420,4725,2,0,0,3,8,2420,0,2014,2014,98038,47.371,122.02,2370,4200,0,0,5.5,4790,6620
5e+05,2014,196,3,2.25,1710,4561,2,0,0,4,8,1710,0,1994,1994,98029,47.569,122,1810,4770,20,0,5.25,3520,6480
7.49e+05,2014,155,3,2.5,2670,10338,2,0,0,3,9,2670,0,1987,1987,98007,47.66,122.15,2670,8866,27,0,5.5,5340,11536
1.19e+06,2014,139,4,3,2240,6000,1,0,0,4,8,1270,970,1914,1914,98109,47.637,122.35,2240,4250,100,0,7,4480,6490
6.15e+05,2014,248,3,2,1860,42800,1,0,0,4,7,930,930,1983,1983,98075,47.59,122,1980,11250,31,0,5,3840,13110
6.2e+05,2015,400,3,2.25,2010,7495,1,0,0,4,8,1570,440,1979,1979,98027,47.561,122.08,2050,8402,36,0,5.25,4060,10412
3.15e+05,2015,425,4,2.25,2550,9736,1,0,0,4,8,2550,0,1967,1967,98002,47.319,122.21,1770,9686,48,0,6.25,4320,12236
2.8e+05,2015,447,3,1.75,1590,7280,1,0,0,3,7,1140,450,1974,1974,98058,47.429,122.15,1590,9634,41,0,4.75,3180,11224
2.5995e+05,2015,425,2,2,1070,649,2,0,0,3,9,720,350,2008,2008,98106,47.521,122.36,1070,928,7,0,4,2140,1998
1.994e+05,2014,223,2,1,880,4000,1,0,0,4,6,880,0,1916,1916,98106,47.533,122.35,1430,4000,98,0,3,2310,4880
5.59e+05,2015,437,2,2,1660,4500,1,0,0,3,8,1660,0,2003,2003,98053,47.709,122.03,1670,5580,12,0,4,3330,7240
4.25e+05,2015,437,3,1.5,1570,12412,1,0,3,3,8,1570,0,1954,1954,98166,47.438,122.35,2130,12412,61,0,4.5,3700,13982
6.63e+05,2015,477,4,2.5,3570,6246,2,0,0,3,7,3570,0,2005,2005,98075,47.593,122.01,2260,5231,10,0,6.5,5830,8801
9.15e+05,2014,198,3,2.75,3390,7000,1,0,3,4,8,1740,1650,1979,1979,98116,47.57,122.41,1770,6500,35,0,5.75,5160,9890
4.6995e+05,2014,280,5,2.5,2310,8303,1,0,0,3,7,1300,1010,1975,1975,98034,47.721,122.21,1930,8303,39,0,7.5,4240,10613
7.4e+05,2014,202,5,3.5,2720,11454,2,0,0,3,9,1830,890,1988,1988,98052,47.647,122.12,2920,11310,26,0,8.5,5640,14030
1.0475e+06,2014,221,3,2.25,2930,7005,3,0,2,3,9,2670,260,1999,1999,98117,47.676,122.4,2450,6460,15,0,5.25,5380,9390
4.275e+05,2015,450,3,1.75,1240,7200,1,0,0,5,7,1240,0,1942,1942,98136,47.514,122.39,1640,7200,73,0,4.75,2880,8440
5.75e+05,2014,215,3,2.5,2070,3599,2,0,0,3,8,2070,0,1999,1999,98033,47.668,122.17,2070,6844,15,0,5.5,4140,8914
2.12e+05,2014,264,3,1.75,1100,9750,1,0,0,4,6,1100,0,1967,1967,98023,47.295,122.36,1100,9900,47,0,4.75,2200,11000
6e+05,2015,431,4,3.5,3270,15160,1,0,2,3,8,1660,1610,1997,1997,98155,47.744,122.29,2790,15160,18,0,7.5,6060,18430
6.35e+05,2014,132,3,2.5,1570,1433,3,0,0,3,8,1570,0,2010,2010,98103,47.686,122.34,1570,2652,4,0,5.5,3140,4222
9.25e+05,2014,140,4,2.25,2260,41984,1,0,0,4,9,2260,0,1967,1967,98033,47.662,122.17,2650,37318,47,0,6.25,4910,39578
1.335e+06,2014,163,5,2.25,4200,5800,2,0,0,4,9,2910,1290,1906,1906,98112,47.628,122.31,3060,5800,108,0,7.25,7260,10000
1.51e+05,2014,148,2,1,720,4222,1,0,0,4,5,720,0,1942,1942,98056,47.496,122.19,860,4785,72,0,3,1580,5505
3.405e+05,2014,300,3,2.5,3070,5871,3,0,0,4,8,2510,560,1928,1928,98178,47.501,122.22,2220,4000,86,0,5.5,5290,7070
6.7998e+05,2015,467,4,2.5,3830,4644,2,0,0,3,8,2900,930,2004,2004,98065,47.538,121.88,3400,6163,11,0,6.5,7230,9993
2.54e+05,2015,485,3,1,1270,16800,1,0,0,4,7,1270,0,1957,1957,98188,47.46,122.28,1700,10200,58,0,4,2970,11470
5.08e+05,2014,230,2,1,820,5040,1,0,0,3,7,820,0,1953,1953,98199,47.65,122.39,1730,5760,61,0,3,2550,6580
5.95e+05,2015,415,3,2.5,2250,8300,2,0,0,3,8,2250,0,2003,2003,98125,47.717,122.31,1790,7626,12,0,5.5,4040,9876
3.28e+05,2015,480,4,3.25,3380,7500,2,0,3,3,7,2420,960,1990,1990,98198,47.409,122.33,1920,7500,25,0,7.25,5300,10880
3.6e+05,2014,352,4,2.5,1900,5889,2,0,0,3,7,1900,0,1992,1992,98038,47.349,122.03,1870,6405,22,0,6.5,3770,8305
2.9e+05,2014,263,4,2.25,1900,10950,1,0,0,4,7,1400,500,1959,1959,98032,47.358,122.28,1700,11850,55,0,6.25,3600,13750
4.0175e+05,2015,471,2,1.5,1070,1236,2,0,0,3,8,1000,70,2005,2005,98116,47.562,122.38,1170,1888,10,0,3.5,2240,2958
2.5e+05,2014,257,2,1.5,1200,5773,2,0,0,3,7,1200,0,1985,1985,98055,47.472,122.19,1530,4576,29,0,3.5,2730,5776
3.337e+05,2015,481,3,2.5,2230,5050,2,0,0,3,7,2230,0,2006,2006,98042,47.336,122.06,2260,5050,9,0,5.5,4490,7280
2.7e+05,2014,176,2,1,1780,81021,1,0,3,4,9,1780,0,1954,1954,98001,47.271,122.27,1780,26723,60,0,3,3560,28503
3.24e+05,2014,352,3,2.25,1550,4411,2,0,0,3,7,1550,0,2001,2001,98019,47.737,121.97,1620,4621,13,0,5.25,3170,6171
6.5e+05,2014,259,4,2.75,2640,6240,2,0,0,3,9,2640,0,2001,2001,98075,47.579,122.06,2640,5898,13,0,6.75,5280,8538
7.5e+05,2015,423,5,2.5,3240,9960,1,0,1,3,8,2020,1220,1958,1958,98008,47.586,122.11,2730,10400,57,0,7.5,5970,13640
3.13e+05,2014,303,3,1,1510,10369,1,0,0,4,7,1010,500,1968,1968,98059,47.481,122.1,1510,16057,46,0,4,3020,17567
7.05e+05,2015,439,3,2.5,1580,1321,2,0,2,3,8,1080,500,2014,2014,98107,47.669,122.4,1530,1357,1,0,5.5,3110,2937
3.8e+05,2014,263,4,1.75,2030,12518,1,0,0,3,8,1610,420,1950,1950,98125,47.728,122.3,1650,7872,64,0,5.75,3680,9902
6.3e+05,2014,297,4,1.75,1930,10210,1,0,2,3,8,1670,260,1941,1941,98125,47.708,122.28,2730,6600,73,0,5.75,4660,8530
5.65e+05,2014,361,5,2.25,2130,4360,1,0,2,3,8,1240,890,1959,1959,98199,47.659,122.39,1830,5000,55,0,7.25,3960,7130
2.5e+05,2014,356,3,1.75,1780,35233,1,0,0,4,8,1420,360,1979,1979,98001,47.295,122.27,1950,17334,35,0,4.75,3730,19114
3.7e+05,2014,346,4,2.75,2200,5207,1,0,0,5,7,1120,1080,1951,1951,98133,47.74,122.34,1210,6008,63,0,6.75,3410,8208
1.95e+05,2015,458,3,1,1310,9554,1,0,0,3,7,960,350,1962,1962,98001,47.295,122.28,1310,9845,53,0,4,2620,11155
9.15e+05,2014,235,3,2.5,3140,9808,2,0,0,3,9,2500,640,2001,2001,98052,47.638,122.1,2370,10014,13,0,5.5,5510,13154
5.6e+05,2014,177,4,2.5,2710,6583,2,0,0,3,9,2710,0,2003,2003,98059,47.492,122.14,2710,6583,11,0,6.5,5420,9293
6.9e+05,2014,320,4,2,2230,5000,1,0,0,4,7,1510,720,1922,1922,98144,47.577,122.29,2140,5000,92,0,6,4370,7230
1.35e+05,2014,332,3,1,1520,8450,1,0,0,2,6,1120,400,1961,1961,98023,47.328,122.34,1320,8450,53,0,4,2840,9970
4.9995e+05,2014,154,3,2.5,1520,2208,2,0,0,3,8,1040,480,2007,2007,98119,47.642,122.37,1610,1618,7,0,5.5,3130,3138
2.64e+05,2014,149,3,1.5,1470,14821,1,0,0,4,7,1470,0,1958,1958,98042,47.366,122.15,1760,15370,56,0,4.5,3230,16840
5.87e+05,2014,151,4,2.5,2550,6256,2,0,0,3,9,2550,0,1992,1992,98072,47.774,122.17,2460,8256,22,0,6.5,5010,10806
1.9e+05,2014,211,2,2.5,1100,1737,2,0,0,3,8,1100,0,2006,2006,98055,47.45,122.19,1610,2563,8,0,4.5,2710,3663
7.5e+05,2015,429,3,2,1760,5488,1,0,0,3,7,1540,220,1927,1927,98119,47.648,122.37,1760,5943,88,0,5,3520,7703
4e+05,2014,324,3,1.5,1510,7642,1,0,0,3,7,1510,0,1959,1959,98008,47.598,122.12,2180,8357,55,0,4.5,3690,9867
2.6e+05,2014,313,2,1.5,980,1296,2,0,0,3,7,840,140,2001,2001,98133,47.708,122.34,1100,1228,13,0,3.5,2080,2208
2.4995e+05,2015,443,3,1.5,1450,6875,1,0,0,4,7,1450,0,1961,1961,98198,47.42,122.32,1270,8000,54,0,4.5,2720,9450
4.95e+05,2014,221,2,1,970,4284,1,0,0,3,7,970,0,1905,1905,98103,47.667,122.33,2050,4284,109,0,3,3020,5254
3.1e+05,2014,231,3,2,2070,9195,1,0,0,3,8,1220,850,1982,1982,98074,47.649,122.06,2080,9551,32,0,5,4150,11621
6e+05,2014,291,4,2.5,2360,13500,1,0,0,4,8,1780,580,1973,1973,98052,47.632,122.1,2780,12400,41,0,6.5,5140,14760
4.87e+05,2014,189,4,2.5,2540,5001,2,0,0,3,9,2540,0,2005,2005,98108,47.542,122.3,2360,6834,9,0,6.5,4900,9374
6.59e+05,2014,160,3,2.5,2510,6320,2,0,0,3,9,2510,0,1996,1996,98075,47.587,122.03,2518,5819,18,0,5.5,5028,8329
7.99e+05,2014,155,4,3.5,3500,8547,2,0,0,3,9,2500,1000,1994,1994,98006,47.561,122.13,2350,10270,20,0,7.5,5850,13770
8.51e+05,2014,129,3,2.5,3560,1.0729e+05,2,0,0,3,10,3560,0,1987,1987,98053,47.665,122.05,3660,89298,27,0,5.5,7220,92858
4.8e+05,2014,189,5,2.75,2550,7725,1,0,0,5,8,1390,1160,1967,1967,98056,47.539,122.17,2450,7725,47,0,7.75,5000,10275
2.55e+05,2014,155,3,2.5,1610,6176,2,0,0,3,7,1610,0,1994,1994,98030,47.366,122.17,1680,7414,20,0,5.5,3290,9024
1.8e+05,2014,333,5,1,1460,11726,1,0,0,3,6,1290,170,1936,1936,98146,47.504,122.36,1460,10450,78,0,6,2920,11910
8.4995e+05,2015,445,3,3,2990,9773,2,0,0,4,8,2990,0,1973,1973,98005,47.634,122.17,2230,11553,42,0,6,5220,14543
4.75e+05,2015,399,3,1.75,2490,7210,1,0,0,3,7,1290,1200,1972,1972,98034,47.726,122.2,1610,7210,43,0,4.75,4100,9700
3.55e+05,2014,339,3,2.25,1410,1332,2,0,0,3,7,1290,120,2004,2004,98027,47.535,122.07,1445,1290,10,0,5.25,2855,2700
3.45e+05,2014,245,2,2.25,860,696,2,0,0,3,9,860,0,2009,2009,98118,47.566,122.29,1100,3000,5,0,4.25,1960,3860
6.35e+05,2015,368,3,3,2230,1407,2,0,0,3,8,1850,380,2014,2014,98027,47.545,122.02,2290,1407,1,0,6,4520,3637
4.9992e+05,2015,467,3,2,1460,3000,1,0,0,4,7,940,520,1990,1990,98117,47.682,122.36,1460,3000,25,0,5,2920,4460
8.5e+05,2014,208,5,3,3900,5250,1,0,1,5,8,2620,1280,1931,1931,98116,47.558,122.39,1950,5700,83,0,8,5850,9600
7e+05,2014,175,4,2.5,2770,5686,2,0,0,3,9,2770,0,2004,2004,98075,47.6,121.97,2910,5000,10,0,6.5,5680,7770
3.56e+05,2015,388,3,1.5,1680,8712,1,0,0,3,8,1680,0,1964,1964,98059,47.481,122.15,1850,8797,51,0,4.5,3530,10477
7.41e+05,2014,305,4,2.75,2070,10125,1,0,0,3,7,1390,680,1962,1962,98040,47.57,122.22,1850,10125,52,0,6.75,3920,12195
3.15e+05,2014,168,3,2.5,1730,6368,2,0,0,3,7,1730,0,1993,1993,98038,47.35,122.03,1780,6597,21,0,5.5,3510,8327
4.4e+05,2014,292,3,2.25,1760,10835,1,0,0,4,8,1290,470,1976,1976,98027,47.522,122.05,2050,10488,38,0,5.25,3810,12248
6.4e+05,2014,162,5,3.5,3690,11928,2,0,0,3,9,2540,1150,2006,2006,98074,47.611,122.06,2640,11928,8,0,8.5,6330,15618
1.3095e+06,2014,169,4,4.5,4750,13912,2,0,2,3,10,3600,1150,2005,2005,98118,47.533,122.27,3600,22124,9,0,8.5,8350,26874
6.3e+05,2014,348,5,1,3020,4800,2,0,0,3,7,3020,0,1901,1901,98122,47.602,122.31,1350,1307,113,0,6,4370,4327
3.12e+06,2014,324,3,3.5,4490,56609,2,1,4,3,12,4490,0,1993,1993,98034,47.7,122.24,2710,51330,21,0,6.5,7200,55820
4.991e+05,2014,208,3,1.5,1620,5108,1,0,0,3,7,1620,0,1954,1954,98115,47.698,122.32,1380,6130,60,0,4.5,3000,7750
4.19e+05,2014,163,4,2.5,2690,7947,2,0,0,3,8,2690,0,1993,1993,98058,47.425,122.15,2160,8328,21,0,6.5,4850,11018
2.9e+05,2015,447,3,2,1490,9285,1,0,0,3,8,1490,0,1995,1995,98092,47.325,122.17,2040,6681,20,0,5,3530,8171
4.58e+05,2014,334,3,4,1390,1569,2,0,0,3,9,1150,240,2006,2006,98105,47.671,122.27,1620,1855,8,0,7,3010,3245
5.75e+05,2014,182,4,2,1660,4800,1,0,0,3,7,1660,0,1922,1922,98103,47.656,122.34,1660,4800,92,0,6,3320,6460
8.6e+05,2015,439,3,2.5,2370,55321,3,0,0,4,8,2370,0,1982,1982,98074,47.615,122.06,2590,41553,33,0,5.5,4960,43923
2.85e+05,2014,160,2,2,1651,18200,1,0,0,3,6,1651,0,1946,1946,98070,47.462,122.46,1510,89595,68,0,4,3161,91246
7.4564e+05,2014,174,4,2.5,2440,4850,2,0,0,3,8,2440,0,2013,2013,98052,47.704,122.11,2970,5450,1,0,6.5,5410,7890
6.125e+05,2014,122,4,2.5,2730,12261,2,0,0,3,9,2730,0,1991,1991,98011,47.742,122.2,2730,10872,23,0,6.5,5460,13602
6.05e+05,2015,444,3,2.75,2450,5750,2,0,0,3,9,2450,0,2013,2013,98065,47.544,121.86,3200,8036,2,0,5.75,5650,10486
2.4e+05,2014,183,3,1.75,1570,8750,1,0,0,3,7,1570,0,1960,1960,98148,47.443,122.33,1890,8825,54,0,4.75,3460,10395
2.62e+05,2014,230,3,2.5,1680,10300,2,0,0,4,7,1680,0,1994,1994,98010,47.314,122,1680,9849,20,0,5.5,3360,11529
5.9e+05,2015,487,4,3.5,3450,6873,2,0,0,3,10,2750,700,2004,2004,98058,47.459,122.12,3450,6873,11,0,7.5,6900,10323
3.13e+05,2014,122,3,1.5,1340,7912,1,0,0,3,7,1340,0,1955,1955,98133,47.766,122.34,1480,7940,59,0,4.5,2820,9280
2.2995e+05,2014,167,3,2,1410,7466,1,0,0,3,7,1410,0,1983,1983,98058,47.427,122.15,1410,7610,31,0,5,2820,9020
2.98e+05,2015,484,3,1.75,1620,12825,1,0,0,3,8,1340,280,1962,1962,98003,47.332,122.32,2076,11200,53,0,4.75,3696,12820
5.5e+05,2014,286,4,1.75,2410,8447,2,0,3,4,8,2060,350,1936,1980,98074,47.65,122.09,2520,14789,78,1,5.75,4930,17199
5.7e+05,2014,319,3,2.25,2180,9246,2,0,0,3,9,2180,0,1984,1984,98074,47.621,122.03,2300,9298,30,0,5.25,4480,11478
6.35e+05,2015,453,4,3,2100,3800,2,0,0,3,8,2100,0,1972,1972,98115,47.681,122.29,1320,3800,43,0,7,3420,5900
3.15e+05,2015,399,3,2.25,1530,7906,1,0,0,3,7,1150,380,1980,1980,98058,47.442,122.14,1460,7875,35,0,5.25,2990,9405
3.85e+05,2014,169,3,1.75,2310,11200,1,0,0,4,8,1630,680,1978,1978,98030,47.364,122.21,2350,13300,36,0,4.75,4660,15610
7.97e+05,2015,472,4,2.75,2650,8610,2,0,0,3,8,2650,0,1959,2007,98008,47.615,122.12,1680,8316,56,1,6.75,4330,10966
8.4e+05,2015,457,3,1.75,2020,4800,1,0,0,4,8,1090,930,1926,1926,98115,47.673,122.29,1680,4800,89,0,4.75,3700,6820
2.589e+05,2014,331,3,2.25,1400,10436,1,0,0,4,7,1040,360,1985,1985,98058,47.426,122.14,1860,9318,29,0,5.25,3260,10718
2.77e+05,2014,188,2,1,770,8149,1,0,0,3,6,770,0,1948,1948,98155,47.746,122.3,1160,8149,66,0,3,1930,8919
4.05e+05,2014,174,3,2.75,1310,7300,1,0,0,3,7,1310,0,1957,1957,98008,47.602,122.12,1310,7030,57,0,5.75,2620,8340
4.97e+05,2014,293,3,2.25,1450,1387,3,0,0,3,8,1450,0,2000,2000,98115,47.676,122.3,1450,1429,14,0,5.25,2900,2879
3.6e+05,2015,395,2,1.75,1340,1050,3,0,0,3,8,1340,0,2009,2009,98133,47.705,122.34,1340,1090,6,0,3.75,2680,2430
7.75e+05,2014,324,4,2.5,3060,6826,2,0,0,3,9,3060,0,2004,2004,98052,47.701,122.11,3110,6932,10,0,6.5,6170,9992
9.75e+05,2014,191,5,4.5,4300,12250,2,0,0,3,10,4300,0,2004,2004,98029,47.556,122.03,3950,12250,10,0,9.5,8250,16550
7e+05,2015,487,4,2,2490,4700,1,0,0,4,7,1690,800,1952,1952,98136,47.525,122.39,2240,5000,63,0,6,4730,7490
3.85e+05,2014,214,3,2.25,1650,7800,1,0,0,3,7,1260,390,1969,1969,98011,47.738,122.2,1760,8268,45,0,5.25,3410,9918
4.29e+05,2014,342,4,2.5,2650,9301,2,0,0,3,9,2650,0,2001,2001,98001,47.348,122.27,2730,8688,13,0,6.5,5380,11338
5.67e+05,2014,349,3,2.5,2070,10908,2,0,0,3,8,2070,0,1986,1986,98029,47.566,122.02,2220,10975,28,0,5.5,4290,13045
6e+05,2014,183,5,2.25,3000,13899,2,0,0,4,8,3000,0,1975,1975,98052,47.637,122.11,2270,10763,39,0,7.25,5270,13763
3.85e+05,2014,160,4,1.75,1720,8750,1,0,0,3,7,860,860,1971,1971,98034,47.726,122.21,1790,8750,43,0,5.75,3510,10470
4.75e+05,2015,381,3,2.5,1640,5097,2,0,0,3,7,1640,0,1969,1969,98155,47.752,122.28,1880,6000,46,0,5.5,3520,7640
3.01e+05,2015,457,3,2.5,2420,4750,2,0,0,3,8,2420,0,2003,2003,98042,47.366,122.12,2690,4750,12,0,5.5,5110,7170
2.25e+05,2014,338,3,2,1100,5200,1,0,0,3,6,1100,0,1969,2014,98042,47.361,122.08,1050,5330,45,1,5,2150,6430
4.52e+05,2014,299,2,2.5,1260,1131,3,0,0,3,8,1260,0,2006,2006,98107,47.672,122.38,1490,2500,8,0,4.5,2750,3760
4.75e+05,2014,139,4,2.5,3060,10043,1,0,0,4,8,1700,1360,1968,1968,98133,47.739,122.34,1630,8296,46,0,6.5,4690,11356
1.93e+05,2014,294,3,1.5,1180,7000,1,0,0,4,7,1180,0,1977,1977,98023,47.296,122.37,1630,7500,37,0,4.5,2810,8680
8.86e+05,2015,438,3,2.25,2380,6000,2,0,0,5,9,1650,730,1931,1931,98199,47.647,122.39,2000,6000,84,0,5.25,4380,8380
7.99e+05,2015,471,4,1.5,1810,6583,1,0,0,3,7,1500,310,1968,1968,98133,47.727,122.35,860,8670,47,0,5.5,2670,10480
6.25e+05,2015,484,3,3,2780,6000,2,0,0,3,9,2780,0,2013,2013,98065,47.518,121.89,2850,6000,2,0,6,5630,8780
2.78e+05,2015,464,3,2,1230,7789,1,0,0,3,7,1230,0,1994,1994,98042,47.372,122.07,1470,8670,21,0,5,2700,9900
2.69e+05,2014,215,3,2,1210,7136,1,0,0,3,7,1210,0,2003,2003,98031,47.4,122.2,1210,5765,11,0,5,2420,6975
6.9e+05,2014,228,4,2.5,2780,4688,2,0,0,3,9,2780,0,2003,2003,98059,47.523,122.16,3000,6029,11,0,6.5,5780,8809
3.975e+05,2014,276,3,2.25,1350,980,2,0,0,3,8,1050,300,2007,2007,98144,47.6,122.31,1350,1245,7,0,5.25,2700,2595
3.55e+05,2014,353,3,2.25,1860,5028,2,0,0,3,8,1860,0,2012,2012,98019,47.732,121.98,2320,5465,2,0,5.25,4180,7325
2.467e+05,2014,354,3,2,1610,13309,1,0,0,4,7,1610,0,1967,1967,98042,47.34,122.13,1610,15725,47,0,5,3220,17335
2.22e+05,2014,291,3,1.75,1240,7560,1,0,0,3,8,1070,170,1967,1967,98003,47.333,122.3,1650,7560,47,0,4.75,2890,8800
3e+05,2014,168,3,1,910,7700,1,0,0,4,7,910,0,1971,1971,98034,47.73,122.24,1250,7700,43,0,4,2160,8610
7.45e+05,2015,432,4,2.75,2410,5650,1,0,0,5,8,2070,340,1909,1909,98116,47.565,122.39,1960,5650,106,0,6.75,4370,8060
2.16e+05,2014,324,3,1,1730,7950,1,0,0,4,7,1180,550,1961,1961,98198,47.364,122.31,1830,8890,53,0,4,3560,10620
8.19e+05,2014,224,3,1.75,1850,6000,1,0,0,3,8,1650,200,1913,1999,98199,47.653,122.4,1540,6000,101,1,4.75,3390,7850
9.8e+05,2014,128,5,2.5,3160,11470,1,0,0,4,9,1780,1380,1971,1971,98040,47.537,122.22,3260,11470,43,0,7.5,6420,14630
6.02e+05,2015,430,3,3.25,1460,1367,3,0,0,3,8,1460,0,2008,2008,98103,47.648,122.33,1310,1191,7,0,6.25,2770,2651
7.4e+05,2014,238,2,2.5,2170,8678,1,0,0,3,8,2170,0,2008,2008,98053,47.716,122.01,2170,5890,6,0,4.5,4340,8060
1.185e+06,2014,331,4,3.25,3960,12895,2,0,0,3,11,3960,0,2001,2001,98059,47.521,122.15,3870,12040,13,0,7.25,7830,16000
1.48e+05,2014,161,1,1,620,8261,1,0,0,3,5,620,0,1939,1939,98106,47.514,122.36,1180,8244,75,0,2,1800,8864
2.38e+05,2014,338,4,1.75,1650,6900,1,0,0,3,7,910,740,1978,1993,98002,47.28,122.21,1540,7645,36,1,5.75,3190,9295
6.85e+05,2014,126,4,2.5,3030,7864,2,0,0,3,9,3030,0,1999,1999,98074,47.608,122.02,2790,7034,15,0,6.5,5820,10064
2.89e+05,2014,202,3,1.75,1690,3449,1,0,0,3,7,1690,0,1987,1987,98055,47.472,122.19,1530,4093,27,0,4.75,3220,5783
3.133e+05,2014,228,2,1,970,4800,1,0,0,3,6,970,0,1911,1940,98116,47.575,122.41,1180,5900,103,1,3,2150,6870
7.7e+05,2014,231,3,2.5,2730,11380,2,0,0,3,10,2730,0,1995,1995,98075,47.58,122.06,2800,10070,19,0,5.5,5530,12800
4.2e+05,2015,375,3,2.5,1810,7210,1,0,0,5,7,1210,600,1968,1968,98059,47.507,122.16,1770,7210,47,0,5.5,3580,9020
4.485e+05,2015,488,3,2.5,2080,3920,2,0,0,3,8,2080,0,2010,2010,98118,47.541,122.29,2110,3710,5,0,5.5,4190,5790
3.19e+05,2014,266,3,2.25,1800,9597,1,0,2,3,7,1200,600,1963,1963,98188,47.452,122.27,1700,13502,51,0,5.25,3500,15302
6.67e+05,2014,331,3,1,1400,1581,1,0,0,5,8,1400,0,1909,1909,98112,47.622,122.31,1860,3861,105,0,4,3260,5261
4.5e+05,2014,229,2,1.75,1250,2890,1,0,0,4,7,790,460,1920,1920,98103,47.679,122.35,1500,3225,94,0,3.75,2750,4475
7.975e+05,2015,471,4,2.5,3270,8223,2,0,0,3,10,3270,0,1998,1998,98075,47.602,122.07,3460,8872,17,0,6.5,6730,12142
4.83e+05,2014,298,2,1.75,1400,4720,1,0,0,4,7,820,580,1927,1927,98116,47.571,122.39,1330,6786,87,0,3.75,2730,8186
5.2225e+05,2014,198,4,2.5,2340,41600,1,0,0,3,8,1640,700,1977,1977,98077,47.747,122.08,2340,34960,37,0,6.5,4680,37300
7.5e+05,2015,386,5,3.75,3500,1.0149e+05,1,0,0,3,8,3500,0,1967,1990,98053,47.675,122.05,3250,38636,48,1,8.75,6750,42136
4.65e+05,2014,278,3,1,910,3880,1,0,0,3,7,780,130,1942,1942,98117,47.686,122.39,1220,3880,72,0,4,2130,4790
4.3e+05,2014,198,3,2.5,1400,7508,2,0,0,4,7,1400,0,1987,1987,98034,47.723,122.17,1710,7700,27,0,5.5,3110,9100
2.625e+05,2014,161,3,1.5,1160,8906,1,0,0,3,7,1160,0,1962,1962,98118,47.536,122.29,1160,8906,52,0,4.5,2320,10066
4.15e+05,2014,310,2,1,980,4108,1,0,0,3,7,980,0,1947,1947,98117,47.687,122.38,1500,4046,67,0,3,2480,5026
3.85e+05,2014,310,3,3.5,1370,1540,2,0,0,3,8,1100,270,2006,2006,98116,47.564,122.39,1370,915,8,0,6.5,2740,2285
4.9e+05,2015,466,3,2.5,2040,9622,2,0,0,3,8,2040,0,1995,1995,98045,47.483,121.8,2390,9868,20,0,5.5,4430,11908
5.28e+05,2015,465,5,1.75,2780,7786,1,0,0,3,8,1390,1390,1966,1966,98052,47.669,122.16,2130,7918,49,0,6.75,4910,10698
5.99e+05,2014,221,3,1.75,1650,1180,3,0,0,3,8,1650,0,2014,2014,98105,47.664,122.32,1720,1960,0,0,4.75,3370,3610
6.53e+05,2015,446,3,2.25,2770,57745,2,0,0,3,8,2770,0,1985,1985,98072,47.775,122.12,2720,46765,30,0,5.25,5490,49535
1.9e+05,2014,231,2,1,930,11450,1,0,0,3,6,930,0,1946,1946,98178,47.486,122.26,1150,11450,68,0,3,2080,12380
4e+05,2015,450,3,1.5,1140,1069,3,0,0,3,8,1140,0,2005,2005,98103,47.691,122.34,1230,1276,10,0,4.5,2370,2416
1.555e+06,2014,167,3,3.5,4360,6240,2,0,3,3,10,2960,1400,2008,2008,98103,47.679,122.35,1920,3910,6,0,6.5,6280,8270
4.4e+05,2014,143,4,2.5,2560,10400,1,0,0,4,7,1280,1280,1965,1965,98027,47.523,122.04,1740,11050,49,0,6.5,4300,13610
3.23e+05,2014,196,4,1.75,1310,9690,1,0,0,4,7,1310,0,1967,1967,98011,47.756,122.23,2280,9618,47,0,5.75,3590,10928
1.8375e+05,2015,446,3,2.5,1770,3451,2,0,0,3,7,1770,0,2004,2004,98055,47.432,122.2,1490,2138,11,0,5.5,3260,3908
3.59e+05,2014,259,4,1.5,1890,6052,1,0,0,4,7,1890,0,1955,1955,98125,47.706,122.3,1510,6072,59,0,5.5,3400,7962
2.05e+05,2014,128,2,1,720,5040,1,0,0,3,6,720,0,1955,1955,98106,47.527,122.36,1357,5120,59,0,3,2077,5840
5.15e+05,2014,284,4,3,1820,8261,1,0,0,3,7,1420,400,1969,1969,98034,47.72,122.22,1920,7961,45,0,7,3740,9781
6.605e+05,2015,478,4,2.25,2010,9603,1,0,0,3,8,1440,570,1986,1986,98027,47.534,122.05,2060,9793,29,0,6.25,4070,11803
9.15e+05,2014,238,5,2.5,2750,5589,1,0,0,5,9,1840,910,1910,1910,98112,47.636,122.3,1460,4250,104,0,7.5,4210,7000
2.895e+05,2014,224,3,1,960,6400,1,0,0,4,6,820,140,1944,1944,98178,47.496,122.24,1200,6600,70,0,4,2160,7560
4.5e+05,2014,221,3,1,1290,5440,1,0,0,4,6,790,500,1929,1929,98117,47.695,122.37,1220,5464,85,0,4,2510,6754
4.95e+05,2015,492,4,2.5,2400,11640,1,0,0,5,8,1800,600,1968,1968,98058,47.449,122.14,2440,10823,47,0,6.5,4840,13223
5.8e+05,2014,277,4,1.5,2430,4995,1,0,0,4,7,1730,700,1928,1928,98144,47.578,122.29,2240,5000,86,0,5.5,4670,7430
8e+05,2014,209,4,2.5,2930,5000,2,0,0,3,9,2760,170,2007,2007,98006,47.542,122.12,3230,5778,7,0,6.5,6160,8708
6.9e+05,2014,203,3,2.5,1300,5150,1,0,0,4,7,1300,0,1920,1920,98117,47.684,122.36,1400,4017,94,0,5.5,2700,5317
1.22e+06,2014,300,3,2.25,2640,7544,1,0,0,3,10,2640,0,1995,1995,98004,47.622,122.19,2650,7904,19,0,5.25,5290,10544
5.9999e+05,2014,175,3,2.25,2680,9162,1,0,0,3,8,1570,1110,1978,1978,98027,47.568,122.09,2480,8261,36,0,5.25,5160,10941
9.5e+05,2014,237,3,2.5,3080,8448,2,0,2,3,9,3080,0,2000,2000,98199,47.647,122.39,2500,6400,14,0,5.5,5580,9480
3.2e+05,2014,217,4,2.75,2640,7500,1,0,0,3,8,1620,1020,1967,1967,98023,47.313,122.37,1980,7875,47,0,6.75,4620,10515
4.1595e+05,2014,223,3,1.75,1150,7700,1,0,0,3,7,1150,0,1957,1957,98008,47.605,122.12,1650,8000,57,0,4.75,2800,9150
3.35e+05,2014,140,3,1,1060,10050,1,0,0,4,7,1060,0,1967,1967,98028,47.736,122.23,1570,9938,47,0,4,2630,10998
5e+05,2014,209,2,2,1250,3360,1,0,0,3,7,1250,0,1957,1957,98103,47.653,122.35,1250,3360,57,0,4,2500,4610
3e+05,2014,193,3,2.5,1870,3439,2,0,0,3,7,1870,0,2005,2005,98042,47.399,122.16,2190,4029,9,0,5.5,4060,5899
3.85e+05,2014,166,4,2.5,2960,5054,2,0,0,3,9,2960,0,2006,2006,98038,47.36,122.03,2960,5000,8,0,6.5,5920,7960
6.05e+05,2014,314,5,2.75,2910,13332,2,0,0,4,8,2910,0,1940,1991,98146,47.498,122.36,1760,8900,74,1,7.75,4670,11810
4.4e+05,2014,262,3,1.5,2260,5300,1,0,0,3,7,1200,1060,1940,1940,98103,47.676,122.35,1950,5000,74,0,4.5,4210,7260
6.075e+05,2015,403,4,2.5,2110,13939,1,0,0,3,8,1270,840,1978,1978,98008,47.643,122.11,2140,8882,37,0,6.5,4250,10992
2.075e+05,2015,373,3,1,1640,9750,1,0,0,3,7,1640,0,1968,1968,98042,47.326,122.14,1200,9750,47,0,4,2840,11390
3.175e+05,2015,432,6,1.75,2540,8400,1,0,0,3,8,1340,1200,1977,1977,98058,47.441,122.13,1900,7695,38,0,7.75,4440,10235
4.655e+05,2014,152,3,1.75,1890,7004,1,0,0,3,7,1290,600,1965,1965,98118,47.556,122.28,1440,5378,49,0,4.75,3330,7268
5.7555e+05,2014,138,4,2.5,2060,7475,1,0,0,3,8,1440,620,1985,1985,98052,47.727,122.11,2280,8396,29,0,6.5,4340,10456
4.4e+05,2014,314,4,2.5,2880,7386,2,0,0,4,9,2880,0,1987,1987,98058,47.44,122.15,2420,7663,27,0,6.5,5300,10543
3.2e+05,2014,269,2,1,710,5200,1,0,2,4,6,710,0,1942,1942,98126,47.538,122.37,1610,5200,72,0,3,2320,5910
7.165e+05,2014,128,4,2.5,3290,6465,2,0,0,3,9,3290,0,2002,2002,98075,47.598,121.98,3100,5929,12,0,6.5,6390,9219
3.99e+05,2014,299,3,3.25,1680,1478,2,0,0,3,8,1360,320,2009,2009,98126,47.567,122.37,1530,2753,5,0,6.25,3210,4433
1.9e+05,2014,320,3,1.75,1100,9452,1,0,0,3,6,1100,0,1942,1942,98146,47.486,122.34,1350,9452,72,0,4.75,2450,10552
4.51e+05,2014,136,3,1.75,1560,4049,1,0,2,3,7,1000,560,1926,1926,98126,47.567,122.38,1430,3738,88,0,4.75,2990,5298
2.05e+05,2014,191,3,1.5,1820,8585,1,0,0,4,7,1820,0,1962,1962,98055,47.448,122.21,1740,10088,52,0,4.5,3560,11908
1.068e+06,2014,169,5,3.5,3990,9938,2,0,0,3,11,3990,0,2001,2001,98059,47.52,122.16,3490,11734,13,0,8.5,7480,15724
5.2e+05,2014,183,4,3,2590,6160,2,0,0,3,8,2590,0,2014,2014,98059,47.478,122.12,2670,5600,0,0,7,5260,8190
4.0719e+05,2014,156,4,2,1880,14653,2,0,0,3,8,1880,0,1978,1978,98014,47.696,121.92,1750,14858,36,0,6,3630,16738
2.2e+05,2015,432,2,1,780,6000,1,0,0,5,6,780,0,1923,1923,98055,47.476,122.21,1080,6000,92,0,3,1860,6780
5.57e+05,2015,478,2,1.5,1450,3840,1,0,0,3,7,950,500,1947,1947,98117,47.684,122.38,1450,3840,68,0,3.5,2900,5290
9.334e+05,2014,194,3,2.5,3940,10360,2,0,0,3,9,3110,830,1992,1992,98052,47.647,122.12,2720,11941,22,0,5.5,6660,15881
5.279e+05,2015,447,3,2.5,2490,5928,2,0,2,3,8,2490,0,1998,1998,98065,47.538,121.87,2420,6381,17,0,5.5,4910,8871
4.9995e+05,2014,140,5,3.5,3200,43560,2,0,0,3,7,3200,0,1989,1989,98059,47.475,122.09,2730,43560,25,0,8.5,5930,46760
9.7e+05,2014,147,5,3,3480,15185,2,0,0,4,8,3480,0,1964,1964,98040,47.576,122.22,3030,14257,50,0,8,6510,17737
6.15e+05,2015,416,3,1.75,2660,7800,1,0,0,4,8,1330,1330,1951,1951,98117,47.699,122.38,1950,6240,64,0,4.75,4610,8900
7.34e+05,2014,263,4,2.75,3090,7650,2,0,2,3,8,2340,750,1959,1989,98042,47.362,122.16,2760,10370,55,1,6.75,5850,13460
2.23e+05,2014,182,3,2,1110,7231,1,0,0,4,7,1110,0,1991,1991,98031,47.404,122.19,1550,7245,23,0,5,2660,8355
4.5e+05,2015,487,3,1,1540,9028,1,0,0,4,6,1540,0,1968,1968,98033,47.67,122.18,1450,9028,47,0,4,2990,10568
2.79e+05,2015,403,3,1,1110,6060,1,0,0,3,6,1110,0,1949,1949,98166,47.471,122.35,1480,8100,66,0,4,2590,9210
5.1e+05,2014,158,4,2.25,2450,62290,2,0,0,3,8,2450,0,1976,1976,98077,47.76,122.07,2450,41181,38,0,6.25,4900,43631
6.4e+05,2014,341,3,2,1470,4640,1,0,0,4,7,1470,0,1926,1926,98199,47.64,122.39,1700,5000,88,0,5,3170,6470
5.4e+05,2015,447,3,1,1270,3840,1,0,0,3,7,1270,0,1926,1926,98103,47.69,122.36,1270,4175,89,0,4,2540,5445
2.69e+05,2014,258,1,1,1020,7920,1,0,0,3,7,1020,0,1947,1983,98106,47.538,122.36,1000,7168,67,1,2,2020,8188
4.43e+05,2014,317,3,1.75,1810,7950,1,0,0,4,7,1810,0,1968,1968,98008,47.624,122.12,1680,7725,46,0,4.75,3490,9535
5.75e+05,2014,139,4,2.5,2500,4945,2,0,0,3,9,2500,0,2013,2013,98065,47.519,121.89,2760,6000,1,0,6.5,5260,8500
5.43e+05,2014,209,3,2.5,1540,1256,3,0,0,3,8,1540,0,2004,2004,98103,47.65,122.35,1500,1350,10,0,5.5,3040,2890
3.45e+05,2015,431,3,1.75,1520,7439,1,0,0,4,7,1520,0,1969,1969,98055,47.457,122.21,1650,7500,46,0,4.75,3170,9020
1.5e+06,2015,423,5,3.5,3520,5400,2,0,0,3,9,2400,1120,2008,2008,98119,47.636,122.36,1360,3600,7,0,8.5,4880,7120
2.8e+05,2014,304,4,2.5,2050,7416,2,0,0,3,8,2050,0,1990,1990,98092,47.266,122.22,2050,7920,24,0,6.5,4100,9970
5.3e+05,2014,314,4,2.5,2590,7891,2,0,0,3,9,2590,0,2006,2006,98056,47.505,122.19,1400,7891,8,0,6.5,3990,10481
6.75e+05,2014,201,3,3.25,1720,1330,2,0,0,3,8,1030,690,2004,2004,98112,47.62,122.31,1720,1520,10,0,6.25,3440,3240
6.6995e+05,2014,300,5,2.5,2820,14062,2,0,0,4,7,2380,440,1960,1960,98034,47.708,122.22,1910,10392,54,0,7.5,4730,13212
5.34e+05,2014,215,4,2.25,2130,7210,1,0,0,5,7,1330,800,1965,1965,98008,47.629,122.12,1310,7896,49,0,6.25,3440,10026
2.74e+05,2014,352,3,2.5,1830,2517,2,0,0,3,8,1830,0,2005,2005,98055,47.45,122.19,1610,2762,9,0,5.5,3440,4592
8.75e+05,2014,174,4,2.5,3220,22588,2,0,0,3,10,3220,0,1996,1996,98077,47.731,122.06,3220,22922,18,0,6.5,6440,26142
4.792e+05,2014,210,3,2,1510,3750,1,0,0,4,7,1510,0,1928,1928,98116,47.574,122.38,1500,5000,86,0,5,3010,6510
3.5e+05,2014,143,3,1,1010,11244,1,0,0,4,7,1010,0,1947,1947,98155,47.747,122.32,1220,11242,67,0,4,2230,12252
6.05e+05,2015,443,3,2.5,1500,1119,3,0,2,3,7,1110,390,2008,2008,98109,47.633,122.35,1500,1057,7,0,5.5,3000,2557
6.13e+05,2015,487,3,1.5,1470,4480,1,0,0,4,7,1130,340,1918,1918,98105,47.669,122.29,2120,4480,97,0,4.5,3590,5950
1.11e+06,2015,472,3,4,4160,31796,2,0,0,3,11,4160,0,1989,1989,98053,47.663,122.02,4300,36192,26,0,7,8460,40352
2.25e+05,2014,251,2,1,720,4758,1,0,0,3,6,720,0,1947,1947,98126,47.518,122.38,990,4920,67,0,3,1710,5640
1.1747e+06,2014,197,6,3.5,4310,7760,2,0,0,3,10,3260,1050,2013,2013,98059,47.53,122.16,4620,10217,1,0,9.5,8930,14527
2.6995e+05,2014,317,3,1.5,1950,7560,1,0,2,4,7,1320,630,1975,1975,98022,47.198,122,1950,8941,39,0,4.5,3900,10891
3.37e+05,2014,290,4,2.5,2470,5100,2,0,0,3,8,2470,0,2005,2005,98038,47.362,122.04,2240,5123,9,0,6.5,4710,7593
4.39e+05,2015,381,4,2,1800,5465,1,0,0,3,7,900,900,1942,1942,98118,47.561,122.27,1400,5400,73,0,6,3200,7200
5.25e+05,2014,135,3,2.5,2700,7434,2,0,0,3,9,2700,0,1991,1991,98072,47.743,122.17,2660,8405,23,0,5.5,5360,11105
3e+05,2014,216,2,1.75,2120,6350,1,0,0,4,6,1440,680,1924,1924,98103,47.697,122.36,1590,6350,90,0,3.75,3710,8470
3.75e+05,2014,286,3,1,1200,5404,1,0,0,3,6,1200,0,1937,1937,98117,47.697,122.37,1200,5987,77,0,4,2400,7187
5.35e+05,2015,480,3,2.5,2390,6263,2,0,0,3,9,2390,0,2003,2003,98028,47.738,122.25,2390,11761,12,0,5.5,4780,14151
6.65e+05,2014,259,3,1,1260,24550,1,0,2,4,7,1260,0,1937,1937,98136,47.544,122.4,2500,12320,77,0,4,3760,13580
2.5e+05,2014,326,4,3,1800,2500,2,0,0,3,7,1800,0,2000,2000,98108,47.533,122.29,1830,6900,14,0,7,3630,8700
4.43e+05,2015,429,4,3,2620,35124,2,0,0,3,9,2620,0,1987,1987,98092,47.307,122.12,2920,35807,28,0,7,5540,38427
8.3e+05,2014,310,4,2.25,2180,11056,1,0,0,3,8,1370,810,1963,1963,98004,47.604,122.19,2090,8747,51,0,6.25,4270,10927
7.35e+05,2014,147,5,2.75,3390,5211,2,0,0,3,9,3390,0,2004,2004,98075,47.598,121.98,3210,5211,10,0,7.75,6600,8601
3.75e+05,2014,173,4,2.5,1870,7471,2,0,0,3,8,1870,0,1990,1990,98055,47.431,122.2,2020,8912,24,0,6.5,3890,10782
2.45e+05,2014,341,4,1.5,2010,7561,1,0,0,4,7,1890,120,1921,1921,98002,47.311,122.23,1420,6564,93,0,5.5,3430,8574
3.225e+05,2014,297,4,2.5,1940,7107,2,0,0,3,7,1940,0,2000,2000,98038,47.384,122.03,1850,5705,14,0,6.5,3790,7645
7.5e+05,2014,132,4,2.5,2980,4930,2,0,0,3,9,2890,90,2000,2000,98006,47.544,122.12,2980,6099,14,0,6.5,5960,9079
3.57e+05,2014,326,5,2.75,1540,4000,1,0,0,3,7,1140,400,1990,1990,98106,47.533,122.35,1630,4000,24,0,7.75,3170,5540
2.6495e+05,2014,170,4,1,1810,7500,1,0,0,2,7,1410,400,1959,1959,98168,47.493,122.33,1250,6255,55,0,5,3060,8065
3.35e+05,2014,127,3,2,1570,7200,1,0,0,4,7,1570,0,1952,1952,98155,47.75,122.31,1410,7434,62,0,5,2980,9004
4.8e+05,2015,465,3,1,1100,5700,1,0,0,3,7,1100,0,1950,1950,98115,47.688,122.28,1560,6588,65,0,4,2660,7688
3.272e+05,2014,210,2,2,1440,8425,1,0,0,4,6,1440,0,1942,1983,98168,47.483,122.3,1430,12037,72,1,4,2870,13477
1.89e+06,2014,331,4,4.25,4285,9345,2,0,0,3,10,4285,0,2013,2013,98004,47.633,122.2,1570,8994,1,0,8.25,5855,13279
4.55e+05,2014,317,4,1.75,1920,6000,1,0,0,4,7,960,960,1954,1954,98125,47.714,122.31,1850,7200,60,0,5.75,3770,9120
6.505e+05,2015,456,3,1.75,1740,4400,1,0,0,3,8,1740,0,1903,1903,98122,47.611,122.29,1740,4400,112,0,4.75,3480,6140
5.7e+05,2015,484,3,1.5,1300,7287,1,0,0,4,7,1300,0,1965,1965,98033,47.689,122.19,1300,9129,50,0,4.5,2600,10429
4.65e+05,2014,167,2,2.75,1430,1425,2,0,0,3,7,995,435,2006,2006,98112,47.621,122.3,1500,1749,8,0,4.75,2930,3179
3.925e+05,2014,154,4,2.5,2150,7303,2,0,0,3,8,2150,0,2005,2005,98056,47.511,122.18,1940,9569,9,0,6.5,4090,11719
2.1e+05,2014,237,3,1,1730,7210,1,0,0,3,7,1430,300,1963,1963,98001,47.34,122.28,1820,7210,51,0,4,3550,8940
7.596e+05,2014,154,4,1,1540,1.1543e+05,1,0,0,4,7,1540,0,1923,1923,98031,47.416,122.22,2027,23522,91,0,5,3567,25062
1.725e+05,2014,222,3,1,1040,7500,1,0,0,4,6,1040,0,1954,1954,98198,47.421,122.32,1270,8000,60,0,4,2310,9040
5.62e+05,2014,290,4,2.25,2170,7007,1,0,0,3,8,1540,630,1974,1974,98033,47.672,122.17,2040,7700,40,0,6.25,4210,9870
4.99e+05,2014,218,3,2.25,3010,9600,2,0,0,3,8,2410,600,1978,1978,98028,47.767,122.26,2620,9660,36,0,5.25,5630,12670
2.45e+06,2015,467,4,4.25,4250,6552,2,0,3,4,10,2870,1380,2008,2008,98144,47.575,122.28,3640,8841,7,0,8.25,7890,13091
5.14e+05,2015,451,3,1.5,1610,9964,1,0,0,3,7,1080,530,1977,1977,98052,47.668,122.14,1610,9964,38,0,4.5,3220,11574
4.58e+05,2014,150,5,2.5,3090,23265,1,0,0,3,8,2990,100,1957,1957,98011,47.771,122.21,2560,18773,57,0,7.5,5650,21863
1.3e+06,2014,203,4,3,4120,14021,2,0,0,3,11,4120,0,2005,2005,98075,47.599,122.03,4390,14684,9,0,7,8510,18804
4.98e+05,2015,460,3,2.5,1690,4088,2,0,0,3,7,1690,0,2004,2004,98053,47.678,122.03,1950,4088,11,0,5.5,3640,5778
5.9198e+05,2014,284,3,2.75,3230,5250,2,0,0,3,9,2680,550,2014,2014,98065,47.52,121.88,2710,5250,0,0,5.75,5940,8480
6.5e+05,2014,265,4,2.5,2820,15000,2,0,0,4,9,2820,0,1985,1985,98052,47.725,122.1,2440,15000,29,0,6.5,5260,17820
2.3495e+05,2014,317,3,2,1510,9153,1,0,0,4,7,1510,0,1974,1974,98001,47.341,122.27,1780,9286,40,0,5,3290,10796
8.1e+05,2014,255,4,3,3990,7838,2,0,0,3,9,3990,0,2003,2003,98053,47.686,122.05,3370,6814,11,0,7,7360,10804
1.19e+06,2015,481,3,1.5,2540,2700,2,0,0,4,8,1630,910,1922,1922,98119,47.637,122.36,2520,5400,93,0,4.5,5060,7940
2.15e+05,2014,287,3,2,1760,9282,1,0,0,5,7,1100,660,1947,1947,98001,47.341,122.29,1730,7500,67,0,5,3490,9260
3.2e+05,2014,169,4,2.5,3490,5000,2,0,0,3,8,3490,0,2003,2003,98042,47.377,122.13,2910,5025,11,0,6.5,6400,8515
4.65e+05,2014,229,3,1.75,1720,5280,1,0,0,4,8,900,820,1943,1943,98199,47.649,122.4,1600,6000,71,0,4.75,3320,7720
3.89e+05,2014,238,3,1.75,1400,10018,1,0,0,4,7,1400,0,1962,1962,98027,47.533,122.03,1350,9300,52,0,4.75,2750,10700
2.225e+05,2015,381,3,2,1450,9044,2,0,0,3,7,1450,0,1990,1990,98022,47.196,121.99,1450,9044,25,0,5,2900,10494
7.45e+05,2015,410,4,1.75,1990,8900,1,0,0,4,8,1990,0,1972,1972,98006,47.564,122.15,2620,8925,43,0,5.75,4610,10915
5.9378e+05,2015,481,3,1.75,1510,10450,1,0,0,4,7,1510,0,1964,1964,98052,47.684,122.11,1310,9450,51,0,4.75,2820,10960
1.95e+05,2014,299,4,1.5,2170,9948,2,0,0,3,7,2170,0,1952,1952,98148,47.426,122.33,1500,9750,62,0,5.5,3670,11920
1.127e+06,2014,183,4,2.5,3160,8281,2,0,0,4,9,3160,0,1995,1995,98033,47.67,122.19,3000,8281,19,0,6.5,6160,11441
3.25e+05,2014,232,2,1,900,8374,1,0,0,3,7,900,0,1984,1984,98034,47.728,122.22,1580,8965,30,0,3,2480,9865
1.31e+06,2015,507,4,2.25,3750,5000,2,0,0,5,8,2440,1310,1924,1924,98115,47.675,122.3,2170,4590,91,0,6.25,5920,8340
7.8335e+05,2015,479,4,2.5,3290,35001,2,0,0,3,10,3290,0,1991,1991,98077,47.723,122.04,4090,40371,24,0,6.5,7380,43661
7.32e+05,2014,332,3,2.5,1960,3060,2,0,0,3,8,1960,0,2010,2010,98117,47.676,122.39,1220,3060,4,0,5.5,3180,5020
4.7e+05,2014,196,3,1,1010,5000,1,0,0,3,7,1010,0,1952,1952,98107,47.675,122.39,1680,5000,62,0,4,2690,6010
2.75e+05,2014,341,3,2.25,1620,6415,2,0,0,4,7,1620,0,1989,1989,98038,47.358,122.04,1640,7253,25,0,5.25,3260,8873
3.45e+05,2014,345,3,2.25,2730,9388,1,0,0,3,7,1390,1340,1975,1975,98030,47.379,122.19,2255,5701,39,0,5.25,4985,8431
2.16e+05,2015,366,2,1,1130,12500,1,0,0,4,7,1130,0,1953,1953,98055,47.451,122.19,1270,10798,62,0,3,2400,11928
7.995e+05,2014,291,4,2.5,2760,5750,2,0,0,3,8,2760,0,1993,1993,98112,47.627,122.3,2760,5390,21,0,6.5,5520,8150
5.75e+05,2015,467,3,1,1530,2400,1,0,0,4,7,890,640,1928,1928,98103,47.654,122.35,1240,2400,87,0,4,2770,3930
2.79e+05,2014,259,3,2.5,1540,7280,1,0,0,3,7,1080,460,1974,1974,98003,47.31,122.32,1220,6440,40,0,5.5,2760,7980
7.8e+05,2015,425,3,2.5,2940,15875,2,0,0,3,10,2940,0,1994,1994,98075,47.595,122.02,2980,15875,21,0,5.5,5920,18815
5.55e+05,2015,366,3,3,2920,23085,1,0,2,3,7,1540,1380,1908,1908,98136,47.516,122.39,2270,18180,107,0,6,5190,21100
1.88e+06,2014,306,3,2.75,2620,17919,1,0,1,4,9,2620,0,1949,1949,98039,47.614,122.23,3400,14400,65,0,5.75,6020,17020
5.899e+05,2014,128,2,3,3160,66646,2,0,0,3,7,3160,0,1993,1993,98077,47.748,122.03,3140,38790,21,0,5,6300,41950
5.3e+05,2014,304,4,2.5,3250,4500,2,0,0,3,8,3250,0,2008,2008,98059,47.494,122.15,3030,4598,6,0,6.5,6280,7848
3.85e+05,2014,176,4,2.5,3200,22651,1,0,0,5,8,1610,1590,1970,1970,98031,47.393,122.18,2030,5500,44,0,6.5,5230,8700
3.49e+05,2015,465,4,2.5,2190,7294,2,0,0,3,8,2190,0,2003,2003,98023,47.292,122.36,2240,7379,12,0,6.5,4430,9569
2.7245e+05,2014,299,3,2.25,1780,7332,2,0,0,3,7,1780,0,1987,1987,98038,47.359,122.05,1510,7625,27,0,5.25,3290,9405
2.75e+05,2014,225,4,2.5,2180,11132,1,0,0,4,8,1620,560,1978,1978,98023,47.319,122.37,1950,13801,36,0,6.5,4130,15981
4.25e+05,2014,334,4,2,1490,5300,1,0,0,3,7,1110,380,1977,1977,98144,47.595,122.3,1330,1499,37,0,6,2820,2989
2.74e+05,2014,248,3,1.75,1440,7198,1,0,0,3,7,990,450,1981,1981,98055,47.433,122.19,1550,7156,33,0,4.75,2990,8596
3e+05,2014,242,3,2,1310,9855,1,0,0,3,7,1310,0,1962,1962,98034,47.73,122.24,1310,8370,52,0,5,2620,9680
6.59e+05,2015,439,4,2.25,2610,24931,2,0,0,3,8,2610,0,1983,1983,98075,47.577,122.05,2550,18306,32,0,6.25,5160,20916
3.335e+05,2014,361,3,1.75,1220,9732,1,0,0,3,7,1220,0,1965,1965,98011,47.774,122.21,1630,10007,49,0,4.75,2850,11227
4.75e+05,2014,346,4,2.25,2680,4673,2,0,0,3,7,2680,0,1999,1999,98011,47.754,122.22,2460,4645,15,0,6.25,5140,7325
4.4e+05,2014,271,2,1,1190,3400,1,0,0,4,7,990,200,1917,1917,98118,47.554,122.27,1180,4000,97,0,3,2370,5190
6.85e+05,2015,451,3,1.5,2230,8558,2,0,0,3,8,2230,0,1960,1960,98040,47.583,122.22,2200,8558,55,0,4.5,4430,10788
6.19e+05,2014,149,4,2,2300,3400,1,0,0,5,8,1550,750,1915,1915,98117,47.678,122.36,1670,4200,99,0,6,3970,6500
3.399e+05,2014,228,3,2.5,2420,7423,2,0,0,3,8,2420,0,1990,1990,98092,47.32,122.19,2260,7629,24,0,5.5,4680,10049
2.4e+05,2015,445,3,1.75,1420,6984,1,0,0,4,7,980,440,1980,1980,98030,47.375,122.18,1430,7875,35,0,4.75,2850,9295
6.5e+05,2015,443,3,2.5,2320,5284,2,0,0,3,8,2320,0,2004,2004,98075,47.591,122.02,2320,4383,11,0,5.5,4640,6703
2.7e+05,2014,286,3,2.25,2100,14027,2,0,0,3,8,2100,0,1979,1979,98042,47.383,122.1,2730,5999,35,0,5.25,4830,8099
2.45e+05,2015,390,2,1.5,690,1058,2,0,0,3,7,690,0,2005,2005,98103,47.695,122.34,690,1058,10,0,3.5,1380,1748
4.78e+05,2014,143,3,1,1280,2580,1,0,0,3,8,1280,0,1910,2014,98115,47.673,122.32,1410,3150,104,1,4,2690,4430
1.2725e+06,2015,452,4,1.75,2040,5000,2,0,0,4,9,2040,0,1921,1921,98102,47.628,122.31,3220,5600,94,0,5.75,5260,7640
4.84e+05,2014,258,1,0,690,23244,1,0,0,4,7,690,0,1948,1948,98053,47.643,121.95,1690,19290,66,0,1,2380,19980
4.5e+05,2015,492,3,1.75,1720,6960,1,0,0,3,7,1140,580,1978,1978,98052,47.697,122.13,1720,7280,37,0,4.75,3440,9000
5.075e+05,2014,140,3,2,2020,8118,1,0,0,3,7,1020,1000,1963,1963,98008,47.587,122.12,1670,8118,51,0,5,3690,10138
4.3e+05,2014,262,3,1.75,1440,4025,1,0,0,4,6,720,720,1917,1917,98126,47.567,122.38,1500,5750,97,0,4.75,2940,7190
3.55e+05,2015,438,4,2.5,2130,9268,2,0,0,4,8,2130,0,1985,1985,98092,47.262,122.22,2100,8400,30,0,6.5,4230,10530
2.3e+05,2015,425,3,1.75,1720,9125,1,0,0,4,7,1140,580,1981,1981,98092,47.317,122.18,1120,7506,34,0,4.75,2840,9226
4.58e+05,2014,140,1,2.25,2140,10350,1,0,0,3,7,1470,670,1976,1976,98072,47.735,122.17,1980,8400,38,0,3.25,4120,10540
3.35e+05,2015,393,3,1.75,1510,9720,1,0,0,3,7,1510,0,1948,1976,98028,47.773,122.26,1520,10037,67,1,4.75,3030,11547
1.6989e+06,2014,262,4,4.5,3860,15246,2,0,4,3,11,2940,920,2004,2004,98006,47.56,122.16,3750,14790,10,0,8.5,7610,18650
1.675e+06,2014,307,6,2.25,4910,6600,2,0,0,5,10,3580,1330,1910,1910,98102,47.646,122.32,3280,5500,104,0,8.25,8190,10410
7.9e+05,2015,431,2,1.5,1940,4400,1,0,0,3,7,970,970,1923,1923,98112,47.637,122.28,1480,3080,92,0,3.5,3420,5020
8.96e+05,2015,408,4,2.5,3560,46644,2,0,0,3,11,3560,0,1992,1992,98077,47.727,122.05,3520,50261,23,0,6.5,7080,53821
5.6e+05,2014,176,4,2.5,2480,16360,1,0,0,5,7,1510,970,1959,1959,98028,47.764,122.27,1770,15205,55,0,6.5,4250,17685
5.45e+05,2014,162,3,1,1510,5000,1,0,0,3,7,1510,0,1909,1909,98105,47.671,122.3,1680,4000,105,0,4,3190,5510
6.378e+05,2014,313,4,1.75,2250,4750,1,0,0,4,7,1420,830,1924,1924,98115,47.674,122.29,1930,4750,90,0,5.75,4180,7000
7e+05,2015,376,3,2.5,3110,11727,2,0,2,3,9,3110,0,2002,2002,98065,47.544,121.87,4240,13353,13,0,5.5,7350,16463
5.85e+05,2014,188,4,2.5,2630,6185,2,0,0,3,9,2630,0,1999,1999,98056,47.523,122.19,2720,6185,15,0,6.5,5350,8815
4.415e+05,2015,474,3,1.75,1510,7700,1,0,0,3,7,1510,0,1968,1968,98034,47.728,122.19,1440,7416,47,0,4.75,2950,8926
4.15e+05,2015,393,3,2.25,2180,11100,1,0,0,5,8,1700,480,1979,1979,98056,47.516,122.18,2350,11397,36,0,5.25,4530,13577
5.45e+05,2014,243,3,2.5,1280,1845,3,0,0,3,8,1280,0,2009,2009,98105,47.662,122.32,1450,1889,5,0,5.5,2730,3169
1.5228e+05,2014,210,1,1,1020,6871,1,0,0,3,6,1020,0,1937,1946,98146,47.505,122.34,1260,6933,77,1,2,2280,7953
7.0377e+05,2014,313,4,2.25,2550,12918,2,0,0,3,9,2550,0,1987,1987,98006,47.562,122.11,2550,11036,27,0,6.25,5100,13586
4.805e+05,2014,127,4,2.5,2180,11200,1,0,0,4,8,2180,0,1968,1968,98072,47.748,122.09,1790,11200,46,0,6.5,3970,13380
3e+05,2014,285,3,1.75,1700,8481,2,0,0,3,7,1700,0,1993,1993,98003,47.262,122.31,1830,6600,21,0,4.75,3530,8300
1.9995e+05,2014,196,3,2.75,2270,13590,1,0,0,4,6,1300,970,1948,1948,98022,47.21,122,1160,13545,66,0,5.75,3430,15815
5.55e+05,2014,194,3,1.75,1570,15500,1,0,0,4,7,1570,0,1968,1968,98052,47.692,122.12,1610,7500,46,0,4.75,3180,9070
7.3e+05,2014,147,3,2,1840,4750,1,0,0,5,7,1010,830,1951,1951,98117,47.686,122.39,1760,5510,63,0,5,3600,7350
6.248e+05,2014,189,3,2,2250,14274,1,0,0,4,8,1500,750,1964,1964,98040,47.576,122.22,2820,13813,50,0,5,5070,16063
3.875e+05,2015,453,4,1,1370,7140,2,0,0,3,6,1370,0,1942,1942,98146,47.512,122.38,1090,6300,73,0,5,2460,7670
5.25e+05,2014,297,3,1.5,1350,6000,1,0,2,3,7,900,450,1950,1950,98136,47.528,122.39,1730,6012,64,0,4.5,3080,7362
3.79e+05,2014,189,3,2.5,1530,2913,2,0,0,4,7,1530,0,1986,1986,98033,47.694,122.18,1370,3783,28,0,5.5,2900,5313
3.16e+05,2014,222,3,2.25,1900,7479,2,0,0,4,7,1900,0,1992,1992,98038,47.349,122.04,1520,6559,22,0,5.25,3420,8459
3.299e+05,2014,173,3,2.5,2242,4995,2,0,0,3,8,2242,0,2011,2011,98092,47.26,122.2,1798,4942,3,0,5.5,4040,7184
7.48e+05,2014,345,4,2.5,3220,8379,2,0,0,3,10,3220,0,2004,2004,98034,47.704,122.19,2720,7635,10,0,6.5,5940,10855
8e+05,2014,147,4,2.5,2680,7200,1,0,0,3,8,1380,1300,1952,2013,98033,47.684,122.19,1950,8520,62,1,6.5,4630,11200
2.43e+05,2014,248,3,1.75,1450,12125,1,0,0,4,7,1450,0,1981,1981,98001,47.358,122.28,1210,12125,33,0,4.75,2660,13575
1.6e+06,2015,388,3,2.5,2850,19593,1,1,4,3,10,1790,1060,1978,1978,98008,47.589,122.11,2850,18782,37,0,5.5,5700,21632
4.05e+05,2014,348,3,2,1440,7425,1,0,0,4,7,1440,0,1965,1965,98034,47.724,122.19,1800,8344,49,0,5,3240,9784
5.16e+05,2014,161,4,3.5,2550,8698,2,0,0,3,7,2550,0,2007,2007,98065,47.522,121.87,2430,5519,7,0,7.5,4980,8069
4.699e+05,2014,177,4,2.5,2990,8913,2,0,0,4,9,2990,0,1991,1991,98058,47.435,122.16,2740,8030,23,0,6.5,5730,11020
6.05e+05,2014,209,4,2.25,2510,31584,2,0,0,4,9,2510,0,1979,1979,98074,47.615,122.05,2510,39221,35,0,6.25,5020,41731
5.5365e+05,2014,128,2,2.5,1360,1349,2,0,0,3,8,1050,310,1997,1997,98112,47.625,122.29,1430,4400,17,0,4.5,2790,5760
2.5e+05,2014,318,3,3,2300,7701,1,0,0,3,7,2300,0,1960,1960,98056,47.51,122.18,1570,8116,54,0,6,3870,10416
4.12e+05,2015,452,4,1.5,1960,5000,1,0,0,3,7,980,980,1912,1912,98106,47.569,122.36,1300,5000,103,0,5.5,3260,6960
2.8e+05,2015,424,3,2,1280,7633,1,0,0,3,7,1280,0,1991,1991,98038,47.388,122.05,1450,6783,24,0,5,2730,8063
1.2e+06,2015,458,4,3,2150,8119,2,0,0,3,8,2150,0,1953,2004,98039,47.633,122.24,1590,8119,62,1,7,3740,10269
6.27e+05,2014,125,4,2.25,1990,7712,1,0,0,3,8,1210,780,1973,1973,98027,47.569,122.09,1720,7393,41,0,6.25,3710,9383
4.95e+05,2014,291,2,2.25,1160,1010,2,0,0,3,8,1000,160,2006,2006,98112,47.621,122.3,1200,1170,8,0,4.25,2360,2330
8.699e+05,2014,229,6,4.5,2750,4400,2,0,0,3,8,1770,980,1987,1987,98103,47.688,122.33,1860,4400,27,0,10.5,4610,7150
6.65e+05,2015,473,4,2.25,2340,5300,1,0,0,5,8,1700,640,1963,1963,98008,47.62,122.11,1890,8250,52,0,6.25,4230,10590
2.65e+05,2014,284,3,1,1010,14948,1,0,0,5,6,1010,0,1969,1969,98059,47.477,122.14,1510,9600,45,0,4,2520,10610
6e+05,2015,466,4,2.75,3110,11225,2,0,0,3,8,3110,0,2012,2012,98059,47.486,122.14,2610,8535,3,0,6.75,5720,11645
4.289e+05,2015,429,4,2.5,2820,5056,2,0,0,3,9,2820,0,2006,2006,98038,47.359,122.04,2820,5150,9,0,6.5,5640,7970
7.75e+05,2015,413,4,2.5,2040,5000,1,0,0,5,7,1180,860,1924,1924,98117,47.679,122.36,1540,5000,91,0,6.5,3580,7040
9.4e+05,2014,209,4,2.5,3160,39960,1,0,0,3,10,3160,0,1980,1980,98005,47.642,122.16,3900,36444,34,0,6.5,7060,39604
3e+05,2014,218,2,1.5,1150,3927,2,0,0,3,7,1150,0,1982,1982,98034,47.725,122.16,1400,3425,32,0,3.5,2550,4575
2.6e+05,2014,129,3,2.5,1420,14850,1,0,0,4,7,1020,400,1963,1963,98032,47.366,122.29,2060,8800,51,0,5.5,3480,10220
2.99e+05,2015,456,3,1.75,1910,17003,1,0,0,4,8,1910,0,1963,1963,98001,47.309,122.28,1820,14806,52,0,4.75,3730,16716
8.5845e+05,2014,324,5,2.75,3460,7977,2,0,0,3,9,3460,0,2011,2011,98074,47.591,122.06,3390,6630,3,0,7.75,6850,10090
9.4995e+05,2014,255,4,3.75,4120,8258,2,0,0,3,10,4120,0,2012,2012,98075,47.587,122.06,3730,8332,2,0,7.75,7850,12452
1.015e+06,2014,183,3,3.25,3620,4000,2,0,0,3,10,2730,890,2005,2005,98199,47.639,122.4,1910,5000,9,0,6.25,5530,8620
2.9e+05,2015,383,2,1,1250,12507,1,0,0,5,7,1250,0,1958,1958,98056,47.497,122.18,1250,12498,57,0,3,2500,13748
3.2e+05,2014,187,3,1.75,2220,11646,1,0,0,3,7,1270,950,1950,1950,98028,47.776,122.27,1490,10003,64,0,4.75,3710,12223
3.55e+05,2014,304,4,1.75,2160,7417,1,0,0,4,7,1360,800,1983,1983,98056,47.512,122.18,1880,8022,31,0,5.75,4040,10182
3.5e+05,2014,196,3,1.75,1970,10800,1,0,0,4,7,1300,670,1979,1979,98056,47.511,122.17,1970,8768,35,0,4.75,3940,10738
3.12e+05,2015,385,3,2.5,1780,4077,2,0,0,3,8,1780,0,2011,2011,98038,47.357,122.06,1970,4077,4,0,5.5,3750,5857
8.08e+05,2014,214,4,2.5,3480,6262,2,0,0,3,9,3480,0,2003,2003,98053,47.686,122.05,3490,6629,11,0,6.5,6970,10109
5.75e+05,2014,162,2,1,1510,4032,1,0,0,3,8,1310,200,1935,1935,98199,47.637,122.39,1700,4042,79,0,3,3210,5552
6.035e+05,2015,447,3,1.75,2140,7280,1,0,0,3,7,1070,1070,1910,1910,98117,47.699,122.38,2280,8400,105,0,4.75,4420,10540
6.2e+05,2014,202,3,2.25,2190,45738,1,0,0,3,8,2190,0,1990,1990,98052,47.711,122.12,2970,4496,24,0,5.25,5160,6686
5.33e+05,2015,415,4,2.5,2590,6394,2,0,0,3,8,2590,0,2003,2003,98028,47.76,122.23,2500,5328,12,0,6.5,5090,7918
2.955e+05,2014,258,3,2.5,1410,1332,2,0,0,3,7,960,450,2014,2014,98108,47.568,122.31,1410,1343,0,0,5.5,2820,2753
5.89e+05,2014,318,3,1.5,1390,5040,1,0,0,3,7,1090,300,1947,1947,98105,47.661,122.28,1910,4800,67,0,4.5,3300,6190
2.575e+05,2014,279,3,1,1690,13825,1,0,0,3,7,1210,480,1955,1955,98148,47.426,122.32,1190,9450,59,0,4,2880,11140
1.875e+06,2014,183,4,3.25,3930,10929,2,0,0,3,10,3930,0,2006,2006,98004,47.626,122.19,1780,9999,8,0,7.25,5710,13929
1.9995e+05,2014,152,3,1,1010,7245,1,0,0,3,7,1010,0,1969,1969,98003,47.334,122.31,1300,8236,45,0,4,2310,9246
2.3e+05,2015,445,3,1,1250,9035,1,0,0,4,7,1250,0,1970,1970,98003,47.275,122.3,1350,10425,45,0,4,2600,11675
3.3e+05,2014,335,4,2.5,2980,5674,2,0,0,3,8,2980,0,2003,2003,98023,47.277,122.35,2610,5495,11,0,6.5,5590,8475
6.13e+05,2014,153,5,2.5,2070,12000,1,0,0,4,7,1340,730,1967,1967,98008,47.626,122.1,2090,12000,47,0,7.5,4160,14070
2.86e+05,2015,416,3,2.5,1800,3980,2,0,0,3,7,1800,0,2006,2006,98042,47.401,122.16,2580,4307,9,0,5.5,4380,6107
2.9e+05,2015,476,3,2.5,1580,6860,2,0,0,3,7,1580,0,1995,1995,98055,47.445,122.19,1580,7050,20,0,5.5,3160,8630
9.475e+05,2014,132,3,2.75,2980,27144,1,1,2,5,8,2180,800,1917,1917,98166,47.452,122.38,1890,12514,97,0,5.75,4870,15494
6.1e+05,2015,453,3,2.5,1300,1331,3,0,0,3,8,1300,0,2007,2007,98103,47.661,122.35,1450,5270,8,0,5.5,2750,6570
5.5e+05,2014,252,4,1.75,2030,5688,2,0,4,4,9,1730,300,1939,1939,98146,47.507,122.39,2320,11107,75,0,5.75,4350,13137
8.9889e+05,2015,484,3,2.5,2080,3729,2,0,0,3,9,2080,0,1996,1996,98033,47.673,122.2,2080,4000,19,0,5.5,4160,6080
1.3e+06,2015,422,5,2.5,4170,33310,2,0,0,4,11,4170,0,1991,1991,98006,47.545,122.13,4670,37960,24,0,7.5,8840,42130
5.25e+05,2015,438,4,1.75,1570,16697,1,0,2,3,7,1030,540,1981,1981,98052,47.671,122.14,1560,9698,34,0,5.75,3130,11268
3.6e+05,2014,187,3,1.5,1800,22000,2,0,0,3,8,1800,0,1931,1931,98168,47.489,122.29,1440,16640,83,0,4.5,3240,18440
3.05e+05,2015,403,3,2,1430,12430,1,0,0,4,7,1430,0,1957,1957,98056,47.49,122.18,1200,8250,58,0,5,2630,9680
3.249e+05,2015,466,3,2.25,2080,9740,2,0,0,3,8,2080,0,1988,1988,98092,47.261,122.22,2080,8705,27,0,5.25,4160,10785
2.5e+05,2014,332,3,2,1470,2781,2,0,0,3,6,1470,0,2003,2003,98038,47.349,122.02,1360,3008,11,0,5,2830,4478
2.65e+05,2015,485,3,1.75,1420,8126,1,0,0,3,8,1420,0,1991,1991,98031,47.387,122.19,1730,7954,24,0,4.75,3150,9374
3e+05,2014,284,4,2.5,1914,3272,2,0,0,3,8,1914,0,2009,2009,98055,47.43,122.19,1714,3250,5,0,6.5,3628,5164
7.475e+05,2014,263,4,2.5,2810,11902,2,0,0,4,9,2810,0,1993,1993,98059,47.53,122.14,2990,10754,21,0,6.5,5800,13564
1.45e+06,2015,445,4,3.5,3720,8301,2,0,0,3,10,2880,840,2008,2008,98004,47.589,122.2,2080,9676,7,0,7.5,5800,13396
3.27e+05,2014,152,3,1.5,1320,13200,1,0,0,3,7,1320,0,1970,1970,98059,47.501,122.14,1730,13200,44,0,4.5,3050,14520
2.585e+05,2014,348,3,2.5,1800,9000,2,0,0,3,7,1800,0,1983,1983,98003,47.319,122.33,1670,8486,31,0,5.5,3470,10286
8.15e+05,2014,148,4,2.25,2000,3800,2,0,0,3,8,2000,0,2001,2001,98115,47.685,122.31,1610,3800,13,0,6.25,3610,5800
2.725e+05,2014,153,3,2,1410,7622,1,0,0,4,7,1410,0,1983,1983,98058,47.427,122.15,1830,8330,31,0,5,3240,9740
1e+06,2015,380,3,2.5,2044,5610,2,0,0,4,9,2044,0,1996,1996,98033,47.679,122.21,2440,5610,19,0,5.5,4484,7654
4.25e+05,2014,159,2,1,910,4635,1,0,0,4,6,910,0,1905,1905,98107,47.675,122.39,1740,5000,109,0,3,2650,5910
3.65e+05,2015,446,3,1.75,2080,7800,1,0,0,5,7,1220,860,1955,1955,98166,47.454,122.36,1770,7860,60,0,4.75,3850,9940
4.3e+05,2014,122,4,1.5,1920,10000,1,0,0,4,7,1070,850,1954,1954,98006,47.572,122.13,1450,10836,60,0,5.5,3370,12756
1.03e+06,2015,414,4,3.5,2730,5607,1,0,0,5,9,1660,1070,1948,1948,98199,47.639,122.4,1720,5400,67,0,7.5,4450,8130
5.35e+05,2014,243,2,2,1510,5133,1,0,0,3,7,1510,0,1939,1939,98199,47.642,122.4,1470,6000,75,0,4,2980,7510
4.85e+05,2014,201,3,2.5,2870,5490,2,0,0,3,9,2870,0,2008,2008,98055,47.447,122.21,3040,5442,6,0,5.5,5910,8312
3.05e+05,2014,222,4,2.25,2050,12581,2,0,0,4,7,2050,0,1978,1978,98002,47.322,122.2,1620,7400,36,0,6.25,3670,9450
6.45e+05,2014,244,4,1.75,1550,7350,1,0,0,4,8,1550,0,1958,1958,98040,47.58,122.23,1860,7350,56,0,5.75,3410,8900
3.53e+05,2014,264,4,2.75,1920,4627,1,0,0,3,8,1010,910,1998,1998,98178,47.5,122.23,1910,7210,16,0,6.75,3830,9130
2.8e+05,2014,331,2,1.5,1190,1265,3,0,0,3,7,1190,0,2005,2005,98133,47.727,122.36,1390,1756,9,0,3.5,2580,2946
3.565e+05,2014,335,4,1.75,1570,9670,1,0,0,3,7,1170,400,1959,1959,98028,47.743,122.25,2080,9100,55,0,5.75,3650,10670
2.45e+06,2014,270,7,4.25,4670,23115,2,0,2,3,11,4670,0,1992,1992,98039,47.618,122.23,3240,13912,22,0,11.25,7910,18582
3.74e+05,2014,230,3,2.5,1850,17808,1,0,0,4,8,1210,640,1982,1982,98032,47.363,122.27,2260,16754,32,0,5.5,4110,18604
8e+05,2014,304,4,1.5,1790,3952,1,0,0,4,8,1790,0,1932,1932,98103,47.689,122.35,1200,3876,82,0,5.5,2990,5666
3.788e+05,2014,198,5,2.5,2740,5400,2,0,0,3,8,2740,0,2005,2005,98031,47.404,122.2,2900,5476,9,0,7.5,5640,8216
3.02e+05,2015,465,4,1.5,1790,10200,1,0,0,4,8,1210,580,1963,1963,98030,47.377,122.22,1540,6600,52,0,5.5,3330,8390
3.42e+05,2015,380,3,1.75,1660,16275,2,0,0,3,7,1660,0,1990,1990,98014,47.69,121.92,1520,16275,25,0,4.75,3180,17935
5.68e+05,2015,431,3,2.5,2740,22499,2,0,0,3,9,2740,0,1994,1994,98058,47.46,122.15,2710,22499,21,0,5.5,5450,25239
1.065e+06,2014,141,2,1.75,1890,9466,2,0,0,3,8,1890,0,1987,1987,98004,47.614,122.21,2180,12825,27,0,3.75,4070,14715
4.16e+05,2014,318,3,2.5,1800,5372,2,0,0,3,8,1800,0,1987,1987,98034,47.719,122.18,1650,6014,27,0,5.5,3450,7814
4.79e+05,2014,278,3,2.5,1710,8998,2,0,0,3,8,1710,0,1982,1982,98052,47.724,122.11,1710,9859,32,0,5.5,3420,11569
3.225e+05,2015,389,2,1,1130,8184,1,0,0,3,6,1130,0,1947,1947,98155,47.747,122.32,1010,8184,68,0,3,2140,9314
8.55e+05,2015,373,4,2.25,2480,36974,2,0,0,4,9,2480,0,1973,1973,98005,47.644,122.15,3160,35070,42,0,6.25,5640,37550
4.7e+05,2015,440,3,3.5,2070,11658,1,0,0,4,8,1370,700,1977,1977,98056,47.537,122.18,1930,8744,38,0,6.5,4000,10814
1.075e+06,2014,321,5,3.5,3230,7560,2,0,0,3,10,3230,0,2007,2007,98052,47.647,122.12,3230,8580,7,0,8.5,6460,11810
4.65e+05,2015,423,3,2.5,1440,4473,2,0,0,3,7,1440,0,2003,2003,98053,47.682,122.04,1650,3322,12,0,5.5,3090,4762
9.15e+05,2014,170,3,3.25,2660,4000,2,0,0,3,9,2170,490,2003,2003,98122,47.619,122.29,2660,4000,11,0,6.25,5320,6660
5.75e+05,2015,457,4,2.5,2890,9775,2,0,2,3,8,2890,0,2004,2004,98065,47.534,121.85,2640,7184,11,0,6.5,5530,10074
3.06e+05,2015,487,4,2.5,1880,9426,2,0,0,4,7,1880,0,1990,1990,98042,47.358,122.09,1760,7040,25,0,6.5,3640,8920
2.3e+06,2014,175,4,3.25,4250,8570,2,0,0,3,9,4250,0,2004,2004,98004,47.615,122.21,2830,12821,10,0,7.25,7080,17071
2.57e+05,2015,430,2,1,1000,3700,1,0,0,3,6,800,200,1929,1929,98118,47.552,122.29,1270,5000,86,0,3,2270,6000
2.449e+05,2014,332,3,1.5,1360,9980,1,0,0,4,7,1360,0,1966,1966,98031,47.414,122.21,1360,9750,48,0,4.5,2720,11110
9.9e+05,2015,477,3,3.25,2460,4182,2,0,0,5,8,2100,360,1910,1910,98115,47.678,122.31,2370,4284,105,0,6.25,4830,6744
1.4e+06,2015,452,4,2.5,2770,8879,2,0,0,3,9,2770,0,2001,2001,98004,47.583,122.19,2770,8882,14,0,6.5,5540,11652
4.0995e+05,2014,195,3,1.75,1320,6030,1,0,0,4,7,1320,0,1969,1969,98052,47.699,122.13,1840,6565,45,0,4.75,3160,7885
1.245e+06,2014,345,5,2.5,3370,8113,2,0,0,3,9,3370,0,2005,2005,98004,47.581,122.2,2470,8113,9,0,7.5,5840,11483
2.48e+05,2015,445,3,1,1420,8800,1,0,0,4,6,1090,330,1981,1981,98030,47.375,122.18,1480,8000,34,0,4,2900,9420
8.5e+05,2015,443,5,2.75,3430,15119,2,0,0,3,10,3430,0,1998,1998,98075,47.568,122.03,3430,12045,17,0,7.75,6860,15475
6.7095e+05,2014,340,3,2.5,1790,2375,3,0,0,3,8,1790,0,2007,2007,98107,47.673,122.38,1450,2400,7,0,5.5,3240,4190
4.2e+05,2014,306,3,1,1060,7638,1,0,0,5,7,1060,0,1966,1966,98007,47.594,122.14,1470,8097,48,0,4,2530,9157
5.5e+05,2015,376,4,2.75,3650,4534,2,0,0,3,7,2940,710,2014,2014,98028,47.74,122.22,2400,7682,1,0,6.75,6050,11332
3.65e+05,2015,387,3,1,1030,4700,1,0,0,3,7,1030,0,1952,1952,98146,47.512,122.38,1030,4700,63,0,4,2060,5730
6.399e+05,2015,448,3,2.5,2330,4160,2,0,0,4,8,2330,0,1992,1992,98052,47.637,122.11,2940,4500,23,0,5.5,5270,6830
3.535e+05,2014,218,4,3,2050,4000,2,0,0,3,8,2050,0,2014,2014,98001,47.352,122.28,2050,4000,0,0,7,4100,6050
3.45e+05,2014,359,3,3.5,1320,1161,3,0,0,3,8,1320,0,2010,2010,98125,47.716,122.29,1320,1161,4,0,6.5,2640,2481
2.65e+05,2014,232,3,2,1320,8959,1,0,0,3,7,1320,0,1993,1993,98042,47.354,122.14,1740,7316,21,0,5,3060,8636
4.45e+05,2014,155,4,2.5,2340,3784,2,0,0,3,8,2340,0,2008,2008,98106,47.535,122.35,1730,4000,6,0,6.5,4070,6340
8.37e+05,2015,472,5,2.75,2940,5225,2,0,0,3,8,2760,180,2010,2010,98052,47.688,122.11,3090,6261,5,0,7.75,6030,9201
6e+05,2015,458,7,2.25,3170,36384,2,0,0,3,8,3170,0,1969,1969,98027,47.465,122,2460,38370,46,0,9.25,5630,41540
7.45e+05,2014,287,3,1,1390,9112,1,0,0,4,7,1390,0,1951,1951,98004,47.607,122.2,2290,9112,63,0,4,3680,10502
3e+05,2014,318,3,1,950,4760,1,0,0,3,6,950,0,1929,1929,98106,47.524,122.35,1080,4760,85,0,4,2030,5710
3.2e+05,2015,451,4,2.75,1640,3000,1,0,0,3,7,1000,640,1984,1984,98118,47.563,122.28,1150,4545,31,0,6.75,2790,6185
8.05e+05,2014,122,3,2,2710,4500,1,0,0,4,8,1880,830,1929,1929,98115,47.675,122.3,2060,4500,85,0,5,4770,7210
3.4495e+05,2015,437,3,1,1090,6712,1,0,0,4,7,1090,0,1972,1972,98034,47.715,122.21,1440,7350,43,0,4,2530,8440
2.25e+05,2015,388,3,1,1000,9295,1,0,0,3,7,1000,0,1955,1955,98146,47.484,122.35,1320,13500,60,0,4,2320,14500
8.302e+05,2015,440,3,2.5,2680,4990,1,0,0,5,8,1440,1240,1951,1951,98199,47.654,122.39,2320,6000,64,0,5.5,5000,8680
8.65e+05,2014,286,4,3.25,3400,99170,1,0,0,4,8,2000,1400,1980,1980,98072,47.729,122.1,3460,47920,34,0,7.25,6860,51320
7.2e+05,2014,252,3,1.75,2040,4000,2,0,0,5,7,1360,680,1924,1924,98105,47.667,122.29,1610,4000,90,0,4.75,3650,6040
5.55e+05,2015,474,4,2.25,2220,8125,1,0,0,4,8,1450,770,1965,1965,98006,47.543,122.18,1980,8700,50,0,6.25,4200,10920
3.25e+05,2014,299,3,1,1490,57381,1,0,0,4,5,1490,0,1932,1932,98092,47.26,122.23,1580,1.0153e+05,82,0,4,3070,1.0302e+05
2.5995e+05,2014,225,3,1.5,1350,7827,1,0,0,4,7,1350,0,1968,1968,98030,47.379,122.22,1900,7827,46,0,4.5,3250,9177
3e+05,2014,187,3,1,930,5160,1,0,0,5,6,930,0,1919,1919,98106,47.526,122.36,1060,5160,95,0,4,1990,6090
4.81e+05,2015,472,3,1.75,1560,3000,1,0,0,4,6,770,790,1918,1918,98103,47.685,122.34,1390,3000,97,0,4.75,2950,4560
7.77e+05,2014,286,4,2.5,3170,9900,2,0,0,4,8,3170,0,1979,1979,98007,47.618,122.15,2540,12400,35,0,6.5,5710,15570
5.9495e+05,2014,211,4,2.25,2380,35008,1,0,0,3,8,2380,0,1977,1977,98075,47.583,122,2250,34794,37,0,6.25,4630,37174
6.4e+05,2015,464,3,2.5,2420,8244,2,0,0,3,10,2420,0,1988,1988,98029,47.559,122.02,2500,9320,27,0,5.5,4920,11740
9.38e+05,2015,469,3,2.5,3090,10940,2,0,2,3,10,3090,0,1992,1992,98006,47.549,122.12,3410,12157,23,0,5.5,6500,15247
2.8495e+05,2015,443,4,1.5,2000,6778,1,0,0,4,7,1170,830,1962,1962,98198,47.371,122.31,1940,7531,53,0,5.5,3940,9531
3.07e+05,2014,359,4,2.75,2520,6964,1,0,0,4,7,1260,1260,1987,1987,98031,47.404,122.17,1930,6949,27,0,6.75,4450,9469
6.81e+05,2014,187,3,1.75,1880,10032,1,0,0,4,8,1880,0,1984,1984,98006,47.553,122.16,2430,9732,30,0,4.75,4310,11612
2.72e+05,2014,218,3,2.5,1980,6608,2,0,0,3,8,1980,0,1994,1994,98092,47.264,122.21,2150,7495,20,0,5.5,4130,9475
3.55e+05,2014,210,2,1,960,6250,1,0,0,3,6,960,0,1916,1916,98136,47.549,122.39,1350,6250,98,0,3,2310,7210
5.85e+05,2014,341,3,2.5,2160,1250,3,0,0,3,8,1830,330,2010,2010,98119,47.651,122.38,1870,2825,4,0,5.5,4030,4985
4.65e+05,2014,338,4,1.75,1810,21650,2,0,0,4,7,1810,0,1961,1961,98077,47.736,122.08,2700,29680,53,0,5.75,4510,31490
8.525e+05,2014,159,3,2.5,2630,10100,1,0,0,4,9,1580,1050,1967,1967,98006,47.564,122.15,2400,9700,47,0,5.5,5030,12330
2.3e+05,2014,237,3,1.75,1260,10164,1,0,0,4,6,1260,0,1964,1964,98059,47.475,122.13,1190,10640,50,0,4.75,2450,11900
1.74e+06,2014,140,4,3.75,3300,4545,1,0,4,3,10,2600,700,1926,1999,98105,47.656,122.27,3300,5000,88,1,7.75,6600,8300
7.35e+05,2014,198,4,2.5,3100,8529,2,0,0,3,9,3100,0,1990,1990,98074,47.625,122.03,2710,8344,24,0,6.5,5810,11444
3.16e+05,2015,488,4,1.5,2120,46173,2,0,0,3,7,2120,0,1974,1974,98053,47.65,121.97,2000,46173,41,0,5.5,4120,48293
3.199e+05,2014,211,4,2.75,2475,4276,2,0,0,3,7,2475,0,2014,2014,98002,47.345,122.21,2475,4000,0,0,6.75,4950,6475
5.5e+05,2014,359,2,1,950,4080,1,0,0,4,7,950,0,1924,1924,98117,47.676,122.38,1120,4080,90,0,3,2070,5030
5.75e+05,2015,462,2,1.75,1230,5418,1,0,0,3,8,990,240,1949,1949,98117,47.684,122.38,1330,5074,66,0,3.75,2560,6304
2.625e+05,2015,451,4,2,1540,5110,1,0,0,3,7,1540,0,1957,1957,98118,47.516,122.27,1540,5110,58,0,6,3080,6650
1.9995e+05,2014,173,5,2.5,1740,8750,1,0,0,4,7,1740,0,1959,1959,98198,47.39,122.3,1740,8750,55,0,7.5,3480,10490
5e+05,2015,452,3,2.25,1700,9008,1,0,0,3,8,1340,360,1985,1985,98125,47.716,122.32,2340,8003,30,0,5.25,4040,9703
6.75e+05,2014,136,5,2.5,3200,6455,2,0,0,3,9,3200,0,2009,2009,98065,47.545,121.86,3290,7924,5,0,7.5,6490,11124
9.8e+05,2014,312,4,2.25,3010,9800,2,0,0,4,9,3010,0,1973,1973,98040,47.534,122.22,2510,9800,41,0,6.25,5520,12810
6.35e+05,2014,256,5,3.25,3710,34200,2,0,0,3,8,2510,1200,1986,1986,98074,47.61,122.05,1720,23100,28,0,8.25,5430,26810
3.3995e+05,2015,485,4,2.25,2200,7150,2,0,0,4,7,2200,0,1990,1990,98042,47.359,122.09,1740,7150,25,0,6.25,3940,9350
4.85e+05,2014,168,2,2.5,1430,923,3,0,0,3,8,1410,20,2008,2008,98103,47.668,122.36,1620,1505,6,0,4.5,3050,2935
2.6159e+05,2015,367,2,1,760,6407,1,0,0,3,6,760,0,1943,1943,98178,47.498,122.26,1050,8580,72,0,3,1810,9340
2.926e+05,2014,188,3,1.5,1520,7123,1,0,0,4,7,1520,0,1959,1959,98056,47.499,122.18,1450,8023,55,0,4.5,2970,9543
7.3e+05,2014,265,3,3,3460,13129,2,0,0,3,9,2560,900,1988,1988,98077,47.731,122.06,3460,12568,26,0,6,6920,16028
3.0052e+05,2015,365,3,2.5,2370,6840,2,0,0,3,9,2370,0,1987,1987,98119,47.65,122.37,1590,4400,28,0,5.5,3960,6770
3.56e+05,2014,142,2,1.75,1060,16470,1,0,0,3,7,1060,0,1977,1977,98072,47.741,122.09,1790,16748,37,0,3.75,2850,17808
2.14e+05,2014,225,3,1,1200,8316,1,0,0,4,6,1200,0,1953,1953,98002,47.322,122.22,1200,8316,61,0,4,2400,9516
4.7e+05,2014,262,3,2.5,2000,8424,1,0,0,4,7,1300,700,1968,1968,98034,47.709,122.2,2110,8400,46,0,5.5,4110,10400
3.3e+05,2015,409,3,2.75,3360,41250,1,0,0,4,7,1820,1540,1988,1988,98022,47.26,122.02,2580,98881,27,0,5.75,5940,1.0224e+05
4.1e+05,2015,436,3,2.5,1420,1269,3,0,0,3,7,1420,0,2007,2007,98103,47.69,122.34,1420,1300,8,0,5.5,2840,2720
5.95e+05,2014,149,3,2,1480,5000,1,0,0,4,7,750,730,1928,1928,98117,47.686,122.37,1250,4000,86,0,5,2730,5480
2.75e+05,2014,189,3,1,1200,7800,1,0,0,4,7,1200,0,1954,1954,98126,47.52,122.37,1230,7070,60,0,4,2430,8270
8.45e+05,2014,174,3,2,2540,4750,1,0,0,5,9,1840,700,1930,1930,98117,47.684,122.4,2190,4750,84,0,5,4730,7290
4.04e+05,2014,262,3,1.75,1410,15210,1,0,0,3,7,1410,0,1950,2014,98166,47.418,122.34,1970,16290,64,1,4.75,3380,17700
4.05e+05,2014,156,2,2,1405,1073,2,0,0,3,8,1140,265,2007,2007,98122,47.612,122.3,1405,3000,7,0,4,2810,4405
3.7995e+05,2014,345,2,1,870,7500,1,0,0,3,7,870,0,1947,1947,98136,47.547,122.38,1240,5709,67,0,3,2110,6579
7.5e+05,2015,395,3,1,1120,8549,1,0,0,3,7,1120,0,1952,1952,98004,47.629,122.2,1440,8640,63,0,4,2560,9760
5.4e+05,2014,222,5,2.75,3160,10059,2,0,0,3,10,1740,1420,1978,1978,98011,47.748,122.22,3120,11557,36,0,7.75,6280,14717
9.8883e+05,2014,318,5,3.25,4115,7910,2,0,0,3,9,4115,0,2014,2014,98053,47.685,122.02,3950,6765,0,0,8.25,8065,10880
4.29e+05,2014,160,3,3.25,1410,1246,3,0,0,3,8,1410,0,2005,2005,98103,47.698,122.34,1410,1253,9,0,6.25,2820,2663
4.18e+05,2014,321,3,2.5,2080,16050,1,0,0,5,8,1360,720,1978,1978,98059,47.469,122.07,1790,14550,36,0,5.5,3870,16630
6.899e+05,2014,135,4,3.25,2740,7266,2,0,0,3,9,2060,680,2003,2003,98027,47.535,122.07,3030,6546,11,0,7.25,5770,9286
4.2e+05,2014,332,2,1,2100,4480,1,0,0,5,7,1400,700,1908,1908,98126,47.574,122.37,1570,4400,106,0,3,3670,6500
4.6e+05,2015,473,4,2.5,2680,11998,1,0,3,3,8,1510,1170,1960,1960,98003,47.337,122.32,2680,12746,55,0,6.5,5360,15426
4.3e+05,2014,162,4,1.75,1890,6000,1,0,0,4,6,1110,780,1947,1947,98125,47.727,122.31,1560,6356,67,0,5.75,3450,8246
2.315e+05,2014,190,3,2.25,1630,7900,1,0,0,4,7,1130,500,1973,1973,98023,47.308,122.38,1630,8200,41,0,5.25,3260,9830
2.134e+05,2014,348,4,2.5,1680,6655,2,0,0,3,7,1680,0,2001,2001,98030,47.387,122.19,1680,6982,13,0,6.5,3360,8662
3.6e+05,2014,256,4,2.25,1930,6508,2,0,0,3,8,1930,0,1996,1996,98019,47.746,121.98,2170,6548,18,0,6.25,4100,8478
6.15e+05,2014,151,3,2.25,1760,1146,3,0,0,3,9,1760,0,2014,2014,98122,47.607,122.3,1346,3472,0,0,5.25,3106,5232
5.825e+05,2014,348,2,1.75,1990,6549,1,0,0,3,7,1170,820,1948,1948,98115,47.7,122.3,1640,7202,66,0,3.75,3630,9192
4.63e+05,2014,155,3,2.5,1640,29970,2,0,0,3,7,1640,0,1992,1992,98053,47.636,121.97,1580,28399,22,0,5.5,3220,30039
3.4e+05,2015,437,2,1,700,5829,1,0,0,3,6,700,0,1945,1945,98103,47.696,122.36,1160,6700,70,0,3,1860,7400
1.295e+06,2014,231,2,2.5,2910,19449,2,1,4,5,9,1940,970,1985,1985,98177,47.773,122.39,2540,23598,29,0,4.5,5450,26508
2.58e+05,2014,218,3,1.75,2270,9000,1,0,0,4,8,1330,940,1978,1978,98023,47.308,122.38,2090,8400,36,0,4.75,4360,10670
4.99e+05,2014,126,2,1.75,1170,2400,1,0,0,4,7,740,430,1903,1903,98103,47.665,122.33,1570,3919,111,0,3.75,2740,5089
2.559e+05,2014,205,3,2.5,1489,3266,2,0,0,3,7,1489,0,2014,2014,98002,47.345,122.22,1537,3273,0,0,5.5,3026,4762
3.2495e+05,2015,481,4,2,2160,4800,2,0,0,4,7,1290,870,1929,1929,98055,47.478,122.21,1570,4800,86,0,6,3730,6960
4.39e+05,2014,354,4,2.5,2690,9551,2,0,0,3,9,2690,0,1992,1992,98058,47.434,122.16,2890,9121,22,0,6.5,5580,11811
2.43e+05,2014,180,2,1.5,1068,1758,2,0,0,3,7,1068,0,1990,1990,98028,47.753,122.24,1078,1315,24,0,3.5,2146,2383
3.64e+05,2015,467,4,1,1210,7740,1,0,0,3,7,1210,0,1922,1922,98126,47.522,122.37,1100,7740,93,0,5,2310,8950
1.3e+06,2014,280,5,1.75,2130,19180,1,0,0,3,8,1500,630,1968,1968,98004,47.638,122.21,3650,19180,46,0,6.75,5780,21310
6.0513e+05,2014,306,2,1,1160,5029,1,0,0,3,7,910,250,1940,1940,98115,47.672,122.27,1220,5029,74,0,3,2380,6189
3.369e+05,2014,359,3,2.5,1690,1200,2,0,0,3,8,1410,280,2014,2014,98106,47.539,122.37,1740,1664,0,0,5.5,3430,3354
2.965e+05,2014,216,3,1,1280,5100,1,0,0,3,7,1280,0,1948,1948,98126,47.526,122.38,1380,7140,66,0,4,2660,8420
5.244e+05,2014,223,4,1.75,1990,12950,1,0,0,4,8,1850,140,1968,1968,98006,47.543,122.17,2090,12850,46,0,5.75,4080,14840
3.05e+05,2014,286,2,1.5,800,2142,2,0,0,3,7,800,0,2006,2006,98144,47.592,122.3,1320,2742,8,0,3.5,2120,3542
8.1e+05,2014,188,2,2.75,2700,8572,1,0,0,3,9,2700,0,2007,2007,98053,47.724,122.03,2680,8569,7,0,4.75,5380,11269
1.415e+06,2014,279,4,3.25,3600,38016,2,0,2,3,11,3310,290,1991,1991,98034,47.712,122.25,2440,22693,23,0,7.25,6040,26293
1.39e+05,2014,174,2,1,690,5280,1,0,0,4,5,690,0,1942,1942,98056,47.495,122.19,1140,4860,72,0,3,1830,5550
2.94e+05,2014,215,4,2,2930,12840,1,0,0,4,8,2930,0,1965,1965,98092,47.296,122.19,1960,10920,49,0,6,4890,13850
8.5e+05,2014,264,2,1.75,2170,25732,1,0,2,4,8,2170,0,1952,1952,98177,47.754,122.37,3020,23135,62,0,3.75,5190,25305
3.93e+05,2014,230,3,2,1320,10720,2,0,0,3,8,1320,0,1981,1981,98074,47.62,122.04,1910,13639,33,0,5,3230,14959
1.155e+06,2014,155,4,2.25,2980,8051,1,0,2,4,10,2020,960,1935,1935,98199,47.643,122.41,2760,5499,79,0,6.25,5740,8479
1.8e+05,2015,415,2,1,770,10000,1,0,0,3,6,770,0,1933,1933,98028,47.738,122.23,2720,8062,82,0,3,3490,8832
6.2e+05,2015,429,5,1,2230,16800,1,0,3,4,7,1700,530,1923,1923,98136,47.516,122.39,2730,18400,92,0,6,4960,20630
3.15e+05,2014,321,6,2.75,2940,7350,1,0,0,3,8,1780,1160,1978,1978,98023,47.31,122.34,2120,8236,36,0,8.75,5060,11176
3.6916e+05,2014,231,4,2.25,2120,9680,2,0,2,4,8,2120,0,1965,1965,98003,47.337,122.33,2360,9647,49,0,6.25,4480,11767
1.425e+06,2014,125,2,2.5,2220,4000,2,0,0,3,9,2220,0,2000,2000,98112,47.636,122.28,1870,4000,14,0,4.5,4090,6220
1.82e+05,2014,208,3,2.25,1960,8875,1,0,0,3,7,1290,670,1965,1965,98003,47.334,122.3,1890,8700,49,0,5.25,3850,10660
7.35e+05,2014,161,4,1.75,2460,5100,1,0,0,5,7,1450,1010,1909,1909,98115,47.678,122.3,1560,5100,105,0,5.75,4020,7560
3.4995e+05,2014,174,4,2.5,2090,5289,2,0,0,3,8,2090,0,1989,1989,98058,47.429,122.16,2080,7109,25,0,6.5,4170,9199
2.5695e+05,2014,345,2,2,1070,635,2,0,0,3,9,720,350,2008,2008,98106,47.521,122.36,1070,928,6,0,4,2140,1998
3.32e+05,2015,389,4,2.5,2300,4482,2,0,0,3,7,2300,0,2013,2013,98042,47.36,122.08,2300,3825,2,0,6.5,4600,6125
3.75e+05,2015,399,3,2,2240,5200,1,0,0,3,7,1630,610,1954,1954,98112,47.619,122.3,1470,3775,61,0,5,3710,6015
3.9944e+05,2014,196,4,2.5,2311,4396,2,0,0,3,9,2311,0,2014,2014,98092,47.328,122.16,2458,4616,0,0,6.5,4769,6927
2.434e+05,2014,282,4,1.5,1730,7464,2,0,0,4,7,1730,0,1959,1959,98032,47.378,122.3,1370,7860,55,0,5.5,3100,9590
7.1e+05,2014,243,4,2.75,2710,41811,1,0,0,4,8,1690,1020,1995,1995,98075,47.584,122.05,2110,35656,19,0,6.75,4820,38366
3.9e+05,2014,283,4,1.5,1940,12100,1,0,0,3,7,1940,0,1962,1962,98033,47.689,122.16,1380,12100,52,0,5.5,3320,14040
4.7e+05,2014,252,3,2.5,2280,6134,2,0,0,3,8,2280,0,2004,2004,98065,47.533,121.85,2640,6167,10,0,5.5,4920,8447
2.94e+05,2014,201,2,1,820,6366,1,0,0,5,6,820,0,1952,1952,98133,47.751,122.34,1580,10169,62,0,3,2400,10989
5.55e+05,2014,236,3,2.5,1940,3211,2,0,0,3,8,1940,0,2009,2009,98027,47.564,122.09,1880,3078,5,0,5.5,3820,5018
4.495e+05,2014,272,3,2.25,1260,2556,2,0,0,3,7,1260,0,2005,2005,98029,47.548,122,1630,2844,9,0,5.25,2890,4104
6.65e+05,2014,251,3,1.75,1800,8000,1,0,0,3,8,1800,0,1972,1972,98008,47.636,122.12,1950,8500,42,0,4.75,3750,10300
7.8e+05,2015,437,3,2.5,2110,9773,1,0,0,3,9,2110,0,1986,1986,98006,47.563,122.11,2560,11787,29,0,5.5,4670,13897
6.45e+05,2014,188,4,2.5,2850,37522,2,0,0,3,9,2850,0,1987,1987,98075,47.585,121.99,2980,35280,27,0,6.5,5830,38130
2.99e+05,2014,266,4,2.25,1870,6693,2,0,0,3,7,1870,0,1996,1996,98003,47.277,122.3,1650,6518,18,0,6.25,3520,8388
3.78e+05,2015,448,2,1.5,980,853,2,0,0,3,7,820,160,2009,2009,98144,47.593,122.3,1130,1270,6,0,3.5,2110,2250
2.5e+06,2015,485,4,3.25,3960,16224,2,0,2,3,12,3100,860,1938,1938,98105,47.67,122.26,3960,15050,77,0,7.25,7920,19010
8e+05,2014,170,4,2.75,3150,7035,2,0,0,3,9,3150,0,2004,2004,98075,47.598,121.97,3200,7035,10,0,6.75,6350,10185
5.35e+05,2014,181,4,1.75,1420,5000,1,0,0,4,7,1420,0,1945,1945,98117,47.677,122.4,1490,5000,69,0,5.75,2910,6420
3.61e+05,2015,392,3,1.5,1200,7236,1,0,0,3,7,1200,0,1975,1975,98011,47.739,122.19,1680,7800,40,0,4.5,2880,9000
7e+05,2014,280,2,1,1160,17635,1,1,4,3,6,1160,0,1945,1945,98178,47.512,122.25,1510,13122,69,0,3,2670,14282
2.8e+05,2014,245,2,1,910,4662,1,0,0,5,6,910,0,1942,1942,98106,47.523,122.35,890,6050,72,0,3,1800,6960
1.94e+05,2014,140,1,1,820,1060,1,0,0,3,8,760,60,2007,2007,98126,47.547,122.37,1770,1853,7,0,2,2590,2673
3.5e+05,2014,304,3,1.75,1380,4590,1,0,0,2,7,930,450,1950,1950,98115,47.684,122.29,1320,4692,64,0,4.75,2700,6072
8.66e+05,2014,187,4,3.25,3990,9786,2,0,0,3,9,3990,0,2004,2004,98053,47.678,122.03,3920,8200,10,0,7.25,7910,12190
8.0995e+05,2014,156,4,2,2230,9900,1,0,0,5,9,2230,0,1959,1959,98005,47.598,122.17,2510,11041,55,0,6,4740,13271
3.06e+05,2014,239,3,1.75,1560,7500,1,0,0,4,8,1560,0,1966,1966,98056,47.489,122.18,1600,7904,48,0,4.75,3160,9464
1.079e+06,2014,263,5,3.5,3740,5610,2,0,0,3,9,2860,880,2014,2014,98117,47.676,122.39,1520,4590,0,0,8.5,5260,8330
1.94e+05,2014,265,3,1,1400,7955,1,0,0,3,7,1400,0,1964,1964,98055,47.485,122.22,1160,14959,50,0,4,2560,16359
4.2e+05,2015,467,4,1.75,2480,60548,1,0,0,4,7,1600,880,1968,1968,98027,47.472,122,2390,90169,47,0,5.75,4870,92649
4e+05,2014,197,3,1.75,2110,19600,1,0,0,4,8,2110,0,1959,1959,98055,47.474,122.2,880,10077,55,0,4.75,2990,12187
4.43e+05,2014,262,3,1.75,1640,4579,1,0,0,4,6,1640,0,1916,1916,98133,47.706,122.35,1580,5040,98,0,4.75,3220,6680
2.195e+06,2014,222,5,3.25,5210,35765,2,0,4,5,10,4940,270,1911,1911,98136,47.546,122.4,2590,10250,103,0,8.25,7800,15460
2.9e+05,2014,338,2,1,1340,9840,1,0,0,3,7,1340,0,1949,1949,98133,47.72,122.34,1610,8949,65,0,3,2950,10289
7.99e+05,2015,445,4,2.75,3340,5677,2,0,0,3,9,3340,0,2011,2011,98052,47.709,122.12,3240,5643,4,0,6.75,6580,8983
1.389e+06,2015,433,4,3.5,3130,3900,2,0,0,3,9,2550,580,2008,2008,98115,47.685,122.33,1830,3900,7,0,7.5,4960,7030
3.8e+05,2015,401,3,1,1400,8710,1,0,0,4,7,1400,0,1948,1948,98146,47.507,122.38,1460,8710,67,0,4,2860,10110
4.3501e+05,2015,432,3,1,1270,4000,1,0,0,3,7,1120,150,1954,1954,98106,47.529,122.35,1220,4600,61,0,4,2490,5870
9.2e+05,2015,474,4,3.25,2190,4265,2,0,0,3,9,1540,650,2015,2015,98122,47.618,122.29,1730,4265,0,0,7.25,3920,6455
6.62e+05,2014,278,3,1.75,2500,36947,1,0,0,3,9,2500,0,1984,1984,98052,47.692,122.08,2590,28837,30,0,4.75,5090,31337
4.47e+05,2015,400,2,1,760,6035,1,0,0,3,6,760,0,1920,1920,98136,47.544,122.38,2110,6046,95,0,3,2870,6806
5.45e+05,2015,438,3,1,960,5030,1,0,0,3,7,960,0,1955,1955,98118,47.561,122.28,1460,5400,60,0,4,2420,6360
7.5e+05,2015,409,4,2.25,2820,9602,1,0,1,3,8,1950,870,1974,1974,98008,47.588,122.11,2890,9602,41,0,6.25,5710,12422
7.75e+05,2014,197,4,3.5,4130,77832,2,0,2,3,10,4130,0,2011,2011,98042,47.323,122.05,4130,87476,3,0,7.5,8260,91606
1.685e+05,2015,389,2,1,1020,7742,1,0,0,4,6,1020,0,1935,1978,98168,47.499,122.3,1510,7742,80,1,3,2530,8762
4.4e+05,2014,256,3,2.25,1760,1800,2,0,0,3,7,1330,430,1983,1983,98199,47.658,122.39,1150,4575,31,0,5.25,2910,6335
8.6e+05,2014,133,4,2.5,3560,11119,1,0,2,3,10,2290,1270,1986,1986,98004,47.646,122.19,3290,11385,28,0,6.5,6850,14945
4.39e+05,2014,238,3,1.75,1250,7030,1,0,0,3,7,1250,0,1965,1965,98008,47.629,122.12,1460,7210,49,0,4.75,2710,8460
8.29e+05,2014,223,4,3,3310,4500,2,0,0,5,9,2910,400,1900,1900,98103,47.659,122.34,1440,3750,114,0,7,4750,7060
3.45e+05,2014,243,3,2.5,1620,5992,2,0,0,3,7,1620,0,2001,2001,98019,47.736,121.97,1620,4644,13,0,5.5,3240,6264
5.445e+05,2014,148,4,2.5,2230,10414,1,0,0,5,7,1450,780,1974,1974,98075,47.582,122,1960,10240,40,0,6.5,4190,12470
5.6995e+05,2015,466,5,1,1420,6250,1,0,0,4,8,1420,0,1926,1926,98116,47.581,122.39,1420,6250,89,0,6,2840,7670
1.99e+05,2014,223,3,1.75,1320,17390,1,0,0,4,7,1320,0,1956,1956,98003,47.326,122.3,1550,19265,58,0,4.75,2870,20585
3.3e+05,2014,204,3,2,2170,3978,1,0,0,5,7,1340,830,1919,1919,98116,47.571,122.39,1350,4680,95,0,5,3520,6850
8.33e+05,2014,129,4,2.75,3780,10308,2,0,0,3,10,3780,0,1999,1999,98075,47.589,121.98,3500,10740,15,0,6.75,7280,14520
2.05e+05,2014,236,3,1,1370,10708,1,0,0,3,7,1370,0,1969,1969,98001,47.277,122.26,1770,14482,45,0,4,3140,15852
9.49e+05,2014,251,4,1.75,2490,7834,1,0,3,4,8,1240,1250,1958,1958,98033,47.685,122.21,3210,7834,56,0,5.75,5700,10324
3.08e+05,2014,175,3,1,1640,18144,1,0,0,3,6,1640,0,1942,1942,98168,47.503,122.33,1500,9065,72,0,4,3140,10705
4.35e+05,2015,481,6,3,3560,4290,1,0,0,4,7,1780,1780,1957,1957,98118,47.528,122.27,3040,6000,58,0,9,6600,9560
5.5e+05,2015,443,4,2,1660,12377,1,0,0,3,8,1660,0,1966,1966,98008,47.623,122.1,1820,8968,49,0,6,3480,10628
9.3e+05,2014,265,3,2.5,3780,35273,1,0,0,3,10,3780,0,1986,1986,98072,47.75,122.12,3450,35273,28,0,5.5,7230,39053
2.885e+06,2014,266,7,3,5350,14400,2,0,0,4,10,5020,330,1910,1910,98112,47.63,122.28,3050,7469,104,0,10,8400,12819
3e+05,2014,141,2,1,970,13700,1,0,0,3,6,970,0,1949,1949,98106,47.515,122.36,1570,10880,65,0,3,2540,11850
4.675e+05,2014,331,4,2.5,3160,7210,1,0,0,4,7,1880,1280,1969,1969,98034,47.737,122.18,2070,7560,45,0,6.5,5230,10720
4.25e+05,2015,393,3,2.5,2650,1.4418e+05,1,0,0,3,8,2650,0,1967,1967,98042,47.421,122.14,1940,41210,48,0,5.5,4590,43860
9.3299e+05,2014,331,4,2.5,3640,6389,2,0,0,3,9,3640,0,2014,2014,98052,47.705,122.12,3570,6303,0,0,6.5,7210,9943
4.4995e+05,2014,167,4,2.5,2470,3811,2,0,0,3,8,2470,0,1999,1999,98065,47.536,121.88,2400,4266,15,0,6.5,4870,6736
5.33e+05,2014,229,3,2.5,2060,4812,2,0,0,3,8,2060,0,1990,1990,98029,47.579,122,1930,5264,24,0,5.5,3990,7324
7.1e+05,2014,227,3,2.5,2830,9680,2,0,0,3,10,2830,0,1991,1991,98074,47.625,122.02,2970,8691,23,0,5.5,5800,11521
2.65e+05,2014,130,4,1,1940,9533,1,0,0,3,7,1080,860,1962,1962,98031,47.414,122.21,1940,8839,52,0,5,3880,10779
6.79e+05,2015,429,4,2.5,3080,8451,1,0,0,3,7,1540,1540,1969,1969,98052,47.674,122.15,1550,8125,46,0,6.5,4630,11205
3.245e+05,2015,450,4,2.5,2110,3825,2,0,0,3,7,2110,0,2012,2012,98042,47.36,122.08,2110,3825,3,0,6.5,4220,5935
6.45e+05,2014,283,2,1,1240,5000,1,0,0,3,7,1000,240,1920,1920,98103,47.663,122.35,1480,3500,94,0,3,2720,4740
4e+05,2014,284,4,2.5,2350,3904,2,0,0,3,7,2350,0,1999,1999,98106,47.531,122.35,1120,4000,15,0,6.5,3470,6350
2.85e+05,2015,466,4,2.5,1996,4547,2,0,0,3,7,1996,0,2009,2009,98042,47.337,122.05,2180,5127,6,0,6.5,4176,7123
2.9355e+05,2014,276,4,1.75,2120,9706,1,0,0,3,7,1370,750,1965,1965,98168,47.494,122.3,1730,11337,49,0,5.75,3850,13457
5.79e+05,2014,250,2,2.5,1280,1051,2,0,0,3,8,1080,200,2009,2009,98119,47.627,122.36,1580,1279,5,0,4.5,2860,2559
1.19e+06,2014,283,2,1.75,2080,8112,1,1,4,4,8,1040,1040,1939,1984,98125,47.713,122.28,2030,8408,75,1,3.75,4110,10488
2.56e+05,2015,479,3,1,950,4000,1,0,0,3,7,780,170,1949,1949,98118,47.523,122.28,1230,4000,66,0,4,2180,4950
3.999e+05,2014,208,4,2.5,2710,8127,2,0,0,3,8,2710,0,1994,1994,98038,47.379,122.03,2520,8436,20,0,6.5,5230,11146
3.795e+05,2014,203,3,2.25,1830,25641,2,0,0,3,8,1830,0,1989,1989,98059,47.479,122.11,1500,25641,25,0,5.25,3330,27471
5.8e+05,2015,415,4,2.5,2110,11680,1,0,0,4,7,1420,690,1977,1977,98052,47.696,122.12,1890,9600,38,0,6.5,4000,11710
6.11e+05,2014,304,2,1,1270,5100,1,0,0,3,7,1100,170,1900,1900,98115,47.677,122.33,1670,3900,114,0,3,2940,5170
4.225e+05,2015,408,3,2,1960,6450,1,0,0,4,7,1000,960,1977,1977,98038,47.397,122.03,1660,20720,38,0,5,3620,22680
3.3e+05,2014,181,3,2.5,1680,11312,1,0,0,3,7,1080,600,1959,1959,98146,47.505,122.34,1390,10700,55,0,5.5,3070,12380
9.75e+05,2014,183,6,2.75,2520,54160,2,1,4,3,7,2520,0,1954,1954,98146,47.497,122.38,2790,26809,60,0,8.75,5310,29329
3.22e+05,2014,150,4,2.5,2280,7200,2,0,0,3,8,2280,0,1994,1994,98030,47.383,122.21,2250,7200,20,0,6.5,4530,9480
8.35e+05,2014,214,5,1.5,3360,5225,2,0,0,3,9,3360,0,2014,2014,98074,47.607,122.05,3230,5368,0,0,6.5,6590,8728
2.832e+05,2014,147,4,2.5,1982,6406,2,0,0,3,8,1982,0,2004,2004,98030,47.364,122.19,2340,6501,10,0,6.5,4322,8483
9.797e+05,2014,283,4,2.25,2480,6000,2,0,2,3,10,2380,100,1929,1929,98199,47.639,122.41,3030,5600,85,0,6.25,5510,8080
8.25e+05,2014,181,4,2.75,3990,6637,2,0,0,3,9,3990,0,2003,2003,98053,47.684,122.05,3500,7074,11,0,6.75,7490,11064
5.69e+05,2014,324,3,2,1990,3000,1,0,0,3,7,1230,760,1908,1970,98112,47.627,122.29,1600,4080,106,1,5,3590,6070
3.5782e+05,2015,373,3,1.5,1240,9196,1,0,0,3,8,1240,0,1968,1968,98072,47.756,122.09,1690,10800,47,0,4.5,2930,12040
1.042e+06,2014,183,4,5,4110,43560,2,0,0,4,11,4110,0,1978,1978,98005,47.635,122.18,3650,43995,36,0,9,7760,48105
6.25e+05,2015,463,4,1.75,2180,4431,1,0,0,3,8,2020,160,1912,1912,98112,47.636,122.3,1890,4400,103,0,5.75,4070,6580
1.385e+06,2014,232,3,2.25,2930,6000,2,0,2,3,11,1920,1010,2000,2000,98112,47.63,122.3,1870,5040,14,0,5.25,4800,7970
4.585e+05,2014,286,2,1.75,1160,6828,1,0,0,3,7,860,300,1941,1941,98115,47.694,122.3,1250,6828,73,0,3.75,2410,7988
6.61e+05,2014,231,3,2,1820,4418,2,0,0,4,8,1820,0,1994,1994,98033,47.695,122.19,1920,13402,20,0,5,3740,15222
5.999e+05,2015,395,3,1.5,2605,12030,1,0,0,3,8,1355,1250,2003,2003,98019,47.773,121.9,1590,15242,12,0,4.5,4195,17847
5.5e+05,2014,276,2,1,1080,3420,1,0,0,4,7,780,300,1922,1922,98107,47.672,122.39,1380,3656,92,0,3,2460,4736
2.58e+05,2015,474,4,1,1220,8500,1,0,0,5,6,1220,0,1916,1916,98168,47.479,122.28,1460,8500,99,0,5,2680,9720
4.89e+05,2015,453,4,2.5,3910,8442,2,0,0,3,9,2710,1200,2000,2000,98038,47.377,122.03,2650,7576,15,0,6.5,6560,11486
4.925e+05,2014,166,5,2.5,2570,9962,2,0,0,3,8,2570,0,2006,2006,98019,47.727,121.96,2890,9075,8,0,7.5,5460,11645
6.4e+05,2014,228,3,2.5,2580,7500,2,0,0,3,9,2580,0,1991,1991,98116,47.558,122.4,910,6500,23,0,5.5,3490,9080
1.43e+06,2015,424,3,2.75,2710,9204,1,0,4,3,9,1480,1230,1975,1975,98177,47.704,122.39,2960,10080,40,0,5.75,5670,12790
3.795e+05,2014,127,2,1,1640,17335,1,0,0,3,7,840,800,1978,1978,98053,47.64,121.95,2440,17850,36,0,3,4080,19490
6.9e+05,2014,166,2,1.75,1600,4000,1,0,0,5,7,850,750,1918,1918,98112,47.641,122.3,1860,4000,96,0,3.75,3460,5600
2.6149e+05,2014,269,4,1,1640,8467,1,0,2,4,6,1220,420,1943,1943,98056,47.489,122.19,1060,7396,71,0,5,2700,9036
4.97e+05,2015,481,3,2.5,1220,1475,3,0,0,3,8,1220,0,2000,2000,98117,47.691,122.39,1220,1546,15,0,5.5,2440,2766
4e+05,2015,407,4,2.25,1970,8941,2,0,0,3,7,1970,0,1973,1973,98034,47.722,122.17,1880,7793,42,0,6.25,3850,9763
2.15e+05,2015,375,3,1,1210,7175,1,0,0,3,7,1210,0,1918,1918,98106,47.534,122.36,1640,5850,97,0,4,2850,7060
4.6995e+05,2014,259,5,3,3223,6371,2,0,0,3,9,3223,0,2014,2014,98042,47.359,122.16,1979,19030,0,0,8,5202,22253
4.15e+05,2015,380,6,1,1370,5080,1,0,0,3,6,1120,250,1931,1931,98106,47.524,122.35,1020,5080,84,0,7,2390,6450
2.85e+05,2015,456,2,1.5,990,1380,3,0,0,3,7,990,0,2001,2001,98133,47.722,122.36,1050,1380,14,0,3.5,2040,2370
3.82e+05,2015,446,3,2.25,1800,4500,2,0,0,3,7,1800,0,1995,1995,98019,47.746,121.98,1760,6589,20,0,5.25,3560,8389
2.32e+05,2014,245,2,1,1240,12092,1,0,0,3,6,960,280,1922,1984,98146,47.496,122.35,1820,7460,92,1,3,3060,8700
9.25e+05,2015,386,3,2.75,3280,10558,1,0,2,4,9,2040,1240,1979,1979,98006,47.561,122.13,3150,9998,36,0,5.75,6430,13278
4.01e+05,2014,169,4,1,1940,5753,1,0,0,3,7,1940,0,1947,1947,98177,47.719,122.36,2170,6075,67,0,5,4110,8015
2.68e+05,2014,273,3,2,1610,8416,1,0,0,3,7,1610,0,1994,1994,98031,47.397,122.19,1600,8308,20,0,5,3210,9918
4.5e+05,2014,147,4,2.5,2520,8515,2,0,0,3,7,2520,0,1999,1999,98019,47.723,121.96,2130,6930,15,0,6.5,4650,9450
6.02e+05,2014,333,2,1,1470,6398,1,0,0,4,7,970,500,1941,1941,98105,47.672,122.28,1950,6398,73,0,3,3420,7868
8.2e+05,2014,266,3,2.5,2950,35108,1,0,0,3,10,2950,0,1995,1995,98077,47.732,122.03,3810,35181,19,0,5.5,6760,38131
7.6e+05,2014,340,4,2.25,2040,8315,1,0,0,4,8,1480,560,1958,1958,98177,47.708,122.37,2330,8940,56,0,6.25,4370,10980
4.6e+05,2014,127,3,2,1760,9055,2,0,0,4,7,1760,0,1985,1985,98052,47.653,122.13,2010,9383,29,0,5,3770,11143
8.5995e+05,2014,339,6,4,3180,6551,2,0,0,3,9,3180,0,2014,2014,98074,47.624,122.02,3230,7602,0,0,10,6410,10782
2.75e+05,2015,463,4,1.75,1680,19405,1,0,0,4,7,1560,120,1959,1959,98055,47.455,122.2,2000,12900,56,0,5.75,3680,14580
3.5e+05,2014,273,4,2.75,2300,3175,1,0,0,3,6,1340,960,1966,1966,98144,47.573,122.31,1260,3175,48,0,6.75,3560,5475
2.9e+05,2015,444,3,2,1360,6685,1,0,0,3,7,1360,0,1952,1952,98155,47.736,122.32,1300,8138,63,0,5,2660,9498
4.775e+05,2015,466,5,3.5,2815,5619,2,0,0,3,9,2815,0,2012,2012,98055,47.43,122.21,2583,5295,3,0,8.5,5398,8110
2.09e+05,2014,333,3,1,1320,3954,1,0,0,3,6,1320,0,1912,2014,98022,47.202,121.99,1270,5184,102,1,4,2590,6504
6e+05,2014,222,3,1,1440,4300,1,0,0,3,8,1440,0,1929,1929,98117,47.685,122.37,1640,4500,85,0,4,3080,5940
2.4205e+05,2014,286,3,2.5,2170,9900,1,0,0,3,7,1690,480,1980,1980,98038,47.363,122.03,1420,10614,34,0,5.5,3590,12784
4.9e+05,2015,432,3,2.25,1410,7740,1,0,0,5,6,1410,0,1923,1923,98126,47.523,122.37,1220,7740,92,0,5.25,2630,9150
5.2e+05,2014,305,3,2.25,2590,9263,1,0,0,5,8,1440,1150,1977,1977,98028,47.769,122.26,2580,9450,37,0,5.25,5170,12040
2.25e+05,2014,205,3,1.5,1370,9000,1,0,0,3,7,1370,0,1962,1962,98168,47.497,122.33,1400,9075,52,0,4.5,2770,10445
7.75e+05,2015,471,4,2.5,2580,5787,2,0,0,3,9,2580,0,2007,2007,98029,47.542,121.99,2580,4410,8,0,6.5,5160,6990
2.395e+06,2014,223,4,3.25,3800,19798,2,0,0,3,10,3800,0,1969,2009,98006,47.568,122.19,3940,18975,45,1,7.25,7740,22775
2.7192e+05,2015,424,3,2,1410,10248,1,0,0,3,7,1410,0,1985,1985,98001,47.331,122.27,2090,9414,30,0,5,3500,10824
1.75e+05,2015,396,3,1,1030,8395,1,0,0,4,7,1030,0,1960,1960,98023,47.332,122.34,1370,9380,55,0,4,2400,10410
5.05e+05,2015,402,4,2.5,3170,5340,2,0,0,3,7,3170,0,2000,2000,98059,47.491,122.14,3010,5340,15,0,6.5,6180,8510
3.65e+05,2014,256,2,1,680,4800,1,0,0,3,6,680,0,1917,1917,98122,47.608,122.3,1610,4800,97,0,3,2290,5480
4.6675e+05,2015,436,4,2,1730,9139,2,0,0,3,8,1730,0,1957,1957,98125,47.718,122.32,1410,7311,58,0,6,3140,9041
7.6e+05,2014,321,5,3.5,3180,14000,2,0,0,5,10,3180,0,1997,1997,98006,47.55,122.13,3670,14450,17,0,8.5,6850,17630
3.25e+05,2014,203,3,2.5,2330,8627,1,0,0,4,7,1480,850,1980,1980,98055,47.454,122.21,1940,9607,34,0,5.5,4270,11937
1.67e+05,2014,266,3,2,1520,7456,1,0,0,3,7,1520,0,1949,1949,98166,47.474,122.34,1740,8464,65,0,5,3260,9984
5.09e+05,2014,361,4,2,1630,1724,1,0,0,3,6,1030,600,1915,1970,98119,47.647,122.36,1780,3810,99,1,6,3410,5440
5.4e+05,2015,477,3,2.5,2180,11100,1,0,0,3,8,1230,950,1983,1983,98052,47.717,122.1,1930,12000,32,0,5.5,4110,14180
5.5e+05,2014,284,4,1.75,2480,14782,1,0,3,3,8,1460,1020,1958,1958,98155,47.765,122.27,2910,10800,56,0,5.75,5390,13280
1.4e+05,2014,326,3,1.5,1200,2002,2,0,0,3,8,1200,0,1966,1966,98055,47.466,122.19,1270,1848,48,0,4.5,2470,3048
1.075e+06,2015,463,4,2.25,2820,5000,1,0,2,4,9,1800,1020,1926,1926,98122,47.61,122.29,2880,6000,89,0,6.25,5700,8820
3.65e+05,2015,478,3,1,1120,8443,1,0,0,3,7,1120,0,1953,1953,98133,47.772,122.34,1450,8433,62,0,4,2570,9553
2.75e+05,2014,359,3,2,1540,10410,1,0,0,4,7,1540,0,1967,1967,98198,47.366,122.31,1590,7725,47,0,5,3130,9265
5.05e+05,2014,169,3,2.5,1610,4611,2,0,0,3,8,1610,0,1996,1996,98029,47.568,122,1730,4461,18,0,5.5,3340,6071
2.05e+06,2015,375,4,3.25,3580,19989,1,1,4,4,7,3480,100,1915,1965,98125,47.709,122.28,2410,6389,100,1,7.25,5990,9969
9.36e+05,2014,294,7,3.75,5100,21802,2,0,0,3,10,3640,1460,2001,2001,98075,47.595,122.04,3350,10005,13,0,10.75,8450,15105
4.25e+05,2015,433,3,2.75,3610,1.0739e+05,1,1,3,3,8,3130,480,1918,1962,98023,47.335,122.36,2630,42126,97,1,5.75,6240,45736
6.89e+05,2015,445,4,2.5,2110,6069,2,0,0,3,9,2110,0,1999,1999,98052,47.637,122.11,2180,9000,16,0,6.5,4290,11110
2.989e+05,2014,285,3,2.5,1852,4000,2,0,0,3,7,1852,0,2014,2014,98002,47.345,122.21,2475,4000,0,0,5.5,4327,5852
1.55e+05,2014,149,3,1,1250,6250,1,0,0,2,7,1030,220,1949,1949,98108,47.529,122.32,1130,6250,65,0,4,2380,7500
5.7e+05,2015,456,2,1,910,4301,1,0,0,4,7,910,0,1923,1923,98117,47.681,122.4,1810,4301,92,0,3,2720,5211
2.193e+06,2014,339,3,2.25,3360,7108,2,0,0,3,10,2770,590,1905,2004,98112,47.619,122.28,3450,8558,109,1,5.25,6810,11918
4.01e+05,2015,416,2,1.5,1260,2625,2,0,0,4,7,1260,0,1983,1983,98052,47.675,122.15,1260,2625,32,0,3.5,2520,3885
3.5395e+05,2014,277,5,2.25,3260,7969,2,0,0,4,8,3260,0,1982,1982,98023,47.314,122.34,2070,7962,32,0,7.25,5330,11222
3.54e+05,2015,478,3,2.5,2160,15817,2,0,0,3,8,2160,0,1999,1999,98031,47.417,122.18,1990,15817,16,0,5.5,4150,17977
2.7245e+05,2015,426,3,1,1350,7973,1,0,0,3,7,1350,0,1954,1954,98188,47.432,122.29,1310,7491,61,0,4,2660,8841
4e+05,2014,341,3,1.5,1890,6183,1,0,0,3,7,1090,800,1967,1967,98118,47.54,122.27,1750,6183,47,0,4.5,3640,8073
7e+05,2015,477,3,1.75,1350,4000,1,0,0,4,7,1350,0,1925,1925,98103,47.658,122.35,1880,4000,90,0,4.75,3230,5350
3.925e+05,2015,458,3,1,1660,8839,1,0,0,4,7,1660,0,1947,1947,98155,47.748,122.3,1230,9236,68,0,4,2890,10896
3.55e+05,2014,360,4,1.5,2230,11536,1,0,1,4,7,1220,1010,1954,1954,98166,47.441,122.35,2170,12465,60,0,5.5,4400,14695
3.4995e+05,2015,443,4,3.5,2796,3520,2,0,0,3,8,2796,0,2013,2013,98001,47.343,122.28,2040,5195,2,0,7.5,4836,7991
3.675e+05,2014,149,2,1,810,4800,1,0,0,3,6,810,0,1919,1919,98118,47.561,122.27,1040,4800,95,0,3,1850,5610
5.99e+05,2014,353,3,2.75,1840,2060,2,0,0,3,10,1700,140,2013,2013,98027,47.53,122.07,2590,2680,1,0,5.75,4430,4520
5.399e+05,2015,376,3,3.25,1300,1325,2,0,0,3,8,1080,220,2005,2005,98103,47.658,122.35,1290,1323,10,0,6.25,2590,2623
2.59e+05,2015,399,4,1.5,1810,9000,1,0,0,3,7,1810,0,1960,1960,98168,47.491,122.32,1520,9780,55,0,5.5,3330,11590
7.64e+05,2014,168,4,2.5,2790,7938,2,0,0,3,9,2790,0,1997,1997,98074,47.622,122.03,2780,7779,17,0,6.5,5570,10569
2.527e+05,2014,136,2,1.5,1070,9643,1,0,0,3,7,1070,0,1985,1985,98030,47.353,122.17,1220,8386,29,0,3.5,2290,9456
3.93e+05,2014,263,2,1,980,3350,1,0,0,4,7,980,0,1925,1925,98103,47.686,122.35,1260,4000,89,0,3,2240,4980
5.4e+05,2015,452,4,1.75,2040,9322,1,0,0,3,8,1440,600,1977,1977,98155,47.761,122.3,1910,10026,38,0,5.75,3950,12066
3.78e+05,2015,439,3,2.5,2130,8404,2,0,0,3,8,2130,0,1991,1991,98058,47.462,122.13,2130,8404,24,0,5.5,4260,10534
1.4e+06,2014,301,4,4.5,3080,10550,2,0,3,3,8,1940,1140,1976,2007,98040,47.581,122.24,2780,10550,38,1,8.5,5860,13630
6.5e+05,2014,178,2,1,1050,2542,1,0,0,3,7,880,170,1904,1904,98122,47.617,122.3,1620,1809,110,0,3,2670,2859
5.2e+05,2014,162,4,1,2080,3500,1,0,0,5,7,1260,820,1926,1926,98136,47.544,122.38,1380,5900,88,0,5,3460,7980
1.3e+05,2015,425,3,1,1100,5100,1,0,0,4,7,1100,0,1913,1913,98108,47.523,122.33,1450,5100,102,0,4,2550,6200
5.5e+05,2015,426,3,1,1010,6120,1,0,0,3,6,1010,0,1942,1942,98033,47.665,122.2,1260,5977,73,0,4,2270,6987
3.25e+05,2015,444,3,2.5,2000,7205,2,0,0,3,8,2000,0,1998,1998,98003,47.35,122.3,2180,7611,17,0,5.5,4180,9611
5.5e+05,2014,347,2,1.75,1740,7290,1,0,0,3,8,1280,460,1950,1950,98199,47.646,122.4,1820,6174,64,0,3.75,3560,7914
7.37e+05,2015,485,3,2.5,2300,7800,2,0,2,3,9,2300,0,1997,1997,98052,47.684,122.16,2300,8187,18,0,5.5,4600,10487
8.44e+05,2015,451,4,3.5,3350,6350,2,0,2,3,8,2610,740,2009,2009,98116,47.56,122.39,1820,6350,6,0,7.5,5170,9700
3.34e+05,2014,303,5,1.75,2590,6720,1,0,0,4,7,1750,840,1979,1979,98055,47.435,122.19,1820,7521,35,0,6.75,4410,10111
8.35e+05,2014,162,3,3,2790,12523,2,1,4,4,8,1600,1190,1977,1977,98198,47.357,122.32,2990,11476,37,0,6,5780,14266
5e+05,2014,228,3,1.5,1960,8815,1,0,0,4,7,1020,940,1958,1958,98006,47.577,122.16,1760,9534,56,0,4.5,3720,11494
5.25e+05,2014,189,4,2.5,3670,9958,2,0,0,3,10,3670,0,2005,2005,98058,47.462,122.16,3300,10679,9,0,6.5,6970,14349
1.275e+06,2014,339,4,2.5,2720,16454,1,0,1,5,9,1870,850,1963,1963,98040,47.549,122.22,3560,15993,51,0,6.5,6280,18713
5.75e+05,2015,393,3,1.75,1760,10349,1,0,0,3,8,1760,0,1957,1957,98005,47.635,122.17,1970,10933,58,0,4.75,3730,12693
5.15e+05,2014,140,4,2.5,2670,8765,2,0,0,3,9,2670,0,2006,2006,98059,47.488,122.15,2880,8765,8,0,6.5,5550,11435
3.25e+05,2015,478,3,2.5,1800,8518,2,0,0,3,7,1800,0,1996,1996,98030,47.364,122.19,1770,7570,19,0,5.5,3570,9370
4.6695e+05,2014,224,3,1,1360,3880,1,0,0,3,7,1060,300,1963,1963,98117,47.684,122.39,1110,3880,51,0,4,2470,5240
2.61e+05,2014,286,3,2.25,1584,2800,2,0,0,3,7,1584,0,2012,2012,98002,47.345,122.21,1584,2800,2,0,5.25,3168,4384
3.05e+05,2014,221,3,2.5,2460,5027,2,0,0,3,8,2460,0,2002,2002,98042,47.372,122.1,2740,5000,12,0,5.5,5200,7460
8.3001e+05,2014,238,4,3.75,3610,7904,3,0,0,3,11,3290,320,1994,1994,98117,47.699,122.39,2460,7300,20,0,7.75,6070,10910
1.315e+06,2014,132,4,3.5,3460,3997,2,0,0,3,10,2560,900,2004,2004,98103,47.672,122.33,1860,4000,10,0,7.5,5320,7460
4.65e+05,2014,155,3,2.25,1530,1245,2,0,0,3,9,1050,480,2014,2014,98122,47.602,122.3,1530,2307,0,0,5.25,3060,3837
3.58e+05,2015,373,3,1.5,1150,27319,1,0,0,4,6,1150,0,1976,1976,98070,47.393,122.45,1700,30691,39,0,4.5,2850,31841
8.83e+05,2014,163,4,2.5,3670,54450,2,0,0,3,10,3670,0,1999,1999,98074,47.621,122.02,2900,49658,15,0,6.5,6570,53328
8.1e+05,2014,211,4,2.75,3010,10450,2,0,0,3,9,3010,0,1996,1996,98052,47.698,122.11,3010,10530,18,0,6.75,6020,13540
2.375e+05,2015,366,3,2,1350,8960,1,0,0,4,7,1350,0,1986,1986,98038,47.361,122.05,1470,8288,29,0,5,2820,9638
1.115e+06,2015,400,3,2.5,4530,22873,2,0,2,5,8,3220,1310,1912,1912,98166,47.457,122.37,3100,18210,103,0,5.5,7630,22740
4.12e+05,2014,232,3,1,1000,3844,1,0,0,5,7,900,100,1928,1928,98133,47.703,122.35,1000,3920,86,0,4,2000,4920
8.6433e+05,2014,214,5,3.25,3480,6507,2,0,0,3,9,3480,0,2014,2014,98074,47.607,122.05,3360,5398,0,0,8.25,6840,8878
6.05e+05,2015,403,4,1.75,3280,35160,1,0,0,3,7,2080,1200,1976,1976,98053,47.673,122.06,2510,31331,39,0,5.75,5790,34611
2.46e+05,2014,283,4,2,1400,7632,1,0,0,5,6,1400,0,1930,1930,98166,47.462,122.34,1400,7632,84,0,6,2800,9032
3.45e+05,2014,147,2,1.5,1180,844,2,0,0,3,7,990,190,2005,2005,98144,47.6,122.3,1170,1400,9,0,3.5,2350,2580
8.0995e+05,2014,161,4,2.5,3280,6181,2,0,0,3,10,3280,0,2001,2001,98074,47.648,122.08,3110,7570,13,0,6.5,6390,10850
5.5e+05,2015,483,2,1,1070,3000,1,0,0,4,7,870,200,1926,1926,98103,47.683,122.35,1890,3300,89,0,3,2960,4370
3.2e+05,2015,464,4,2.5,2130,9653,1,0,0,3,7,1500,630,1978,1978,98031,47.407,122.17,2000,7988,37,0,6.5,4130,10118
3.625e+05,2015,477,3,2,1940,40588,1,0,0,3,7,1940,0,2000,2000,98058,47.425,122.16,1860,9657,15,0,5,3800,11597
2.25e+05,2014,218,3,1.75,1350,9793,1,0,0,4,7,1350,0,1968,1968,98022,47.198,122,1690,8080,46,0,4.75,3040,9430
3.87e+05,2014,299,3,1.75,1810,10800,1,0,0,5,8,1210,600,1968,1968,98056,47.524,122.18,1800,10800,46,0,4.75,3610,12610
2.1618e+05,2014,291,2,1,1120,7797,1,0,0,3,6,1120,0,1948,1948,98055,47.487,122.22,2180,7200,66,0,3,3300,8320
2.595e+05,2014,177,3,1.75,1650,12349,1,0,0,3,7,1650,0,1957,1957,98188,47.442,122.28,1470,10763,57,0,4.75,3120,12413
3.82e+05,2014,141,5,2.25,2880,11965,2,0,0,4,8,2880,0,1990,1990,98042,47.373,122.12,2370,10715,24,0,7.25,5250,13595
4.225e+05,2015,465,3,1,1270,8920,1,0,0,5,7,1270,0,1969,1969,98056,47.534,122.17,1590,8589,46,0,4,2860,9859
3.255e+05,2015,407,4,1.75,2290,8142,1,0,0,4,7,1490,800,1969,1969,98055,47.456,122.21,1840,8142,46,0,5.75,4130,10432
5.62e+05,2014,245,3,2.5,2400,97138,2,0,0,5,8,2400,0,1983,1983,98077,47.736,122.05,2230,54450,31,0,5.5,4630,56850
8.5999e+05,2014,191,4,2.75,3520,5500,2,0,0,3,9,3520,0,2014,2014,98074,47.618,122.06,3340,5500,0,0,6.75,6860,9020
1.925e+05,2014,278,3,1.75,1420,7205,1,0,0,3,7,1420,0,1986,1986,98030,47.355,122.17,1690,7405,28,0,4.75,3110,8825
6.5e+05,2014,225,3,2,1340,2720,1,0,0,3,7,1340,0,1913,1913,98103,47.652,122.33,2030,4590,101,0,5,3370,5930
3.539e+05,2014,258,3,2.5,2517,3900,2,0,0,3,8,2517,0,2014,2014,98092,47.321,122.18,2390,7108,0,0,5.5,4907,9625
6.78e+05,2014,232,3,2.25,2730,10675,2,0,0,3,9,2730,0,1990,1990,98074,47.629,122.04,2770,10570,24,0,5.25,5500,13300
8.365e+05,2014,243,3,2.5,2230,7200,3,0,3,3,9,2230,0,1996,1996,98118,47.558,122.27,2230,7200,18,0,5.5,4460,9430
6.625e+05,2015,390,3,2,2070,4200,1,0,0,4,7,1670,400,1906,1906,98103,47.662,122.33,1490,4560,109,0,5,3560,6630
5.3e+05,2014,191,4,2.25,2130,8640,1,0,0,3,7,1430,700,1969,1969,98034,47.709,122.2,2120,8826,45,0,6.25,4250,10956
3.19e+05,2015,436,4,3.25,2360,8344,2,0,0,3,8,2360,0,1990,1990,98058,47.44,122.13,1860,8410,25,0,7.25,4220,10770
7.62e+05,2014,139,5,2,3370,5000,1,0,0,4,7,2140,1230,1907,1907,98109,47.637,122.35,1920,3200,107,0,7,5290,6570
2.2e+05,2014,183,4,1,1200,6000,1,0,0,3,6,1200,0,1923,1923,98106,47.531,122.35,950,4000,91,0,5,2150,5200
9.36e+05,2014,167,3,1.75,2960,12420,1,0,2,4,8,1480,1480,1952,1952,98116,47.574,122.41,2700,9106,62,0,4.75,5660,12066
2.37e+05,2015,372,3,1,920,5546,1,0,0,2,6,920,0,1928,1928,98125,47.711,122.28,1300,5546,87,0,4,2220,6466
2.36e+05,2014,174,4,2.75,2000,5827,2,0,0,3,7,2000,0,1997,1997,98038,47.363,122.03,1710,6929,17,0,6.75,3710,8929
4e+05,2014,251,3,2.25,1190,1149,2,0,0,3,8,1050,140,2008,2008,98116,47.582,122.39,1210,1316,6,0,5.25,2400,2506
5.5e+05,2014,180,4,1.5,2750,1.285e+05,1,0,0,2,7,1500,1250,1958,1958,98055,47.434,122.2,1470,11514,56,0,5.5,4220,14264
2.2e+05,2014,339,3,1.75,1650,8850,1,0,0,3,7,1650,0,1959,1959,98188,47.433,122.29,1400,8800,55,0,4.75,3050,10450
2.465e+05,2014,201,3,2,1430,8919,1,0,0,3,7,1430,0,1992,1992,98022,47.212,121.98,1580,8919,22,0,5,3010,10349
1.849e+05,2014,210,3,1,1040,10080,1,0,0,3,6,1040,0,1959,1959,98023,47.329,122.34,1000,8736,55,0,4,2040,9776
3.53e+05,2014,142,1,1,550,1279,2,0,0,3,7,550,0,2008,2008,98122,47.616,122.31,1460,1385,6,0,2,2010,1935
7.5484e+05,2014,271,3,2.5,2930,5641,2,0,0,3,8,2930,0,2013,2013,98052,47.71,122.11,3300,5641,1,0,5.5,6230,8571
3.67e+05,2014,291,3,2.25,1400,1320,3,0,2,3,8,1400,0,2006,2006,98133,47.715,122.36,1490,1449,8,0,5.25,2890,2849
3.19e+05,2014,217,4,2.5,1930,8336,2,0,0,3,8,1930,0,1995,1995,98031,47.402,122.17,2280,7959,19,0,6.5,4210,9889
5.75e+05,2015,459,4,1.75,2330,8800,1,0,2,4,7,1260,1070,1961,1961,98008,47.615,122.11,2270,8800,54,0,5.75,4600,11130
6.54e+05,2014,341,3,2.5,2570,5500,1,0,0,4,7,1320,1250,1961,1961,98199,47.642,122.4,1460,6250,53,0,5.5,4030,8820
8.05e+05,2014,142,4,2.75,2410,6000,1,0,0,5,8,1410,1000,1950,1950,98107,47.671,122.4,1760,6000,64,0,6.75,4170,8410
4.16e+05,2014,215,4,1.75,1980,7840,1,0,0,4,7,990,990,1961,1961,98008,47.623,122.11,1520,8400,53,0,5.75,3500,10380
3.12e+05,2014,256,4,2,1890,8362,1,0,0,3,7,1890,0,1966,1966,98188,47.438,122.28,1600,9257,48,0,6,3490,11147
5.15e+05,2015,451,2,1,1150,5664,1,0,0,3,7,870,280,1948,1948,98115,47.689,122.28,1380,5664,67,0,3,2530,6814
6.35e+05,2015,416,4,2.5,2080,11176,1,0,0,5,8,2080,0,1954,1954,98125,47.711,122.29,1390,7928,61,0,6.5,3470,10008
5.21e+05,2014,230,4,2.25,1890,8034,1,0,0,4,8,1890,0,1967,1967,98008,47.634,122.12,1920,7210,47,0,6.25,3810,9100
4.99e+05,2015,477,4,3.75,2560,5250,2,0,0,3,7,1900,660,1963,2006,98133,47.733,122.34,1400,5250,52,1,7.75,3960,7810
4.32e+05,2014,306,3,2.5,1920,9812,2,0,0,3,8,1920,0,2000,2000,98028,47.763,122.24,1830,10534,14,0,5.5,3750,12454
3.17e+05,2014,292,3,2,2020,7260,1,0,0,3,7,1180,840,1926,1926,98108,47.55,122.31,1400,5950,88,0,5,3420,7970
3.897e+05,2015,376,3,2.5,1720,3581,2,0,0,3,7,1720,0,2011,2011,98053,47.686,122.01,1720,3600,4,0,5.5,3440,5320
3.59e+05,2015,372,4,2.5,1820,11325,1,0,0,3,8,1390,430,1976,1976,98166,47.457,122.36,1990,10802,39,0,6.5,3810,12622
8.8e+05,2015,484,4,2.5,2350,4675,2,0,0,3,9,2150,200,1923,1923,98112,47.634,122.31,2240,3848,92,0,6.5,4590,6198
4.61e+05,2015,453,3,2.25,1620,998,2,0,0,3,8,1540,80,2012,2012,98027,47.539,122.03,1620,1068,3,0,5.25,3240,2688
3.28e+05,2014,214,4,2.5,1850,5388,2,0,0,3,8,1850,0,2009,2009,98038,47.349,122.04,2140,5086,5,0,6.5,3990,6936
3.9995e+05,2014,338,3,2.5,1470,4488,2,0,0,5,7,1470,0,1980,1980,98034,47.723,122.16,1400,4441,34,0,5.5,2870,5911
2.15e+05,2014,135,3,1,1160,10384,1,0,0,4,6,1160,0,1969,1969,98038,47.363,122.03,1200,9880,45,0,4,2360,11040
4.15e+05,2014,319,3,1.75,1640,6435,1,0,0,3,7,1190,450,1972,1972,98034,47.72,122.22,1770,6930,42,0,4.75,3410,8570
2.3498e+05,2015,440,3,1.75,1650,8073,1,0,0,3,7,1100,550,1980,1980,98092,47.319,122.18,1280,8073,35,0,4.75,2930,9723
2.71e+05,2014,359,2,1,710,4240,1,0,0,4,6,710,0,1942,1942,98106,47.523,122.35,850,5200,72,0,3,1560,5910
5.45e+05,2015,479,5,3.75,2380,7268,1,0,0,3,8,1430,950,2008,2008,98106,47.557,122.36,2040,10810,7,0,8.75,4420,13190
1.77e+05,2015,423,3,1,870,5200,1,0,0,5,6,870,0,1969,1969,98042,47.37,122.08,870,5200,46,0,4,1740,6070
5.3e+05,2014,244,3,1.75,1680,7770,1,0,0,4,7,1680,0,1967,1967,98005,47.603,122.17,1880,7770,47,0,4.75,3560,9450
7.4e+05,2014,148,2,1.75,2080,4800,1,0,0,5,7,1080,1000,1923,1923,98117,47.69,122.36,1310,4800,91,0,3.75,3390,6880
2.67e+05,2014,248,3,1.5,1030,8223,1,0,0,4,7,1030,0,1952,1952,98148,47.428,122.33,1460,9463,62,0,4.5,2490,10493
6.03e+05,2015,460,4,2.25,2370,11310,1,0,0,3,8,1550,820,1968,1968,98155,47.768,122.29,1890,8621,47,0,6.25,4260,10991
1.285e+06,2014,148,4,2.5,3240,10800,1,0,0,3,10,2260,980,1946,1946,98105,47.671,122.26,3490,10800,68,0,6.5,6730,14040
5.1e+05,2015,368,4,3.25,1980,9988,1,0,0,3,8,1340,640,1980,1980,98052,47.688,122.11,1980,8972,35,0,7.25,3960,10952
4.184e+05,2014,320,4,2.5,2906,5893,2,0,0,3,9,2906,0,2014,2014,98092,47.26,122.19,2680,4950,0,0,6.5,5586,7856
4.22e+05,2015,478,3,1,1160,7854,1,0,0,3,7,1160,0,1960,1960,98125,47.73,122.31,1300,8317,55,0,4,2460,9477
4.05e+05,2015,481,2,3,1160,1073,2,0,0,3,7,880,280,2007,2007,98144,47.579,122.31,1250,4812,8,0,5,2410,5972
6.25e+05,2014,203,4,2,1410,4480,1,0,0,3,8,1410,0,1927,1927,98109,47.639,122.34,1240,3400,87,0,6,2650,4810
3.45e+05,2014,181,2,1,1080,7775,1,0,0,3,6,1080,0,1955,1955,98136,47.545,122.39,1730,7350,59,0,3,2810,8430
3.4595e+05,2014,173,3,2.5,2110,4118,2,0,0,3,8,2110,0,1989,1989,98042,47.388,122.15,2110,4044,25,0,5.5,4220,6154
7.75e+05,2015,433,3,3,1820,4300,1,0,0,4,8,1620,200,1914,1983,98107,47.671,122.36,1440,4300,101,1,6,3260,6120
4.8e+05,2015,447,3,1.5,1200,3060,1,0,0,4,7,1060,140,1910,1910,98115,47.679,122.31,1410,3060,105,0,4.5,2610,4260
1.75e+05,2015,433,2,1,1330,28270,1,0,0,3,6,1330,0,1925,1925,98168,47.482,122.27,1210,6926,90,0,3,2540,8256
9.8e+05,2014,194,4,2,2190,4560,2,0,0,5,8,2190,0,1910,1910,98103,47.662,122.33,2190,4560,104,0,6,4380,6750
2.52e+05,2014,311,3,2.5,1680,8284,2,0,0,3,7,1680,0,1989,1989,98038,47.361,122.05,1550,8284,25,0,5.5,3230,9964
3.51e+05,2014,264,4,1,1550,7260,1,0,0,4,6,1550,0,1959,1959,98008,47.623,122.12,1210,7260,55,0,5,2760,8810
4.5e+05,2015,431,3,2.25,1420,13468,1,0,0,3,7,960,460,1976,1976,98033,47.669,122.18,1480,10980,39,0,5.25,2900,12400
2.79e+05,2014,202,3,1,1320,5750,1,0,0,3,7,1320,0,1913,1913,98108,47.529,122.33,1010,5700,101,0,4,2330,7020
1.53e+05,2014,163,3,1,1270,6405,1,0,0,3,6,1270,0,1944,1944,98178,47.496,122.24,1110,6405,70,0,4,2380,7675
9.5e+05,2014,215,3,3,4040,14338,2,0,0,3,10,3030,1010,1986,1986,98077,47.727,122.06,3360,14142,28,0,6,7400,18182
2.917e+05,2015,457,3,2.5,1970,4120,1,0,0,3,6,1230,740,1927,1927,98106,47.533,122.35,1470,4080,88,0,5.5,3440,6050
3.3e+05,2015,459,2,1,1129,3840,1,0,0,3,7,1129,0,1953,1953,98106,47.531,122.35,1300,3880,62,0,3,2429,5009
8.09e+05,2014,167,3,2.5,2590,7720,2,0,0,3,9,2590,0,1988,1988,98007,47.659,122.15,2600,9490,26,0,5.5,5190,12080
6.674e+05,2014,202,4,2.5,2660,40312,2,0,0,4,8,2660,0,1977,1977,98072,47.753,122.14,2650,45302,37,0,6.5,5310,47962
8.85e+05,2015,381,3,2.25,2940,6500,3,0,0,3,9,2940,0,2014,2014,98136,47.548,122.39,1680,6500,1,0,5.25,4620,9440
4.15e+05,2014,211,4,2.5,1160,16008,1,0,0,4,7,1160,0,1989,1989,98155,47.764,122.3,1570,12645,25,0,6.5,2730,13805
2.35e+05,2014,292,2,1,1500,8015,1,0,0,3,6,1500,0,1947,1947,98146,47.503,122.35,1130,8015,67,0,3,2630,9515
2.4e+05,2014,216,2,1.5,1670,9880,1,0,0,4,7,1670,0,1941,1963,98146,47.486,122.35,1670,9807,73,1,3.5,3340,11477
3.41e+05,2014,136,3,2.5,1480,1663,2,0,0,3,9,1180,300,2012,2012,98126,47.544,122.38,1380,1537,2,0,5.5,2860,3017
2.55e+05,2015,447,4,2.5,2163,5882,2,0,0,3,7,2163,0,2006,2006,98001,47.274,122.25,1760,9600,9,0,6.5,3923,11763
4.65e+05,2014,133,3,1.5,1270,5112,1,0,0,3,7,1270,0,1950,1950,98115,47.676,122.29,1580,5080,64,0,4.5,2850,6350
2.295e+05,2014,277,3,1.5,1810,14400,1,0,0,4,7,1810,0,1954,1954,98001,47.289,122.27,1710,12000,60,0,4.5,3520,13810
4.43e+05,2014,187,5,1.75,1650,3000,1,0,0,3,8,1650,0,1902,1902,98144,47.596,122.31,1740,4000,112,0,6.75,3390,5650
5.77e+05,2014,278,2,1.75,2070,23160,1,0,0,3,7,1260,810,1946,1946,98199,47.655,122.39,1690,5458,68,0,3.75,3760,7528
6.2899e+05,2015,430,4,2.5,2540,32647,2,0,0,3,9,2540,0,1996,1996,98053,47.632,121.99,2740,32647,19,0,6.5,5280,35187
4.82e+05,2014,210,2,2.25,1350,1248,2,0,0,3,7,1180,170,2000,2000,98102,47.64,122.32,1760,3360,14,0,4.25,3110,4710
5.4312e+05,2015,425,2,1,1380,5484,1,0,0,3,8,1030,350,1947,1947,98199,47.638,122.4,1380,5347,68,0,3,2760,6727
4.9e+05,2014,265,3,1.5,990,1343,2,0,0,3,8,840,150,2007,2007,98112,47.624,122.31,1350,2521,7,0,4.5,2340,3511
4.8e+05,2014,196,3,2.5,1940,10035,2,0,0,4,8,1940,0,1994,1994,98072,47.744,122.17,2810,8333,20,0,5.5,4750,10273
2.45e+05,2014,128,3,1.5,1260,7964,1,0,0,4,7,1260,0,1955,1955,98148,47.431,122.33,1510,8776,59,0,4.5,2770,10036
2.0995e+05,2014,187,3,1.5,1180,7300,1,0,0,4,7,1180,0,1968,1968,98002,47.286,122.2,2030,8424,46,0,4.5,3210,9604
6.45e+05,2014,230,3,2,2130,4000,2,0,0,3,7,2130,0,1908,1908,98115,47.674,122.32,2010,4000,106,0,5,4140,6130
4.1311e+05,2014,285,3,1.5,1420,7520,1,0,0,4,7,1420,0,1956,1956,98007,47.601,122.13,2000,7520,58,0,4.5,3420,8940
9.1556e+05,2015,436,5,3.25,3740,11536,2,0,0,4,9,2540,1200,1984,1984,98006,47.56,122.11,2920,11258,31,0,8.25,6660,14998
6.25e+05,2014,232,3,1.75,2240,6050,1,0,0,4,8,1250,990,1950,1950,98116,47.566,122.4,1720,6050,64,0,4.75,3960,8290
4.19e+05,2014,122,3,1.5,1570,6700,1,0,0,4,7,1570,0,1956,1956,98007,47.602,122.13,1570,7300,58,0,4.5,3140,8870
6.6e+05,2015,433,2,1,1070,5000,1,0,0,3,7,1070,0,1924,1924,98103,47.663,122.34,1400,4000,91,0,3,2470,5070
5.7e+05,2015,472,3,1,1660,7650,1,0,0,3,7,1350,310,1910,1910,98118,47.558,122.28,1750,5760,105,0,4,3410,7420
5.55e+05,2014,269,3,3.5,2100,2479,2,0,0,3,9,1450,650,2011,2011,98118,47.562,122.29,1800,2457,3,0,6.5,3900,4557
7.2e+05,2015,414,3,1.75,1370,1990,3,0,0,3,9,1370,0,2014,2014,98102,47.643,122.32,1730,1990,1,0,4.75,3100,3360
1.9e+05,2014,135,3,1,1090,8520,1,0,0,3,7,1090,0,1967,1967,98003,47.336,122.31,1190,8520,47,0,4,2280,9610
2.34e+05,2014,205,3,1,1750,8820,1,0,0,4,7,1750,0,1961,1961,98032,47.361,122.29,1400,9600,53,0,4,3150,11350
2.5e+05,2015,456,2,0.75,700,16828,1,0,0,4,6,700,0,1958,1958,98092,47.301,122.13,2010,29316,57,0,2.75,2710,30016
1.2565e+06,2014,150,4,2.5,3150,13700,2,0,0,4,9,3150,0,1966,1966,98040,47.531,122.22,3200,11900,48,0,6.5,6350,15050
2.999e+05,2014,348,4,2.5,1580,3632,2,0,0,3,7,1580,0,2011,2011,98038,47.367,122.02,1950,3800,3,0,6.5,3530,5380
3.1e+05,2015,464,5,3,2270,5001,1,0,0,3,7,1360,910,1989,1989,98108,47.554,122.3,1950,5500,26,0,8,4220,7770
2.585e+05,2015,429,3,2,1460,7930,1,0,0,3,7,1460,0,1989,1989,98038,47.359,122.05,1630,7930,26,0,5,3090,9390
9.11e+05,2015,484,4,3.25,3526,15958,2,0,0,3,10,3526,0,1997,1997,98075,47.567,122.03,3639,15090,18,0,7.25,7165,18616
3.7495e+05,2014,199,4,2.5,2790,4650,2,0,0,3,8,2790,0,2004,2004,98038,47.356,122.03,2850,4650,10,0,6.5,5640,7440
3.15e+05,2014,311,2,1,840,5087,1,0,0,3,7,840,0,1925,1925,98118,47.556,122.28,1590,5087,89,0,3,2430,5927
7.75e+05,2014,294,4,2.75,3500,6226,2,0,0,3,9,3500,0,2004,2004,98053,47.685,122.05,3480,7222,10,0,6.75,6980,10722
2.7e+05,2014,175,3,2.5,1670,8364,1,0,0,4,7,1300,370,1990,1990,98042,47.369,122.08,1490,8143,24,0,5.5,3160,9813
1.6505e+05,2014,181,3,1,1200,8514,1,0,0,3,7,1200,0,1959,1959,98022,47.204,122.01,1210,8985,55,0,4,2410,10185
2.34e+05,2014,293,4,2,1710,7455,1,0,0,3,7,1030,680,1975,1975,98031,47.397,122.17,1710,7350,39,0,6,3420,9060
2.7e+05,2015,374,4,2.5,1670,8056,1,0,0,3,7,1170,500,1961,1961,98168,47.488,122.32,1360,8056,54,0,6.5,3030,9726
2.42e+05,2014,272,5,2.25,2340,7494,1,0,0,3,7,1170,1170,1951,1951,98188,47.448,122.28,1650,10125,63,0,7.25,3990,12465
3.675e+05,2014,216,5,3,2980,10064,1,0,0,3,7,1680,1300,1940,1940,98155,47.737,122.32,1590,7800,74,0,8,4570,10780
5.625e+05,2015,481,2,1,1170,2800,1,0,0,4,5,1170,0,1905,1905,98103,47.657,122.34,1660,4996,110,0,3,2830,6166
4.1e+05,2015,440,4,1,1970,4740,1,0,0,3,7,1670,300,1904,2005,98122,47.614,122.3,1510,4740,111,1,5,3480,6710
4e+05,2015,365,6,2.5,3060,17112,1,0,0,4,8,1530,1530,1967,1967,98058,47.438,122.15,2690,16038,48,0,8.5,5750,19098
3.27e+05,2014,177,5,2.75,2400,8050,2,0,0,3,8,2400,0,1998,1998,98092,47.264,122.21,2400,8050,16,0,7.75,4800,10450
6.85e+05,2015,408,4,2,2290,6000,1,0,3,5,7,2290,0,1900,1900,98115,47.681,122.32,2000,3150,115,0,6,4290,5440
4.65e+05,2014,147,3,2,1560,8640,1,0,0,5,7,1560,0,1967,1967,98034,47.729,122.19,1970,8625,47,0,5,3530,10185
2.85e+05,2014,154,3,2.5,2437,5136,2,0,0,3,7,2437,0,2011,2011,98002,47.352,122.21,2437,4614,3,0,5.5,4874,7051
5.5995e+05,2014,194,3,2.5,2120,4310,2,0,0,3,7,2120,0,2001,2001,98053,47.687,122.04,2280,4380,13,0,5.5,4400,6500
3.299e+05,2014,140,3,2.5,2170,4905,2,0,0,3,8,2170,0,2004,2004,98038,47.35,122.04,2300,4935,10,0,5.5,4470,7105
1.85e+05,2015,368,2,1,670,6750,1,0,0,4,5,670,0,1947,1947,98188,47.452,122.28,1700,11520,68,0,3,2370,12190
5.65e+05,2015,429,3,1,1610,4108,1,0,0,5,7,1610,0,1928,1928,98126,47.57,122.38,1680,4467,87,0,4,3290,6077
4.99e+05,2015,433,6,1.75,2400,7500,1,0,0,3,7,1400,1000,1975,1975,98155,47.766,122.31,1980,7500,40,0,7.75,4380,9900
4.325e+05,2014,222,3,2.5,1930,7120,1,0,0,4,7,1420,510,1961,1961,98133,47.772,122.34,1600,8352,53,0,5.5,3530,10282
6.46e+05,2014,168,5,2.75,2870,4461,1,0,0,3,7,1650,1220,1976,1976,98107,47.675,122.39,1890,4196,38,0,7.75,4760,7066
3.759e+05,2015,402,3,2,1824,7120,1,0,0,3,9,1824,0,2010,2010,98001,47.346,122.27,2409,6264,5,0,5,4233,8088
6.275e+05,2015,464,4,2.5,2540,11500,1,0,0,4,8,1640,900,1979,1979,98006,47.561,122.15,2820,9800,36,0,6.5,5360,12340
4.45e+05,2014,256,3,1.75,1850,16863,1,0,0,4,7,1280,570,1980,1980,98034,47.717,122.22,1790,9000,34,0,4.75,3640,10850
7.11e+05,2014,194,3,2.5,2550,5376,2,0,0,3,9,2550,0,2004,2004,98052,47.665,122.08,2250,4050,10,0,5.5,4800,6600
2.195e+05,2014,176,3,1,1090,6710,1,0,0,5,5,1090,0,1912,1912,98002,47.307,122.22,1170,6708,102,0,4,2260,7798
1.08e+06,2015,410,3,2.5,1990,1891,3,0,0,3,9,1990,0,2012,2012,98102,47.627,122.32,1990,3600,3,0,5.5,3980,5590
2.5988e+05,2015,426,5,2.5,2200,6250,2,0,0,3,7,2200,0,1996,1996,98038,47.367,122.02,1850,6091,19,0,7.5,4050,8291
5.7e+05,2014,214,5,1.75,2510,9750,1,0,0,3,8,2510,0,1969,1969,98052,47.663,122.15,1900,9750,45,0,6.75,4410,12260
2.9e+05,2014,211,3,2.5,2000,7414,2,0,0,4,7,2000,0,1993,1993,98038,47.351,122.06,2000,7414,21,0,5.5,4000,9414
5.418e+05,2014,283,4,2.5,3118,7866,2,0,2,3,9,3118,0,2014,2014,98001,47.293,122.26,2673,6500,0,0,6.5,5791,9618
3.9e+05,2015,447,3,1.75,2160,98445,2,0,0,3,8,2160,0,1978,1978,98042,47.35,122.16,2004,44431,37,0,4.75,4164,46591
4.31e+05,2014,195,3,2.5,1710,12677,2,0,0,3,8,1710,0,1996,1996,98028,47.75,122.23,1610,12160,18,0,5.5,3320,13870
8.1e+05,2015,388,3,2.5,2610,8481,2,0,0,3,10,2610,0,1993,1993,98006,47.553,122.11,3140,10008,22,0,5.5,5750,12618
8.12e+05,2014,232,3,2.5,2040,4559,2,0,0,3,9,2040,0,1998,1998,98122,47.616,122.3,1500,4500,16,0,5.5,3540,6540
3.55e+05,2014,188,4,2.75,3000,5470,2,0,0,3,8,3000,0,2005,2005,98038,47.361,122.04,2420,4891,9,0,6.75,5420,7891
2.45e+05,2014,250,2,1,1050,5900,1,0,0,3,7,1050,0,1950,1950,98126,47.533,122.38,1280,5900,64,0,3,2330,6950
3.6565e+05,2015,431,4,2.25,2380,7700,2,0,0,4,8,2380,0,1977,1977,98055,47.439,122.19,2100,7700,38,0,6.25,4480,10080
3.95e+05,2015,368,4,2.25,1780,10748,2,0,0,4,8,1780,0,1964,1964,98072,47.762,122.11,2070,37680,51,0,6.25,3850,39460
6.2e+05,2015,376,3,1.75,2140,5808,1,0,1,3,7,1070,1070,1947,1947,98119,47.644,122.37,1930,5808,68,0,4.75,4070,7948
2.6e+05,2015,429,2,1,690,6000,1,0,0,3,6,690,0,1949,1949,98118,47.562,122.28,840,3030,66,0,3,1530,3720
4.1e+05,2015,478,3,2.25,1420,3750,2,0,0,3,7,1420,0,1987,1987,98116,47.572,122.38,1430,4664,28,0,5.25,2850,6084
9.5e+05,2015,464,3,2.5,2280,2296,3,0,0,3,9,1890,390,2013,2013,98112,47.626,122.3,1390,4000,2,0,5.5,3670,6280
2.69e+05,2014,232,4,1,1610,8401,1,0,0,3,7,1610,0,1958,1958,98056,47.51,122.17,1610,8401,56,0,5,3220,10011
9.02e+05,2014,143,4,2.25,2530,9200,1,0,0,5,9,1570,960,1976,1976,98006,47.561,122.15,3030,9400,38,0,6.25,5560,11930
5.099e+05,2014,239,3,1.75,1690,53578,1,0,0,3,8,1690,0,1984,1984,98053,47.655,122.05,2290,52707,30,0,4.75,3980,54397
3.32e+05,2014,285,4,2.5,2380,5737,2,0,0,3,7,2380,0,2010,2010,98023,47.282,122.36,2380,5396,4,0,6.5,4760,7776
4.32e+05,2015,386,2,1,960,3235,1,0,0,4,7,960,0,1916,1916,98103,47.661,122.34,1290,2069,99,0,3,2250,3029
4.52e+05,2014,202,3,2,2270,1.4898e+05,1,0,0,4,6,1270,1000,1900,1980,98056,47.509,122.19,2210,17388,114,1,5,4480,19658
4.35e+05,2015,382,6,2.5,2270,11970,1,0,0,3,7,1470,800,1964,1964,98011,47.772,122.2,2270,10640,51,0,8.5,4540,12910
2.75e+05,2014,258,4,1.75,1960,6177,1,0,0,4,8,1960,0,1967,1967,98023,47.313,122.38,2010,8162,47,0,5.75,3970,10122
4.9e+05,2015,387,3,1.5,1970,3400,1,0,0,4,8,1420,550,1929,1929,98122,47.616,122.29,1940,4000,86,0,4.5,3910,5970
5.7e+05,2014,290,2,1,1790,3760,1,0,0,4,8,1490,300,1912,1912,98144,47.593,122.29,1458,3760,102,0,3,3248,5550
2.0995e+05,2015,460,2,1,860,5080,1,0,0,3,7,860,0,1960,1960,98032,47.39,122.24,1250,6477,55,0,3,2110,7337
4.45e+05,2014,326,2,1.5,1510,2001,2,0,0,4,8,1510,0,1985,1985,98007,47.621,122.15,1510,2055,29,0,3.5,3020,3565
4.25e+05,2015,395,3,1,1010,5864,1,0,0,3,7,1010,0,1915,1915,98116,47.573,122.38,1290,5000,100,0,4,2300,6010
3.6287e+05,2014,233,4,2.5,2245,4301,2,0,0,3,8,2245,0,2014,2014,98038,47.355,122.06,2530,4478,0,0,6.5,4775,6723
2.35e+05,2014,215,2,1,870,5000,1,0,0,3,6,870,0,1949,1949,98126,47.519,122.38,820,5000,65,0,3,1690,5870
4.2559e+05,2015,417,3,2.75,1940,3088,2,0,3,3,8,1770,170,2008,2008,98065,47.519,121.88,1410,2335,7,0,5.75,3350,4275
5.12e+05,2015,424,3,1.75,1610,12555,1,0,0,3,7,1080,530,1977,1977,98052,47.662,122.14,1780,10374,38,0,4.75,3390,11984
3.855e+05,2014,141,3,2,1540,7947,1,0,0,3,7,1120,420,1961,1961,98011,47.761,122.22,1910,7950,53,0,5,3450,9490
2.81e+05,2015,471,4,2.25,1677,3600,2,0,0,3,7,1677,0,2012,2012,98092,47.32,122.18,1677,3600,3,0,6.25,3354,5277
3.615e+05,2015,451,4,2.5,1980,7334,2,0,0,3,7,1980,0,2003,2003,98038,47.353,122.04,1850,7134,12,0,6.5,3830,9114
2.8e+05,2015,480,3,1.5,1430,8861,1,0,0,3,7,1430,0,1956,1956,98188,47.445,122.29,1080,9425,59,0,4.5,2510,10855
3.2e+05,2015,479,3,2.5,1530,2890,2,0,0,3,7,1530,0,2001,2001,98108,47.543,122.29,1540,2890,14,0,5.5,3070,4420
1.0108e+06,2014,312,4,3.25,3610,4000,2,0,0,3,9,2640,970,2007,2007,98199,47.658,122.4,1980,4000,7,0,7.25,5590,7610
4.25e+05,2014,266,3,2,1500,8086,1,0,0,3,7,1060,440,1981,1981,98027,47.558,122.08,1550,8086,33,0,5,3050,9586
5.65e+05,2014,341,4,2.75,2730,6856,2,0,0,3,8,2730,0,2003,2003,98072,47.774,122.16,2520,5569,11,0,6.75,5250,8299
8.55e+05,2014,262,4,2.75,2270,10460,2,0,0,3,9,2270,0,1965,1965,98040,47.56,122.22,2610,10180,49,0,6.75,4880,12450
1.5e+05,2014,197,2,1,830,4045,1,0,0,3,6,830,0,1943,1943,98106,47.529,122.35,1100,4116,71,0,3,1930,4946
1.56e+05,2014,314,2,1.75,590,6138,1,0,0,2,5,590,0,1947,1947,98118,47.545,122.28,1360,7112,67,0,3.75,1950,7702
5.488e+05,2014,187,4,1,1660,4704,1,0,0,3,7,1260,400,1930,1930,98115,47.692,122.32,1360,5413,84,0,5,3020,7073
3.8e+05,2014,258,3,2.5,1980,17342,2,1,4,3,10,1580,400,1984,1984,98166,47.455,122.37,2060,17313,30,0,5.5,4040,19293
2.999e+05,2015,395,3,2.25,1560,35026,1,0,0,3,7,1290,270,1985,1985,98092,47.302,122.07,1660,35160,30,0,5.25,3220,36720
3e+06,2015,458,5,3.75,4590,11265,2,0,0,4,11,3450,1140,1927,1927,98112,47.639,122.29,3870,8996,88,0,8.75,8460,13586
3e+05,2014,140,3,1,1090,9900,1,0,0,4,7,1090,0,1955,1955,98052,47.675,122.16,1720,10419,59,0,4,2810,11509
5.63e+05,2015,366,6,1,1730,2760,1,0,0,3,7,1250,480,1918,1918,98109,47.634,122.35,1630,3200,97,0,7,3360,4930
4.4e+05,2014,310,3,2.5,1650,4929,2,0,0,3,7,1520,130,2007,2007,98108,47.563,122.3,1520,2287,7,0,5.5,3170,3937
1.799e+05,2014,238,3,1,1010,9920,1,0,0,3,6,1010,0,1977,1977,98042,47.324,122.14,1270,9680,37,0,4,2280,10690
3.4e+05,2014,298,3,2,1420,6060,1,0,0,5,7,830,590,1942,1942,98146,47.51,122.37,1420,6360,72,0,5,2840,7780
5.85e+05,2014,341,2,1.75,1830,7200,1,0,2,4,7,1070,760,1949,1949,98118,47.559,122.27,1570,6000,65,0,3.75,3400,7830
4.35e+05,2014,133,4,2.25,2140,6355,2,0,0,3,7,2140,0,2002,2002,98065,47.537,121.88,2480,5746,12,0,6.25,4620,7886
3.3815e+05,2014,242,4,2.25,2700,8580,2,0,0,3,8,2700,0,1992,1992,98022,47.209,122.01,2420,8580,22,0,6.25,5120,11280
4.78e+05,2014,300,2,1,820,6000,1,0,0,3,7,820,0,1939,1939,98199,47.649,122.39,1630,6000,75,0,3,2450,6820
5.76e+05,2014,194,3,1,1140,5395,1,0,0,4,7,1010,130,1909,1909,98115,47.678,122.31,1700,5376,105,0,4,2840,6516
1.9e+05,2014,195,4,2.5,1840,13493,2,0,0,3,7,1840,0,1994,1994,98001,47.265,122.24,1430,11463,20,0,6.5,3270,13303
4.45e+05,2015,460,4,2.5,2760,8558,2,0,0,3,7,2760,0,2001,2001,98056,47.48,122.19,2760,7703,14,0,6.5,5520,10463
6e+05,2015,451,3,3.25,1690,1473,2,0,0,3,8,1380,310,2008,2008,98109,47.64,122.34,1670,2594,7,0,6.25,3360,4284
2.55e+05,2014,277,3,1.75,1410,9315,1,0,0,5,7,1410,0,1960,1960,98031,47.397,122.2,1630,8250,54,0,4.75,3040,9660
2.9795e+05,2014,236,3,2,1390,5127,1,0,0,3,8,1390,0,1990,1990,98055,47.45,122.21,1960,5019,24,0,5,3350,6409
4.25e+05,2014,265,4,2.5,2480,4504,2,0,0,3,7,2480,0,2005,2005,98059,47.5,122.15,2950,4504,9,0,6.5,5430,6984
8.75e+05,2015,452,4,1.75,2360,8286,1,0,0,3,7,1320,1040,1952,1952,98004,47.623,122.2,1680,7630,63,0,5.75,4040,9990
1.85e+05,2014,127,4,1,1490,6600,1,0,0,3,7,1490,0,1969,1969,98168,47.483,122.33,1280,6600,45,0,5,2770,8090
4.1425e+05,2015,396,4,1.75,1640,13566,1,0,0,4,7,1120,520,1977,1977,98072,47.742,122.1,1470,13530,38,0,5.75,3110,15170
2.85e+05,2015,415,4,2.25,1970,7200,2,0,0,3,8,1970,0,1979,1979,98092,47.313,122.18,1790,7500,36,0,6.25,3760,9470
2.65e+05,2015,437,2,1,940,9458,1,0,0,3,6,940,0,1948,1948,98155,47.752,122.31,1450,9458,67,0,3,2390,10398
3.85e+05,2015,473,4,3,2253,7700,2,0,0,3,7,2253,0,1957,2014,98198,47.394,122.3,1786,9052,58,1,7,4039,11305
2.9726e+05,2015,399,3,2.5,1730,8076,2,0,0,3,8,1730,0,1994,1994,98003,47.262,122.31,1780,6930,21,0,5.5,3510,8660
8.35e+05,2015,415,4,2,3390,16025,2,0,0,4,10,3390,0,1987,1987,98077,47.722,122.06,3950,15277,28,0,6,7340,18667
3.2e+05,2014,343,3,2.5,1610,1356,2,0,0,3,8,1240,370,2007,2007,98106,47.526,122.36,1270,1314,7,0,5.5,2880,2924
2.35e+05,2014,360,2,1,830,9000,1,0,0,3,6,830,0,1939,1939,98032,47.381,122.24,1160,7680,75,0,3,1990,8510
2.08e+05,2015,466,2,1,700,5100,1,0,0,4,5,700,0,1953,1953,98056,47.496,122.17,970,5811,62,0,3,1670,6511
2.54e+05,2015,487,3,2,1470,7694,1,0,0,4,7,1470,0,1992,1992,98038,47.354,122.05,1580,7480,23,0,5,3050,8950
2.8517e+05,2014,235,3,2.25,2200,8375,2,0,0,3,8,2200,0,1988,1988,98092,47.263,122.22,2200,10002,26,0,5.25,4400,12202
3.06e+05,2014,134,3,1.5,1220,1086,3,0,0,3,8,1220,0,2007,2007,98133,47.705,122.35,1220,1422,7,0,4.5,2440,2642
4.75e+05,2014,223,3,1,1380,4635,1,0,0,4,6,1380,0,1919,1919,98144,47.57,122.28,1790,4635,95,0,4,3170,6015
3.1e+05,2015,431,3,2.5,1300,3612,2,0,0,3,7,1300,0,2005,2005,98118,47.533,122.28,1390,2943,10,0,5.5,2690,4243
1.08e+06,2014,176,4,3.5,3990,5267,2,0,0,3,10,3990,0,2008,2008,98006,47.564,122.12,3230,6481,6,0,7.5,7220,10471
5.1e+05,2015,369,4,2.5,3180,5405,2,0,0,3,7,3180,0,2001,2001,98059,47.49,122.14,2610,5403,14,0,6.5,5790,8583
2.25e+05,2014,291,3,2,1460,7740,1,0,0,3,7,1460,0,1968,1968,98003,47.347,122.31,1540,7644,46,0,5,3000,9104
9.2e+05,2014,283,4,2.5,3810,13579,2,0,0,3,10,3810,0,2003,2003,98007,47.601,122.15,3310,9270,11,0,6.5,7120,13080
7.5e+05,2014,122,3,1.75,2240,10578,2,0,0,5,8,1550,690,1923,1923,98115,47.695,122.29,1570,10578,91,0,4.75,3810,12818
6.51e+05,2014,127,3,2.5,3240,1.0837e+05,2,0,0,4,10,3240,0,1991,1991,98042,47.327,122.09,2090,1.0837e+05,23,0,5.5,5330,1.1161e+05
4.65e+05,2014,311,4,2.5,2200,3141,2,0,0,3,7,2060,140,1994,1994,98144,47.573,122.31,1660,3175,20,0,6.5,3860,5375
3.575e+05,2014,348,3,1.75,1630,9403,1,0,0,3,7,1630,0,1983,1983,98155,47.757,122.32,1430,8461,31,0,4.75,3060,10091
4.105e+05,2015,407,4,2.5,3362,8601,2,0,0,3,8,3362,0,2004,2004,98003,47.259,122.3,2770,8601,11,0,6.5,6132,11963
4.99e+05,2014,352,3,2.5,1720,5940,1,0,0,4,8,1000,720,1977,1977,98052,47.663,122.13,1720,6136,37,0,5.5,3440,7856
3.165e+05,2014,242,3,1.75,1600,14250,1,0,0,3,7,1070,530,1979,1979,98023,47.327,122.36,2140,14960,35,0,4.75,3740,16560
4.15e+05,2015,477,3,2.75,1770,3172,2,0,0,3,8,1770,0,2009,2009,98065,47.516,121.88,1760,2891,6,0,5.75,3530,4661
8.8e+05,2015,467,5,2.75,3020,9187,2,0,0,3,9,3020,0,2007,2007,98033,47.681,122.17,2250,9675,8,0,7.75,5270,12695
4.03e+05,2015,407,3,2.25,1840,13020,1,0,0,3,8,1390,450,1980,1980,98052,47.692,122.09,2210,13020,35,0,5.25,4050,14860
3.24e+05,2014,251,2,1,1070,6000,1,0,0,3,7,1070,0,1955,1955,98133,47.731,122.33,1490,7622,59,0,3,2560,8692
1.215e+06,2015,475,4,2.25,2570,9600,2,0,0,4,9,2570,0,1962,1962,98040,47.579,122.24,2570,13200,53,0,6.25,5140,15770
7.21e+05,2015,473,3,2.25,2040,18360,2,0,0,4,8,2040,0,1983,1983,98052,47.698,122.14,2590,21315,32,0,5.25,4630,23355
2.6e+05,2014,262,3,1.75,2170,10018,1,0,0,4,7,1630,540,1978,1978,98001,47.309,122.26,2049,15263,36,0,4.75,4219,17433
1.95e+05,2014,129,2,1,720,18000,1,0,0,3,6,720,0,1950,1950,98178,47.505,122.26,1250,7925,64,0,3,1970,8645
6.1e+05,2014,211,3,2.5,2910,12283,2,0,2,3,10,2910,0,1993,1993,98058,47.46,122.15,2680,22499,21,0,5.5,5590,25409
7.25e+05,2014,218,4,2.25,2880,8882,2,0,0,4,8,2480,400,1965,1965,98115,47.7,122.28,2460,9610,49,0,6.25,5340,12490
1.1e+06,2015,426,5,2.75,2830,18050,1,0,0,5,7,1630,1200,1958,1958,98040,47.577,122.23,2370,14250,57,0,7.75,5200,17080
7.12e+05,2014,278,4,2.25,2450,11960,1,0,0,3,10,2450,0,1979,1979,98074,47.635,122.06,2600,11960,35,0,6.25,5050,14410
4.35e+05,2015,403,4,1.75,2520,7200,1,0,2,5,7,1260,1260,1955,1955,98056,47.483,122.19,2360,7300,60,0,5.75,4880,9820
1.385e+06,2014,221,4,3.5,4010,15365,2,0,1,3,11,4010,0,2006,2006,98027,47.553,122.09,3550,13429,8,0,7.5,7560,17439
4.15e+05,2015,437,4,2.5,2150,10098,1,0,0,3,7,1090,1060,1963,1963,98034,47.717,122.2,1880,10000,52,0,6.5,4030,12150
1.05e+06,2014,200,3,2.5,3470,12076,2,0,3,3,10,2560,910,1988,1988,98040,47.532,122.24,3590,17677,26,0,5.5,7060,21147
4.4e+05,2014,332,4,1.5,1690,3245,1,0,0,3,8,1690,0,1929,1929,98126,47.544,122.38,1380,1590,85,0,5.5,3070,3280
3.75e+05,2014,133,3,1,1190,9486,1,0,0,4,7,1190,0,1953,1953,98166,47.432,122.34,2100,10400,61,0,4,3290,11590
1.045e+06,2014,314,4,2.75,2950,4560,2,0,0,5,7,1810,1140,1912,1912,98103,47.653,122.33,2000,4560,102,0,6.75,4950,7510
5.3e+05,2014,242,4,3,2240,5580,2,0,0,5,7,1830,410,1949,1949,98118,47.56,122.27,1530,4800,65,0,7,3770,7040
4.75e+05,2014,150,2,2,1540,54450,2,0,0,3,7,1540,0,1983,1983,98053,47.638,121.95,2280,29918,31,0,4,3820,31458
1.298e+06,2014,153,4,3.5,2790,10125,1,0,0,5,8,2790,0,1985,1985,98040,47.565,122.22,2570,10125,29,0,7.5,5360,12915
2.23e+05,2014,203,4,2,1200,8470,1,0,0,4,7,1200,0,1961,1961,98023,47.326,122.34,1110,8400,53,0,6,2310,9600
5e+05,2015,415,3,1,1440,54315,1,0,0,3,7,790,650,1974,1974,98075,47.591,122.01,2690,40518,41,0,4,4130,41958
5.75e+05,2015,415,3,1.75,1580,7344,1,0,0,5,7,1580,0,1911,1911,98126,47.526,122.38,1580,6207,104,0,4.75,3160,7787
2.29e+05,2014,348,3,1,1010,12705,1,0,0,4,7,1010,0,1959,1959,98003,47.335,122.3,1490,10200,55,0,4,2500,11210
6.52e+05,2015,445,3,2,1700,4080,1,0,0,4,7,850,850,1941,1941,98117,47.678,122.39,1480,5100,74,0,5,3180,6800
7.39e+05,2014,148,3,2.5,2810,5400,2,0,0,3,9,2810,0,2005,2005,98052,47.706,122.12,2870,5400,9,0,5.5,5680,8210
2.55e+05,2015,451,3,1,1430,12420,1,0,0,3,7,1430,0,1964,1964,98056,47.512,122.19,1900,10350,51,0,4,3330,11780
2.58e+05,2014,325,4,3,2710,7199,1,0,0,4,7,1710,1000,1967,1967,98030,47.379,122.21,2070,9271,47,0,7,4780,11981
4.25e+05,2014,174,3,2.5,1930,4500,2,0,0,3,8,1930,0,1990,1990,98029,47.579,122,1770,4500,24,0,5.5,3700,6430
8.07e+05,2015,478,3,2.5,1940,4000,2,0,0,4,9,1940,0,2000,2000,98199,47.659,122.4,1410,4000,15,0,5.5,3350,5940
1.99e+05,2014,174,3,1,1000,8512,1,0,0,3,6,1000,0,1991,1991,98022,47.215,121.99,1490,10395,23,0,4,2490,11395
2.4e+05,2015,472,3,1,1260,7920,1,0,0,3,7,1260,0,1966,1966,98003,47.345,122.31,1300,7920,49,0,4,2560,9180
2.33e+05,2015,375,3,1.75,1460,7800,1,0,0,2,7,1040,420,1979,1979,98023,47.303,122.38,1310,7865,36,0,4.75,2770,9325
6.6989e+05,2014,298,4,2.75,2550,7591,2,0,0,3,9,2550,0,1989,1989,98059,47.53,122.15,2670,7796,25,0,6.75,5220,10346
8.255e+05,2014,150,3,2.5,2780,11964,2,0,0,3,9,2780,0,2009,2009,98034,47.713,122.22,1760,9640,5,0,5.5,4540,12420
1.168e+06,2014,224,5,2.75,2910,15118,1,0,0,5,9,1780,1130,1972,1972,98006,47.57,122.18,2880,15253,42,0,7.75,5790,18163
2.799e+05,2014,176,3,1.75,1580,6620,1,0,0,3,7,1580,0,1988,1988,98003,47.28,122.3,1580,8137,26,0,4.75,3160,9717
8.4e+05,2014,230,3,2.5,2060,9715,2,0,0,3,8,2060,0,1924,2006,98115,47.696,122.32,1240,7072,90,1,5.5,3300,9132
9.87e+05,2014,345,3,2,2160,15788,1,0,0,3,8,2160,0,1951,1951,98004,47.623,122.21,2260,9787,63,0,5,4420,11947
5.54e+05,2014,325,2,1,820,3700,1,0,0,5,7,820,0,1968,1968,98040,47.588,122.25,1750,9000,46,0,3,2570,9820
6.48e+05,2014,154,4,2.5,3290,6203,2,0,0,3,9,3290,0,2008,2008,98065,47.544,121.86,2990,6835,6,0,6.5,6280,10125
4.3e+05,2014,177,2,1,1050,2570,1,0,0,5,7,850,200,1927,1927,98117,47.676,122.37,1080,2800,87,0,3,2130,3850
9.5e+05,2015,463,3,1,1720,9830,1,0,0,4,7,1720,0,1946,1946,98040,47.59,122.25,3200,8923,69,0,4,4920,10643
2.05e+05,2015,465,3,1,970,7700,1,0,0,4,7,970,0,1959,1959,98032,47.379,122.3,1160,8250,56,0,4,2130,9220
3.49e+05,2015,472,3,1.75,1740,7682,1,0,0,3,8,1330,410,1978,1978,98058,47.445,122.13,2010,8820,37,0,4.75,3750,10560
2.35e+05,2014,346,3,1.75,1370,14030,1,0,0,4,8,1370,0,1977,1977,98092,47.297,122.16,2100,15260,37,0,4.75,3470,16630
3.1e+05,2014,215,3,1.75,1490,7150,1,0,0,5,6,1490,0,1967,1967,98059,47.502,122.12,1350,9100,47,0,4.75,2840,10590
4e+05,2014,221,3,1,1460,43000,1,0,0,3,7,1460,0,1952,1952,98166,47.443,122.35,2250,20023,62,0,4,3710,21483
2.4203e+05,2014,196,4,1.75,1400,54014,1,0,0,4,7,1400,0,1935,1935,98031,47.415,122.18,1910,8523,79,0,5.75,3310,9923
7.69e+05,2014,239,4,2.75,3630,15405,1,0,2,4,8,1850,1780,1968,1968,98040,47.566,122.22,3380,11184,46,0,6.75,7010,14814
6.2e+05,2014,348,4,2.5,2730,9260,2,0,0,3,8,2730,0,2008,2008,98133,47.722,122.33,2730,7357,6,0,6.5,5460,10087
3.525e+05,2015,477,2,2.25,1240,705,2,0,0,3,7,1150,90,2009,2009,98027,47.532,122.07,1240,750,6,0,4.25,2480,1990
5.35e+05,2014,276,3,2.5,2400,12546,1,0,0,3,9,2400,0,1983,1983,98074,47.632,122.04,2940,12150,31,0,5.5,5340,14550
5.9e+05,2015,480,4,2.5,2940,29013,2,0,0,3,10,2940,0,1992,1992,98077,47.764,122.04,3010,34071,23,0,6.5,5950,37011
2.6e+05,2014,141,6,2,2220,8797,1,0,0,3,7,2220,0,1977,1977,98002,47.298,122.23,1170,5123,37,0,8,3390,7343
4.37e+05,2014,187,3,1.75,2220,17568,1,0,0,4,8,2220,0,1967,1967,98072,47.749,122.08,2070,11745,47,0,4.75,4290,13965
8.6606e+05,2014,167,5,3.5,3130,4797,2,0,0,3,9,2570,560,2014,2014,98006,47.566,122.13,3440,5439,0,0,8.5,6570,8569
2.95e+05,2014,290,3,2,1830,17321,1,0,0,4,7,1100,730,1948,1948,98178,47.507,122.27,1450,10706,66,0,5,3280,12536
7.39e+05,2015,491,3,2.25,2220,10530,1,0,0,4,8,1700,520,1974,1974,98052,47.638,122.1,2500,10014,41,0,5.25,4720,12234
1.2999e+06,2014,215,5,4,3870,5929,2,0,0,3,10,3870,0,2014,2014,98052,47.697,122.13,3600,5625,0,0,9,7470,9495
5.8745e+05,2015,477,3,2.25,2190,8775,1,0,1,4,8,2190,0,1927,1927,98125,47.73,122.29,1910,8145,88,0,5.25,4100,10335
7.311e+05,2014,209,3,2.5,2060,8778,1,0,0,3,8,1160,900,1953,2010,98136,47.525,122.38,1990,7560,61,1,5.5,4050,9620
3.805e+05,2015,415,3,2.5,1900,7361,2,0,0,3,8,1900,0,1994,1994,98055,47.432,122.19,2100,7361,21,0,5.5,4000,9261
3.85e+05,2015,492,3,1,810,4600,1,0,0,3,6,810,0,1918,1918,98144,47.571,122.32,1520,4800,97,0,4,2330,5610
4.15e+05,2015,484,3,1.5,1360,1795,2,0,0,3,7,1360,0,1945,1945,98199,47.647,122.4,1580,1795,70,0,4.5,2940,3155
6.6e+05,2014,170,4,3.25,3030,9273,2,0,0,5,8,3030,0,1988,1988,98029,47.575,122.01,2360,7632,26,0,7.25,5390,10662
4.4e+05,2014,271,3,2.25,1230,1097,3,0,0,3,8,1230,0,2009,2009,98107,47.67,122.37,1420,1437,5,0,5.25,2650,2667
6.36e+05,2015,470,3,2.5,2140,2770,2,0,0,3,8,1770,370,2007,2007,98052,47.666,122.13,2510,2708,8,0,5.5,4650,4848
4.7e+05,2014,339,2,1,1220,4000,1,0,0,4,6,1220,0,1908,1908,98103,47.68,122.35,1580,4000,106,0,3,2800,5220
4.1e+05,2015,459,4,2.5,2070,6180,2,0,0,3,8,2070,0,2007,2007,98056,47.492,122.18,1250,6018,8,0,6.5,3320,8088
8e+05,2014,176,4,2.5,2990,16809,2,0,0,3,11,2990,0,1990,1990,98077,47.712,122.07,3340,18752,24,0,6.5,6330,21742
6e+05,2014,232,4,2.5,2600,6536,2,0,0,3,9,2600,0,1999,1999,98056,47.523,122.19,2640,6185,15,0,6.5,5240,8785
3.505e+05,2014,279,2,1,1450,6380,1,0,0,3,7,1450,0,1967,1967,98115,47.692,122.32,1240,6380,47,0,3,2690,7830
3.99e+05,2014,229,3,2,2100,31550,1,0,0,3,8,2100,0,2010,2010,98014,47.691,121.92,1860,18452,4,0,5,3960,20552
4.9e+05,2014,223,3,2,2370,12196,2,0,0,4,7,2370,0,1970,1970,98033,47.673,122.18,1380,12196,44,0,5,3750,14566
9.5e+05,2014,208,3,1.75,2150,3503,2,0,0,3,8,1870,280,1921,1921,98112,47.629,122.3,3920,6402,93,0,4.75,6070,8552
8.5e+05,2014,269,5,3.5,3870,65556,2,0,0,3,10,3870,0,1994,1994,98053,47.64,121.99,4290,67019,20,0,8.5,8160,70889
6.6657e+05,2014,200,4,2,2320,7400,1,0,0,5,7,1620,700,1913,1913,98118,47.556,122.27,1740,4000,101,0,6,4060,6320
2.35e+05,2014,188,2,1,1020,7920,1,0,0,3,6,1020,0,1939,1939,98108,47.556,122.31,1530,6900,75,0,3,2550,7920
2.87e+05,2014,338,4,2.5,2660,4082,2,0,0,3,7,2660,0,2010,2010,98042,47.341,122.06,2390,4876,4,0,6.5,5050,7536
3.01e+05,2014,205,3,1,1060,9241,1,0,0,4,7,1060,0,1956,1956,98133,47.746,122.34,1900,6484,58,0,4,2960,7544
3.22e+05,2014,299,3,3.25,1380,1225,3,0,0,3,7,1380,0,2000,2000,98133,47.703,122.35,1380,1704,14,0,6.25,2760,3084
3.7e+05,2014,253,3,1.5,1690,1.6191e+05,1,0,0,2,7,1430,260,1952,1952,98030,47.356,122.19,1930,12548,62,0,4.5,3620,14238
9.785e+05,2015,479,3,2.25,2060,7080,2,0,0,3,9,1800,260,1940,1940,98199,47.645,122.41,3070,7500,75,0,5.25,5130,9560
3.55e+05,2014,217,2,2.5,1370,1140,2,0,0,3,8,1080,290,2009,2009,98133,47.706,122.34,1340,1050,5,0,4.5,2710,2420
5.85e+05,2015,403,4,2.75,2050,17859,1,0,0,4,7,1300,750,1967,1967,98075,47.594,122.06,2960,20908,48,0,6.75,5010,22958
2.25e+06,2014,314,4,2.25,4760,8036,2,0,0,5,9,3390,1370,1916,1916,98112,47.642,122.28,2950,9323,98,0,6.25,7710,14083
2.8e+05,2015,484,3,1,1020,8400,1,0,0,4,7,1020,0,1957,1957,98056,47.49,122.18,1690,8030,58,0,4,2710,9050
6.25e+05,2014,259,3,3.5,1560,1490,2,0,0,3,8,1240,320,1995,1995,98102,47.625,122.32,1560,1662,19,0,6.5,3120,3222
4.9e+05,2014,331,3,1.75,1600,16510,1,0,0,3,8,1600,0,1984,1984,98052,47.66,122.14,1510,10407,30,0,4.75,3110,12007
4.9e+05,2015,414,3,2.5,2080,12032,2,0,0,3,8,2080,0,1978,1978,98077,47.745,122.07,2320,9900,37,0,5.5,4400,11980
2.4e+05,2014,266,3,2,1030,11118,1,0,0,5,7,1030,0,1970,1970,98003,47.346,122.31,1300,7920,44,0,5,2330,8950
2.795e+06,2015,465,5,3.25,4590,12793,2,0,2,5,11,3590,1000,1928,1928,98199,47.645,122.41,2920,8609,87,0,8.25,7510,13199
95000,2015,485,1,0.75,760,5746,1,0,0,4,5,760,0,1915,1915,98002,47.305,122.22,970,6696,100,0,1.75,1730,7456
1.7e+05,2014,270,3,0.75,1040,42180,1,0,0,2,6,1040,0,1947,1947,98055,47.452,122.2,1270,24090,67,0,3.75,2310,25130
1.85e+05,2014,319,2,1,1390,11340,1,0,0,4,7,1390,0,1969,1969,98168,47.497,122.3,1200,10224,45,0,3,2590,11614
6.455e+05,2014,318,4,2.5,2390,9638,2,0,0,3,10,2390,0,1988,1988,98029,47.56,122.02,2630,9258,26,0,6.5,5020,11648
2.7e+05,2014,285,3,2.5,1660,5550,2,0,0,3,7,1660,0,2002,2002,98198,47.375,122.3,1810,5550,12,0,5.5,3470,7210
4.84e+05,2014,126,2,1.75,1660,6000,1,0,0,3,7,1160,500,1942,1942,98105,47.662,122.29,1660,4000,72,0,3.75,3320,5660
8.72e+05,2014,203,4,4,3770,9750,1,0,0,4,9,1940,1830,1967,1967,98177,47.716,122.37,2260,9878,47,0,8,6030,13648
7.55e+05,2014,177,5,2.5,3260,24300,1,0,1,4,8,2310,950,1950,1950,98155,47.759,122.27,2390,32057,64,0,7.5,5650,35317
4.4e+05,2014,224,3,2.5,2060,11231,2,0,0,3,8,2060,0,1987,1987,98072,47.757,122.14,2140,10224,27,0,5.5,4200,12284
3.15e+05,2014,319,3,1.5,1700,8067,1,0,0,3,7,1250,450,1956,1956,98155,47.738,122.32,1340,7869,58,0,4.5,3040,9569
5.4e+05,2014,155,4,2.25,1330,8400,1,0,0,3,8,1330,0,1962,1962,98005,47.608,122.17,2270,10146,52,0,6.25,3600,11476
3.21e+05,2014,243,4,2.25,1800,4500,2,0,0,4,8,1800,0,2004,2004,98031,47.394,122.18,2010,5050,10,0,6.25,3810,6850
2.23e+05,2014,314,3,1,940,7980,1,0,0,3,6,940,0,1961,1961,98146,47.511,122.34,1050,7980,53,0,4,1990,8920
1.925e+05,2014,290,1,1,470,63737,1,0,2,5,5,470,0,1924,1924,98022,47.216,121.98,1350,46762,90,0,2,1820,47232
4.25e+05,2014,173,2,1,880,6413,1,0,0,3,7,880,0,1950,1950,98116,47.573,122.39,1360,6413,64,0,3,2240,7293
2.229e+05,2014,249,2,1,860,5800,1,0,0,5,5,860,0,1942,1942,98056,47.498,122.18,900,6000,72,0,3,1760,6860
3.65e+05,2014,176,5,2,2280,19000,1,0,0,3,6,2280,0,1924,1924,98166,47.468,122.36,1790,11800,90,0,7,4070,14080
4.43e+05,2014,305,3,2.5,2430,7049,2,0,0,3,8,2430,0,2007,2007,98106,47.54,122.35,1770,7049,7,0,5.5,4200,9479
3.1995e+05,2015,460,3,2.5,2240,7500,2,0,0,3,8,2240,0,1985,1985,98092,47.265,122.22,2190,7506,30,0,5.5,4430,9746
3.8e+05,2014,332,3,2.5,1260,900,2,0,0,3,7,940,320,2007,2007,98116,47.562,122.38,1310,1415,7,0,5.5,2570,2675
4.4923e+05,2015,447,5,2.5,3020,24750,1,0,0,3,8,1650,1370,1965,1965,98005,47.59,122.18,2930,16062,50,0,7.5,5950,19082
1.025e+06,2015,425,3,1,2050,4800,2,0,0,3,8,1950,100,1922,1922,98112,47.632,122.31,2220,4800,93,0,4,4270,6850
1.25e+05,2014,284,3,1,920,7276,1,0,0,4,6,920,0,1961,1961,98002,47.285,122.21,1120,7276,53,0,4,2040,8196
3.45e+05,2015,414,3,2,1430,4200,1,0,0,4,7,830,600,1908,1908,98199,47.646,122.38,1540,5000,107,0,5,2970,6430
1.9e+05,2014,287,2,2.5,1370,3438,2,0,0,3,7,1370,0,1987,1987,98188,47.461,122.28,1370,2308,27,0,4.5,2740,3678
3.4e+05,2014,286,3,1.75,2140,13260,1,0,0,3,7,1240,900,1948,1948,98146,47.507,122.35,1640,13260,66,0,4.75,3780,15400
1.89e+05,2014,335,2,1,1200,9850,1,0,0,4,7,1200,0,1921,1921,98002,47.309,122.21,1060,5095,93,0,3,2260,6295
2.24e+05,2014,148,3,1.5,1560,7300,1,0,0,4,7,1040,520,1964,1964,98001,47.343,122.28,1460,7910,50,0,4.5,3020,9470
1.01e+06,2015,431,4,3.5,3500,4080,2,0,2,3,9,2590,910,2004,2004,98115,47.683,122.29,2430,5100,11,0,7.5,5930,8600
6.07e+05,2015,443,4,2.5,2100,8220,1,0,0,4,8,1300,800,1975,1975,98052,47.673,122.14,2160,8348,40,0,6.5,4260,10448
5.99e+05,2015,400,3,2.5,2970,23100,1,0,0,3,7,1510,1460,1967,1967,98072,47.773,122.13,2390,20300,48,0,5.5,5360,23270
2.32e+05,2015,438,3,1,840,6540,1,0,0,3,6,840,0,1970,2014,98042,47.374,122.12,1010,6600,45,1,4,1850,7440
4.1e+05,2014,280,3,1.75,1660,5987,1,0,0,3,7,960,700,1982,1982,98146,47.511,122.38,1510,6000,32,0,4.75,3170,7660
3.8e+05,2014,289,3,2,1470,1656,2,0,0,3,8,1310,160,2003,2003,98126,47.565,122.37,1470,2288,11,0,5,2940,3758
4.4e+05,2015,492,3,1,1040,4000,1,0,0,3,7,1040,0,1950,1950,98122,47.618,122.29,1170,4000,65,0,4,2210,5040
6.1695e+05,2014,244,5,3.5,3560,5008,2,0,0,3,8,2810,750,2013,2013,98106,47.554,122.36,2910,5026,1,0,8.5,6470,8586
4.46e+05,2015,473,3,1.75,1460,9998,1,0,0,3,7,960,500,1958,1958,98028,47.743,122.24,1460,9998,57,0,4.75,2920,11458
3.2e+05,2015,416,5,3,2970,7000,1,0,0,3,8,1810,1160,1979,1979,98023,47.308,122.34,2630,8062,36,0,8,5600,11032
3.3495e+05,2015,449,2,2.25,1240,750,2,0,0,3,7,1150,90,2008,2008,98027,47.532,122.07,1240,750,7,0,4.25,2480,1990
2.875e+05,2014,272,3,1,1810,7200,1,0,0,4,7,1130,680,1954,1954,98133,47.749,122.35,1810,8100,60,0,4,3620,9910
3.53e+05,2015,453,2,1,1100,7500,1,0,0,3,7,1100,0,1951,1951,98125,47.724,122.33,1920,7149,64,0,3,3020,8249
6.215e+05,2015,381,3,1.75,2570,39634,2,0,0,3,8,2570,0,1984,1984,98075,47.596,122.08,2990,39634,31,0,4.75,5560,42204
2.95e+05,2014,263,2,1,840,10465,1,0,0,3,6,840,0,1951,1951,98155,47.755,122.32,1320,8515,63,0,3,2160,9355
2.79e+05,2014,321,3,2.5,1450,4106,2,0,0,3,7,1450,0,2011,2011,98038,47.365,122.02,2000,4000,3,0,5.5,3450,5450
5.15e+05,2015,424,3,1.75,1900,5000,1,0,0,4,7,950,950,1925,1925,98106,47.568,122.36,1420,5000,90,0,4.75,3320,6900
9.5599e+05,2014,290,5,3.25,3830,6507,2,0,0,3,9,3830,0,2014,2014,98053,47.684,122.02,3950,6723,0,0,8.25,7780,10553
2.42e+05,2014,168,3,2,1260,8092,1,0,0,3,7,1260,0,1986,1986,98038,47.364,122.05,1950,8092,28,0,5,3210,9352
2.25e+05,2014,284,2,1,700,6000,1,0,0,3,6,700,0,1943,1943,98055,47.467,122.21,1320,6000,71,0,3,2020,6700
2.4e+05,2014,293,3,1.75,1240,10956,1,0,0,3,6,1240,0,1987,1987,98042,47.37,122.15,1240,8137,27,0,4.75,2480,9377
2.91e+05,2014,333,4,2.5,1580,6633,2,0,0,4,7,1580,0,1984,1984,98042,47.377,122.12,1590,6633,30,0,6.5,3170,8213
3.24e+05,2014,173,4,1.75,2110,7208,1,0,0,3,8,1170,940,1975,1975,98058,47.446,122.13,1820,7208,39,0,5.75,3930,9318
2.288e+05,2015,492,4,2.5,1470,1612,2,0,0,3,7,980,490,2003,2003,98118,47.528,122.27,1460,5027,12,0,6.5,2930,6497
4.1e+05,2014,189,3,1.75,1660,6250,1,0,0,3,7,830,830,1980,1980,98116,47.586,122.39,1660,5750,34,0,4.75,3320,7410
5.3e+05,2015,426,4,2.75,2740,7872,2,0,0,3,10,2740,0,2015,2015,98056,47.495,122.17,1220,6300,0,0,6.75,3960,9040
2.5e+05,2015,367,3,2.25,1050,572,2,0,0,3,7,740,310,2006,2006,98106,47.555,122.36,1260,1062,9,0,5.25,2310,2112
8.6e+05,2014,356,4,3.25,3830,10005,2,0,0,3,10,3830,0,2001,2001,98075,47.595,122.04,2555,5204,13,0,7.25,6385,9034
2.25e+05,2015,477,3,1,1300,8316,1,0,0,4,6,1300,0,1954,1954,98002,47.322,122.22,1260,8316,61,0,4,2560,9616
2.5e+05,2014,319,3,2,1430,7280,1,0,0,3,7,990,440,1980,1980,98030,47.374,122.18,1430,7280,34,0,5,2860,8710
1.419e+06,2014,298,5,3.25,4020,4500,2,0,0,3,9,3120,900,2010,2010,98004,47.635,122.2,3550,5775,4,0,8.25,7570,9795
9.71e+05,2014,221,5,3.5,4390,10140,2,0,0,3,9,3350,1040,2005,2005,98125,47.717,122.28,2010,8400,9,0,8.5,6400,12790
3.52e+05,2015,430,2,2.5,1320,1957,1,0,0,3,8,660,660,2004,2004,98106,47.536,122.36,1420,2198,11,0,4.5,2740,3518
5e+05,2014,285,3,1.75,1220,7370,1,0,0,4,7,1220,0,1964,1964,98008,47.633,122.12,1580,8213,50,0,4.75,2800,9433
2.82e+05,2014,257,3,2.25,2420,7548,1,0,0,4,8,1370,1050,1967,1967,98023,47.311,122.38,2150,8000,47,0,5.25,4570,10420
6e+05,2014,229,3,1.75,1620,1325,2,0,0,3,9,1430,190,2005,2005,98102,47.65,122.32,1750,1572,9,0,4.75,3370,3192
3.7e+05,2015,432,4,2.5,2100,19680,1,0,0,3,6,2100,0,1914,1914,98055,47.479,122.23,1340,12300,101,0,6.5,3440,14400
4.3e+05,2014,198,2,1.75,1350,4003,1,0,0,3,8,1350,0,2004,2004,98053,47.718,122.03,1350,4479,10,0,3.75,2700,5829
8.98e+05,2014,148,5,1.5,2680,28014,1,0,0,4,8,1450,1230,1963,1963,98004,47.635,122.2,2900,22180,51,0,6.5,5580,24860
2.7544e+05,2014,242,4,2.75,2170,9658,1,0,0,3,7,2170,0,1966,1966,98030,47.374,122.19,1490,9731,48,0,6.75,3660,11901
9.5e+05,2014,194,4,3.25,3820,15293,2,0,0,3,10,3820,0,2003,2003,98074,47.61,122.02,2790,7142,11,0,7.25,6610,10962
9.192e+05,2014,150,4,3.5,3760,5000,2,0,0,3,9,2860,900,2014,2014,98117,47.683,122.39,1340,5000,0,0,7.5,5100,8760
6.2495e+05,2015,459,3,2.5,2060,4730,2,0,0,4,8,2060,0,1994,1994,98033,47.687,122.18,1980,5010,21,0,5.5,4040,7070
1.7e+05,2015,380,3,1.75,1370,10780,1,0,0,3,7,1370,0,1959,1959,98168,47.473,122.3,1370,10317,56,0,4.75,2740,11687
8.16e+05,2014,256,3,1.5,1180,8545,1,0,0,3,8,1180,0,1952,1952,98004,47.624,122.2,1660,9000,62,0,4.5,2840,10180
4.3e+05,2014,349,1,1,630,1362,1,0,0,3,7,630,0,1943,1943,98109,47.634,122.34,1090,1376,71,0,2,1720,2006
4.85e+05,2014,286,4,3,3110,18843,2,0,0,3,9,3110,0,1995,1995,98058,47.462,122.15,3080,14735,19,0,7,6190,17845
3.4e+05,2014,195,3,2,1130,9879,2,0,0,3,6,1130,0,1996,1996,98053,47.635,121.96,1900,14907,18,0,5,3030,16037
5.35e+05,2014,354,2,2.5,2730,7246,2,0,0,3,9,2730,0,1998,1998,98056,47.512,122.17,3220,7214,16,0,4.5,5950,9944
1.23e+05,2014,182,2,1,1050,6600,1,0,0,3,6,1050,0,1964,1964,98168,47.483,122.32,1330,6600,50,0,3,2380,7650
7.9e+05,2014,205,3,2.25,2370,10289,1,0,0,4,9,1590,780,1977,1977,98005,47.592,122.17,2500,10004,37,0,5.25,4870,12374
6.015e+05,2015,402,3,1.75,1460,10128,1,0,0,3,8,1460,0,1968,2000,98033,47.671,122.17,2240,10154,47,1,4.75,3700,11614
3.8444e+05,2014,201,3,2.5,2029,3906,2,0,0,3,9,2029,0,2014,2014,98003,47.341,122.18,2029,3920,0,0,5.5,4058,5949
1.8995e+05,2015,465,2,1,1030,4188,1,0,0,3,8,1030,0,1981,1981,98038,47.374,122.06,1450,3376,34,0,3,2480,4406
4.625e+05,2014,250,4,1,1540,4500,1,0,0,2,7,1540,0,1905,1905,98116,47.587,122.38,1920,6000,109,0,5,3460,7540
2.57e+05,2015,401,3,1.75,1330,36537,1,0,0,4,7,1330,0,1989,1989,98092,47.313,122.13,1650,35100,26,0,4.75,2980,36430
4.15e+05,2014,182,3,1,1520,9030,1,0,0,3,7,1520,0,1956,1956,98007,47.587,122.13,1470,8712,58,0,4,2990,10232
3.15e+05,2014,293,3,1.75,1660,8160,1,0,0,4,7,1660,0,1951,1951,98166,47.461,122.36,1490,8100,63,0,4.75,3150,9760
1.62e+05,2014,259,4,2,1440,7641,1,0,0,4,5,1440,0,1943,1943,98056,47.508,122.18,1440,7750,71,0,6,2880,9190
6.257e+05,2015,386,3,2,2570,1.5987e+05,1,0,0,5,7,2570,0,1968,1968,98024,47.555,121.89,2010,38322,47,0,5,4580,40892
1.67e+05,2014,208,3,1.5,1280,5547,2,0,0,4,6,1280,0,1985,1985,98002,47.334,122.22,1150,4500,29,0,4.5,2430,5780
9.02e+05,2014,166,4,2.5,3030,8507,2,0,0,3,9,3030,0,2003,2003,98033,47.667,122.18,2570,8830,11,0,6.5,5600,11860
1.04e+06,2014,127,4,3.5,3900,8391,2,0,0,3,10,3900,0,2006,2006,98033,47.698,122.2,3820,12268,8,0,7.5,7720,16168
7.5e+05,2015,424,2,1.5,1110,3600,1,0,0,5,7,1110,0,1904,1904,98119,47.638,122.36,1670,5400,111,0,3.5,2780,6510
5.425e+05,2014,129,4,2.5,2330,14289,2,0,0,4,8,2330,0,1978,1978,98007,47.592,122.15,2210,12823,36,0,6.5,4540,15153
3.9e+05,2015,480,3,2.25,1820,7420,2,0,0,4,8,1820,0,1983,1983,98058,47.437,122.16,1900,7526,32,0,5.25,3720,9346
1.0889e+06,2014,198,4,2.75,3460,11350,1,0,4,4,9,1780,1680,1974,1974,98006,47.568,122.15,3200,13874,40,0,6.75,6660,17334
1.379e+05,2015,451,3,1.75,1160,5082,1,0,0,3,6,580,580,1942,1942,98178,47.503,122.26,1730,6000,73,0,4.75,2890,7160
8.025e+05,2014,201,4,3.75,3320,8030,2,0,0,3,10,3320,0,2005,2005,98075,47.582,121.97,3740,8030,9,0,7.75,7060,11350
5.6395e+05,2015,439,4,2.75,3050,4750,2,0,0,3,8,3050,0,2014,2014,98059,47.486,122.15,2730,5480,1,0,6.75,5780,8530
6.65e+05,2014,264,4,2.75,2420,7102,1,0,0,5,7,1670,750,1946,1946,98177,47.704,122.37,1620,7102,68,0,6.75,4040,9522
3.6e+05,2014,354,4,2.5,2390,7056,2,0,0,3,9,2390,0,1990,1990,98001,47.339,122.26,2590,7801,24,0,6.5,4980,10191
4.99e+05,2014,244,3,2.5,1610,1728,3,0,0,3,8,1610,0,2000,2000,98115,47.678,122.32,1540,3090,14,0,5.5,3150,4700
4.22e+05,2015,488,4,2.5,2310,6650,2,0,2,3,8,2310,0,2012,2012,98166,47.451,122.27,1800,9819,3,0,6.5,4110,12129
4.195e+05,2014,197,4,2.5,2550,7200,2,0,2,3,7,2550,0,2003,2003,98056,47.479,122.18,2560,5715,11,0,6.5,5110,8265
4.05e+05,2015,463,3,2.5,2160,10200,1,0,0,3,7,1360,800,1978,1978,98133,47.73,122.33,2010,7850,37,0,5.5,4170,10010
3.875e+05,2014,332,4,2.5,3190,9856,2,0,0,3,8,3190,0,1979,1979,98058,47.444,122.13,2260,7996,35,0,6.5,5450,11186
3.87e+05,2014,297,3,1.5,1340,6500,1,0,0,3,7,1340,0,1972,1972,98034,47.717,122.19,1620,7107,42,0,4.5,2960,8447
7.85e+05,2014,280,4,2.25,3200,53357,2,0,0,4,9,3200,0,1972,1972,98077,47.755,122.03,2650,54014,42,0,6.25,5850,57214
5.45e+05,2014,238,4,1.75,1940,8990,1,0,0,4,8,1560,380,1956,1956,98034,47.702,122.24,2310,11745,58,0,5.75,4250,13685
4.75e+05,2014,280,2,1.75,1320,3420,1,0,1,3,7,1080,240,1955,1955,98199,47.664,122.4,2070,6000,59,0,3.75,3390,7320
6.15e+05,2014,331,3,1.75,2220,7224,1,0,2,3,8,2040,180,1975,1975,98177,47.774,122.38,2540,9990,39,0,4.75,4760,12210
5.79e+05,2014,173,3,2.5,1640,1269,3,0,0,3,8,1640,0,2009,2009,98112,47.62,122.3,1590,1231,5,0,5.5,3230,2871
1.4e+05,2014,221,2,1,900,6400,1,0,0,2,6,900,0,1940,1940,98118,47.529,122.28,1350,6405,74,0,3,2250,7305
4.67e+05,2015,393,3,2.5,1530,3984,2,0,0,3,8,1530,0,1995,1995,98029,47.569,122.01,1720,4005,20,0,5.5,3250,5535
5.7e+05,2014,287,4,2.5,2280,4534,2,0,0,3,8,2280,0,2003,2003,98075,47.59,122.02,2246,4534,11,0,6.5,4526,6814
5.45e+05,2015,460,4,2.25,1890,7210,1,0,0,3,8,1890,0,1967,1967,98008,47.634,122.12,1920,7210,48,0,6.25,3810,9100
8.88e+05,2014,242,3,1.5,1250,8710,1,0,0,4,7,1250,0,1953,1953,98004,47.624,122.2,1750,9185,61,0,4.5,3000,10435
4.035e+05,2014,280,1,1,700,5621,1,0,0,4,6,700,0,1945,1945,98133,47.734,122.35,1020,5621,69,0,2,1720,6321
3.62e+05,2015,470,4,2.5,2360,7370,1,0,0,3,7,1460,900,1985,1985,98125,47.72,122.31,1590,9906,30,0,6.5,3950,12266
1.5e+05,2014,141,3,1,1010,25000,1,0,0,3,6,1010,0,1966,1966,98014,47.693,121.9,2020,1.0149e+05,48,0,4,3030,1.025e+05
3e+05,2015,408,3,2,1480,6698,1,0,0,4,7,1080,400,1979,1979,98058,47.461,122.17,1850,7348,36,0,5,3330,8828
3.59e+05,2014,218,4,2.5,2575,4725,2,0,0,3,8,2575,0,2011,2011,98001,47.306,122.28,2575,5323,3,0,6.5,5150,7898
6.53e+05,2014,299,3,2,2680,8429,1,0,0,4,9,1880,800,1950,1991,98038,47.372,122.04,1570,8640,64,1,5,4250,11320
4.888e+05,2014,170,4,2.25,2170,9665,1,0,0,4,8,1300,870,1976,1976,98006,47.544,122.17,2170,12054,38,0,6.25,4340,14224
3.6e+05,2014,262,3,1.5,1340,1110,2,0,0,3,7,1040,300,1999,1999,98117,47.698,122.37,1220,1110,15,0,4.5,2560,2450
8.4e+05,2014,292,5,1.75,2500,11617,1,0,0,4,9,1560,940,1966,1966,98040,47.536,122.22,3370,11617,48,0,6.75,5870,14117
1.35e+06,2015,431,3,2.5,2753,65005,1,1,2,5,9,2165,588,1953,1953,98070,47.404,122.45,2680,72513,62,0,5.5,5433,75266
5.93e+05,2015,445,2,2.5,2000,2500,3,0,1,3,8,1810,190,1994,1994,98116,47.579,122.4,1970,5650,21,0,4.5,3970,7650
7e+05,2015,443,4,1,1980,4560,1,0,0,3,7,1980,0,1920,1920,98103,47.661,122.33,1810,3245,95,0,5,3790,5225
4.9265e+05,2014,180,4,1.75,2120,9786,1,0,0,3,8,1640,480,1967,1967,98177,47.775,122.36,2310,8787,47,0,5.75,4430,10907
4.58e+05,2014,134,3,1,1660,7500,1,0,0,4,7,1060,600,1940,1940,98125,47.711,122.31,1450,7500,74,0,4,3110,9160
8.13e+05,2014,300,3,1.75,2080,11866,1,0,0,3,8,2080,0,1960,1960,98005,47.587,122.17,2240,10696,54,0,4.75,4320,12776
4.75e+05,2014,356,3,1.75,1330,14560,1,0,0,3,7,1330,0,1983,1983,98052,47.66,122.14,1510,9890,31,0,4.75,2840,11220
3.05e+05,2014,228,4,2.25,2270,9600,1,0,0,3,7,1290,980,1976,1976,98023,47.326,122.36,1930,15000,38,0,6.25,4200,17270
7.4e+05,2015,450,5,3.5,3990,5000,2,0,0,3,8,2910,1080,2004,2004,98118,47.54,122.27,1310,5000,11,0,8.5,5300,8990
6.7779e+05,2015,438,6,3,2800,4213,2,0,0,3,8,2800,0,1998,1998,98117,47.689,122.39,1440,3960,17,0,9,4240,6760
8.2e+05,2014,235,4,2.5,3170,3862,3,0,0,3,8,3170,0,2008,2008,98034,47.67,122.14,2840,4181,6,0,6.5,6010,7351
4.2e+05,2014,263,3,1.75,1230,10005,1,0,0,4,7,1230,0,1963,1963,98008,47.621,122.11,1530,8560,51,0,4.75,2760,9790
3.4e+06,2015,488,4,4,4260,11765,2,0,0,3,11,3280,980,1939,2010,98112,47.638,122.29,4260,10408,76,1,8,8520,14668
6.55e+05,2014,245,4,2.5,2370,9517,1,0,0,3,9,1630,740,1984,1984,98074,47.622,122.03,2440,9035,30,0,6.5,4810,11405
6.4995e+05,2015,388,3,2.5,2420,7500,1,0,2,4,8,1210,1210,1944,1944,98117,47.695,122.39,2340,7500,71,0,5.5,4760,9920
2.75e+05,2015,471,2,1.5,1160,1103,2,0,0,3,7,890,270,2006,2006,98133,47.768,122.31,1160,1086,9,0,3.5,2320,2246
4.7491e+05,2015,396,4,1.5,1340,6200,1,0,0,5,6,1340,0,1959,1959,98008,47.621,122.12,1210,7178,56,0,5.5,2550,8518
4.15e+05,2014,174,3,1.75,1070,8000,1,0,0,3,7,1070,0,1977,1977,98052,47.698,122.13,1200,7990,37,0,4.75,2270,9060
3.3e+05,2015,387,3,2.5,2040,14071,2,0,0,3,7,2040,0,1995,1995,98019,47.728,121.96,1890,14040,20,0,5.5,3930,16080
6.25e+05,2014,159,3,1.75,2210,16200,1,0,0,3,8,1390,820,1958,1958,98005,47.592,122.17,2050,16200,56,0,4.75,4260,18410
3.15e+05,2014,140,2,1,790,6969,1,0,0,3,6,790,0,1955,1984,98052,47.698,122.16,1380,12196,59,1,3,2170,12986
7.72e+05,2014,225,4,2.5,2990,9643,2,0,0,3,9,2990,0,2003,2003,98074,47.629,122.02,2990,8666,11,0,6.5,5980,11656
2.7295e+05,2015,451,3,2.25,1570,9096,1,0,0,4,7,1180,390,1991,1991,98022,47.194,121.99,1570,8418,24,0,5.25,3140,9988
6.5e+05,2014,307,4,2.5,2110,6820,1,0,0,5,7,1530,580,1942,1942,98115,47.688,122.31,1420,6431,72,0,6.5,3530,8541
2.72e+05,2015,373,2,1,670,6300,1,0,0,4,6,670,0,1942,1942,98126,47.514,122.37,740,6300,73,0,3,1410,6970
7.15e+05,2014,243,4,2.5,2970,29163,2,0,0,3,9,2970,0,1993,1993,98053,47.672,122.03,3100,31105,21,0,6.5,6070,34075
6.5e+05,2014,292,4,2,1930,3976,1,0,0,4,8,1930,0,1914,1914,98122,47.612,122.3,1470,4080,100,0,6,3400,6010
3.89e+05,2015,478,3,1,1280,9630,1,0,0,3,7,1280,0,1968,1968,98072,47.768,122.16,1300,9453,47,0,4,2580,10733
4.05e+05,2014,245,2,1,720,4323,1,0,0,3,6,720,0,1942,1942,98199,47.66,122.4,1460,3300,72,0,3,2180,4020
5.37e+05,2014,255,4,1.75,2230,7957,1,0,0,4,7,2230,0,1967,1967,98008,47.586,122.12,2230,8040,47,0,5.75,4460,10270
3.06e+05,2014,195,2,1.5,1090,1183,3,0,0,3,8,1090,0,2008,2008,98103,47.697,122.35,1110,1384,6,0,3.5,2200,2474
7.35e+05,2014,177,4,3,2370,3672,1,0,0,5,7,1650,720,1916,1916,98115,47.678,122.31,2140,4182,98,0,7,4510,6552
4e+05,2015,429,3,2.75,2220,5000,2,0,0,3,7,2220,0,1993,1993,98108,47.551,122.32,960,5000,22,0,5.75,3180,7220
4.85e+05,2014,326,4,3.5,3273,5115,2,0,0,3,8,2671,602,2014,2014,98055,47.448,122.2,2996,5100,0,0,7.5,6269,8373
7.38e+05,2015,444,3,1,1280,3900,1,0,0,4,7,1280,0,1921,1921,98103,47.654,122.34,2020,4560,94,0,4,3300,5840
2.68e+05,2014,318,3,1.75,1600,7711,1,0,0,3,7,1600,0,1999,1999,98002,47.284,122.2,2100,7711,15,0,4.75,3700,9311
2.792e+05,2014,257,1,1,640,6350,1,0,0,3,5,640,0,1939,1939,98117,47.698,122.36,1270,6350,75,0,2,1910,6990
5.29e+05,2014,216,3,2,1530,3400,1,0,0,3,7,990,540,1907,2014,98112,47.62,122.3,1880,4212,107,1,5,3410,5742
8.25e+05,2014,204,4,2.25,2770,9340,2,0,0,4,9,2770,0,1979,1979,98027,47.563,122.08,3010,9340,35,0,6.25,5780,12110
6.1745e+05,2015,484,3,2,1580,14398,1,0,0,3,7,1080,500,1981,1981,98005,47.633,122.17,1650,14407,34,0,5,3230,15987
2.44e+05,2015,464,3,1,2000,15900,1,0,0,3,6,1000,1000,1948,1948,98178,47.482,122.23,1760,10500,67,0,4,3760,12500
5.5e+05,2015,452,4,3.5,2770,24140,2,0,0,3,8,2770,0,1967,1967,98033,47.658,122.19,1720,16011,48,0,7.5,4490,18781
2.99e+05,2014,340,3,1,1040,9514,1,0,0,4,7,1040,0,1969,1969,98059,47.494,122.1,1040,9514,45,0,4,2080,10554
3.25e+05,2014,140,4,2.25,1870,9680,1,0,0,4,7,1170,700,1959,1959,98034,47.716,122.23,2000,9790,55,0,6.25,3870,11660
3.3e+05,2014,230,2,1,880,4000,1,0,0,3,6,780,100,1937,1937,98117,47.693,122.38,950,4000,77,0,3,1830,4880
5.35e+05,2015,452,2,1,1390,5346,1,0,0,5,7,960,430,1908,1908,98118,47.557,122.28,1450,5040,107,0,3,2840,6430
7.5e+05,2015,440,4,2.25,2160,9525,1,0,0,3,8,1080,1080,1961,1961,98040,47.565,122.22,2780,9525,54,0,6.25,4940,11685
3.05e+05,2014,189,3,1.5,1800,12196,1,0,0,4,7,1800,0,1966,1966,98023,47.333,122.34,1490,11730,48,0,4.5,3290,13530
3.445e+05,2014,141,4,2.75,1800,5453,1,0,0,3,7,1050,750,2002,2002,98055,47.463,122.21,1820,6900,12,0,6.75,3620,8700
5.25e+05,2015,453,5,3.25,2480,10277,2,0,0,5,8,1640,840,1993,1993,98155,47.773,122.29,2270,10277,22,0,8.25,4750,12757
6.35e+05,2015,425,4,2.25,2350,46173,2,0,0,4,8,2350,0,1980,1980,98053,47.666,122.07,2390,36567,35,0,6.25,4740,38917
4.4e+05,2015,362,4,2.75,2420,10200,1,0,0,3,8,1220,1200,1962,1962,98034,47.72,122.24,2240,9750,53,0,6.75,4660,12170
8.45e+05,2014,300,4,3,2390,4000,1,0,0,5,8,1460,930,1931,1931,98103,47.686,122.33,1670,4000,83,0,7,4060,6390
4.26e+05,2015,463,2,2.5,1550,2657,2,0,0,4,8,1550,0,1987,1987,98033,47.703,122.19,1570,2442,28,0,4.5,3120,3992
4.4e+05,2014,236,4,1,1780,4000,1,0,0,3,7,1780,0,1922,1922,98103,47.662,122.35,1750,4000,92,0,5,3530,5780
5.25e+05,2015,445,4,2,1540,3740,1,0,0,4,7,770,770,1946,1946,98117,47.689,122.38,1090,5080,69,0,6,2630,6620
3.7995e+05,2014,231,4,2.5,2680,4500,2,0,0,3,8,2680,0,2011,2011,98038,47.356,122.06,2010,4500,3,0,6.5,4690,7180
1.7e+06,2015,430,5,2.75,3810,9360,2,0,0,3,10,3810,0,2014,2014,98004,47.604,122.19,2110,9870,1,0,7.75,5920,13680
2.85e+05,2014,223,3,2.5,1690,7460,1,0,0,3,7,870,820,1997,1997,98146,47.496,122.35,1900,7302,17,0,5.5,3590,8992
3.575e+05,2014,181,3,3.5,2080,5100,2,0,0,3,8,2080,0,2004,2004,98038,47.35,122,2080,5100,10,0,6.5,4160,7180
4.25e+05,2015,423,3,2.25,1670,1.0716e+05,1,0,0,3,7,1670,0,2007,2007,98022,47.274,122.01,3310,1.089e+05,8,0,5.25,4980,1.1057e+05
3.02e+05,2014,195,4,2.75,2030,9120,1,0,0,4,7,2030,0,1988,1988,98003,47.282,122.3,1790,7627,26,0,6.75,3820,9657
3.3e+05,2014,180,4,2.5,2340,11784,2,0,0,3,9,2340,0,1997,1997,98042,47.384,122.15,2250,10760,17,0,6.5,4590,13100
3.3995e+05,2014,300,2,1,800,3090,1,0,0,4,6,800,0,1925,1925,98118,47.552,122.28,1400,3090,89,0,3,2200,3890
5.65e+05,2014,212,3,2.5,1700,7210,2,0,0,5,7,1700,0,1966,1966,98052,47.669,122.16,1700,7566,48,0,5.5,3400,9266
3.23e+05,2014,208,3,1.75,1830,12500,1,0,1,3,7,1200,630,1947,1947,98178,47.509,122.25,1830,7300,67,0,4.75,3660,9130
5.35e+05,2014,299,4,2.25,2620,33578,2,0,0,3,7,2620,0,1977,1977,98075,47.592,122.01,2520,35160,37,0,6.25,5140,37780
5.3e+05,2014,133,2,2,1680,4950,1,0,0,3,8,1680,0,2006,2006,98053,47.719,122.02,1570,4800,8,0,4,3250,6480
3.35e+05,2014,273,4,1,1480,6500,1,0,0,4,7,1480,0,1914,1914,98118,47.528,122.27,2380,6000,100,0,5,3860,7480
3.92e+05,2014,333,4,2.5,2600,8921,2,0,0,3,8,2600,0,1991,1991,98058,47.442,122.18,2550,8683,23,0,6.5,5150,11283
9.25e+05,2014,229,5,3.5,4050,13495,1,0,2,4,9,2230,1820,1988,1988,98166,47.438,122.35,3210,13495,26,0,8.5,7260,17545
2.35e+05,2014,216,4,1.5,1760,6150,1,0,0,3,7,1760,0,1951,1951,98031,47.387,122.22,1760,8276,63,0,5.5,3520,10036
2.85e+05,2014,333,3,1.75,1990,6500,1,0,0,3,7,1090,900,1961,1961,98055,47.488,122.22,2150,6500,53,0,4.75,4140,8490
3.1e+05,2014,361,3,2,1310,1361,3,0,0,3,7,1310,0,2003,2003,98133,47.734,122.34,1370,1608,11,0,5,2680,2918
3.15e+05,2015,452,3,2,1220,14645,1,0,0,3,6,1220,0,1970,1970,98059,47.484,122.12,1980,24960,45,0,5,3200,26180
7e+05,2015,409,4,2,2230,4635,1,0,0,5,7,1510,720,1908,1908,98103,47.682,122.35,1520,4635,107,0,6,3750,6865
5.87e+05,2014,195,3,2.5,2150,5193,2,0,0,3,8,2150,0,1995,1995,98033,47.695,122.19,2150,7172,19,0,5.5,4300,9322
3.2993e+05,2014,149,3,1.5,1460,5040,1,0,0,3,7,1100,360,1971,1971,98133,47.711,122.36,2330,7560,43,0,4.5,3790,9020
7.15e+05,2014,218,3,1,1610,7680,1,0,0,3,6,900,710,1956,1956,98122,47.604,122.3,1940,2880,58,0,4,3550,4490
7.175e+05,2015,395,3,2.5,2530,9932,2,0,0,3,8,2530,0,1995,1995,98052,47.685,122.16,2140,7950,20,0,5.5,4670,10480
4.55e+05,2015,381,3,1.75,890,3800,1,0,0,3,7,750,140,1926,1926,98115,47.68,122.29,1280,3800,89,0,4.75,2170,4690
1.6e+05,2015,416,3,1,880,8976,1,0,0,4,6,880,0,1966,1966,98023,47.306,122.37,990,8760,49,0,4,1870,9640
6.28e+05,2015,432,5,2.75,2600,8160,2,0,0,3,8,2600,0,2015,2015,98133,47.735,122.34,1600,8160,0,0,7.75,4200,10760
3.995e+05,2015,432,4,1.5,1660,6617,1,0,0,5,7,1660,0,1947,1947,98155,47.739,122.32,950,7440,68,0,5.5,2610,9100
5.75e+05,2014,266,4,2.5,2630,6247,2,0,0,3,8,2630,0,1992,1992,98029,47.566,122,2130,4668,22,0,6.5,4760,7298
7.6001e+05,2014,188,4,2.75,3090,5859,2,0,0,3,9,3090,0,2010,2010,98074,47.606,122.05,2960,5250,4,0,6.75,6050,8340
8.49e+05,2014,171,4,2,2160,6300,1,0,1,4,8,2160,0,1928,1928,98116,47.566,122.4,1980,5152,86,0,6,4140,7312
3.71e+05,2015,443,3,1.75,1570,15330,1,0,0,3,7,1080,490,1956,1956,98166,47.461,122.34,1250,13330,59,0,4.75,2820,14900
8.1e+05,2014,202,4,2.5,2910,6555,2,0,0,3,9,2910,0,2005,2005,98033,47.666,122.17,2910,10419,9,0,6.5,5820,13329
5e+05,2014,127,3,2.5,1940,37565,1,0,0,4,8,1940,0,1987,1987,98027,47.48,122.06,2560,37565,27,0,5.5,4500,39505
4.1e+05,2014,320,3,2,1410,8088,1,0,0,3,7,1410,0,1987,1987,98034,47.73,122.23,1770,7401,27,0,5,3180,8811
3.26e+05,2014,238,5,2.75,2166,6342,2,0,0,3,8,2166,0,2013,2013,98042,47.346,122.15,2474,5948,1,0,7.75,4640,8114
1.015e+06,2014,271,4,2.5,2700,4590,2,0,0,3,8,2700,0,2002,2002,98103,47.673,122.33,2080,3570,12,0,6.5,4780,6270
5.175e+05,2015,433,3,1.75,1810,10625,1,0,0,3,8,1370,440,1973,1973,98027,47.532,122.05,2140,10922,42,0,4.75,3950,12732
8.1e+05,2014,239,3,2,2870,6360,1,0,1,4,8,1790,1080,1946,1946,98115,47.681,122.28,2310,6466,68,0,5,5180,9336
7.95e+05,2015,473,3,1.75,1930,9600,1,0,0,3,8,1930,0,1958,1958,98040,47.575,122.24,2350,9840,57,0,4.75,4280,11770
6e+05,2014,352,3,1.75,2300,12682,1,0,2,3,8,2300,0,1955,1955,98028,47.759,122.27,2720,14643,59,0,4.75,5020,16943
6.1e+05,2014,154,4,3.5,2910,5260,2,0,0,3,9,2910,0,2012,2012,98065,47.517,121.88,2910,5260,2,0,7.5,5820,8170
6.61e+05,2014,225,2,1,1260,5800,1,0,0,4,7,1260,0,1939,1939,98199,47.65,122.41,1830,5800,75,0,3,3090,7060
1.085e+06,2015,464,5,2.25,3650,13068,1,0,0,4,10,1850,1800,1976,1976,98040,47.546,122.23,2760,13927,39,0,7.25,6410,17577
4.915e+05,2015,486,3,2.25,1560,12000,1,0,0,4,7,1110,450,1968,1968,98034,47.726,122.17,2190,4612,47,0,5.25,3750,6172
3.885e+05,2015,457,4,2.5,2718,6197,2,0,0,3,8,2718,0,2006,2006,98092,47.325,122.16,2667,5000,9,0,6.5,5385,7718
2.52e+05,2014,236,3,2.25,1740,10836,1,0,0,3,7,910,830,1981,1981,98031,47.398,122.17,2090,7500,33,0,5.25,3830,9240
6.7995e+05,2015,446,4,2.5,2850,5664,2,0,0,3,9,2850,0,2001,2001,98075,47.584,122,2850,5475,14,0,6.5,5700,8325
1.873e+05,2014,198,2,1,1310,7697,1,0,0,3,6,850,460,1950,1950,98146,47.498,122.35,1270,6410,64,0,3,2580,7720
5.1e+05,2014,148,4,1.5,2040,8800,1,0,0,4,7,1020,1020,1961,1961,98007,47.596,122.14,1490,8800,53,0,5.5,3530,10840
3.95e+05,2014,303,4,1.75,1950,10219,1,0,0,3,7,1950,0,1962,1962,98133,47.749,122.34,1500,9099,52,0,5.75,3450,11049
4.6495e+05,2015,439,3,2,2190,19800,1,0,0,3,7,2190,0,1994,1994,98146,47.511,122.36,1640,9719,21,0,5,3830,11909
5.25e+05,2015,452,3,2.5,1720,7950,1,0,0,4,7,1720,0,1972,1972,98034,47.718,122.17,1790,7030,43,0,5.5,3510,8750
2.39e+05,2014,294,4,2,1370,8837,1,0,0,3,7,1370,0,1955,1955,98188,47.439,122.28,1360,9000,59,0,6,2730,10370
7.34e+05,2014,258,4,2.5,3490,18521,2,0,0,4,9,3490,0,1990,1990,98077,47.741,122.07,2850,18521,24,0,6.5,6340,22011
4e+05,2014,215,2,2,2010,3797,1,0,0,3,7,1450,560,1922,2004,98108,47.56,122.31,1660,4650,92,1,4,3670,6660
5.525e+05,2014,215,3,1,2020,4120,1,0,0,4,7,1520,500,1929,1929,98118,47.551,122.27,1200,4635,85,0,4,3220,6655
2.95e+05,2014,209,3,2,1810,10530,1,0,2,3,8,1810,0,1991,1991,98022,47.191,122.01,1910,10450,23,0,5,3720,12260
6.21e+05,2014,360,4,2.75,1950,6930,1,0,2,4,7,1250,700,1960,1960,98008,47.616,122.11,1950,8560,54,0,6.75,3900,10510
6.35e+05,2015,453,4,2.5,2970,7961,1,0,0,3,8,2020,950,1969,1969,98125,47.712,122.29,1410,7959,46,0,6.5,4380,10929
2.85e+05,2014,176,2,1,1010,7200,1,0,0,3,7,1010,0,1975,1975,98155,47.765,122.29,1890,9248,39,0,3,2900,10258
3.6e+05,2015,465,4,2,1650,7552,1,0,0,4,7,860,790,1977,1977,98155,47.776,122.32,1410,7199,38,0,6,3060,8849
9.63e+05,2014,166,4,3.5,3280,6603,2,0,0,3,10,3280,0,2007,2007,98027,47.564,122.13,3280,7333,7,0,7.5,6560,10613
7.23e+05,2014,182,4,2.25,2430,4748,1,0,0,3,8,1630,800,1928,1928,98116,47.59,122.39,2430,4748,86,0,6.25,4860,7178
6.07e+05,2015,424,4,2,1490,4054,1,0,0,5,7,1490,0,1926,1926,98115,47.674,122.3,1510,3889,89,0,6,3000,5379
2.5235e+05,2014,135,3,2,1650,7352,1,0,0,3,7,1160,490,1979,1979,98058,47.461,122.17,1710,7350,35,0,5,3360,9000
4.25e+05,2014,230,3,1,1240,5750,1,0,0,4,6,1240,0,1948,1948,98116,47.564,122.4,1240,5750,66,0,4,2480,6990
2.85e+05,2014,336,2,1,720,6400,1,0,0,4,6,720,0,1943,1943,98126,47.529,122.37,1030,6400,71,0,3,1750,7120
1.11e+06,2014,341,4,3.25,3520,19354,1,0,2,4,9,2010,1510,1978,1978,98006,47.557,122.15,2630,19354,36,0,7.25,6150,22874
1.26e+06,2014,269,4,2,2970,5400,2,0,0,4,9,2970,0,1900,1900,98112,47.623,122.31,2500,5040,114,0,6,5470,8010
3.75e+05,2014,245,4,2.25,1450,7245,1,0,0,5,7,1450,0,1950,1983,98133,47.764,122.34,1660,7800,64,1,6.25,3110,9250
2.495e+05,2015,408,3,1,1180,7200,1,0,0,4,7,1180,0,1968,1968,98058,47.425,122.18,1180,7200,47,0,4,2360,8380
8.2e+05,2014,149,4,2.25,2280,6660,1,0,2,3,8,1960,320,1940,1984,98119,47.65,122.37,1720,5336,74,1,6.25,4000,7616
4.25e+05,2015,450,2,1,1250,5880,1,0,0,3,6,900,350,1948,1948,98117,47.691,122.39,1520,5020,67,0,3,2770,6270
3.5e+05,2014,332,2,1.5,830,1077,2,0,0,3,7,830,0,2006,2006,98122,47.606,122.32,830,1366,8,0,3.5,1660,2196
7.22e+05,2014,266,4,2.75,3190,5408,2,0,0,3,9,3190,0,2005,2005,98075,47.59,121.99,3160,5773,9,0,6.75,6350,8963
2.9e+05,2015,408,3,2,1550,18958,1,0,0,3,7,1550,0,1983,1983,98198,47.37,122.32,1840,12826,32,0,5,3390,14376
4.97e+05,2014,208,2,1,770,3325,1,0,0,3,7,770,0,1918,1918,98122,47.61,122.3,960,4800,96,0,3,1730,5570
5.91e+05,2014,133,4,2.25,2710,38180,2,0,0,4,8,2710,0,1977,1977,98077,47.77,122.1,2590,38180,37,0,6.25,5300,40890
2.199e+05,2015,458,3,1,860,10426,1,0,0,3,6,860,0,1954,1954,98146,47.499,122.34,1140,11250,61,0,4,2000,12110
3.75e+05,2014,303,3,1,1780,5236,1,0,0,5,6,1050,730,1944,1944,98146,47.512,122.39,1260,5320,70,0,4,3040,7100
2.76e+05,2014,279,2,1,870,2676,1,0,0,3,7,820,50,2004,2004,98144,47.57,122.29,1500,1719,10,0,3,2370,2589
2.8957e+05,2015,459,3,1.5,1340,25160,1,0,0,3,7,1340,0,1968,1968,98059,47.475,122.11,1440,23680,47,0,4.5,2780,25020
2.25e+05,2014,300,2,1,830,5720,1,0,0,4,6,830,0,1950,1950,98133,47.734,122.34,1150,5250,64,0,3,1980,6080
8.65e+05,2014,318,3,1.5,1530,10827,1,0,0,4,8,1530,0,1955,1955,98039,47.635,122.23,2050,10827,59,0,4.5,3580,12357
6.3e+05,2014,194,4,2.5,2510,35020,1,0,0,4,8,1610,900,1977,1977,98075,47.583,122,2080,34398,37,0,6.5,4590,36908
8.75e+05,2014,188,4,3.5,3110,1.0846e+05,2,0,2,4,8,3110,0,1979,1979,98075,47.592,122.02,2340,4938,35,0,7.5,5450,8048
5.55e+05,2015,479,3,1.75,1270,9170,1,0,0,3,7,1270,0,1969,1969,98052,47.671,122.15,1700,8500,46,0,4.75,2970,9770
5.505e+05,2015,424,2,1.5,930,7400,1,0,2,4,7,830,100,1909,1909,98116,47.569,122.41,1920,4152,106,0,3.5,2850,5082
2.472e+05,2014,196,3,1,1590,11200,1,0,0,4,7,1590,0,1961,1961,98092,47.289,122.19,1560,9750,53,0,4,3150,11340
5.65e+05,2014,134,4,2.5,2240,14667,2,0,0,4,9,2240,0,1989,1989,98059,47.528,122.16,2410,11243,25,0,6.5,4650,13483
2.3e+05,2015,429,3,1,1250,8800,1,0,0,3,7,1250,0,1955,1955,98146,47.497,122.36,1480,8200,60,0,4,2730,9450
3.8e+05,2015,410,4,2.5,2000,6921,2,0,0,3,8,2000,0,2003,2003,98038,47.356,122.01,2430,6339,12,0,6.5,4430,8339
2.81e+05,2014,248,3,1.5,1280,974,3,0,0,3,7,1280,0,2003,2003,98125,47.716,122.29,1420,1422,11,0,4.5,2700,2702
5.15e+05,2015,388,4,2.5,1800,4338,2,0,0,3,8,1800,0,2001,2001,98075,47.596,122.02,1800,4507,14,0,6.5,3600,6307
5.9e+05,2014,299,4,1.5,2230,5109,1,0,0,3,7,1330,900,1918,1918,98115,47.7,122.31,1630,5109,96,0,5.5,3860,7339
3.999e+05,2014,183,2,1.75,1410,1005,1,0,0,3,9,900,510,2011,2011,98027,47.545,122.02,1440,1188,3,0,3.75,2850,2598
1.228e+06,2014,162,4,2.5,5730,44947,2,0,4,3,11,4280,1450,1991,1991,98074,47.605,122.06,3310,17628,23,0,6.5,9040,23358
2.41e+05,2015,403,3,1,1020,7538,1,0,0,3,7,1020,0,1981,1981,98032,47.359,122.29,1650,7201,34,0,4,2670,8221
5.54e+05,2015,456,3,2,1910,9001,1,0,0,4,7,1910,0,1957,1957,98008,47.604,122.12,2040,8700,58,0,5,3950,10610
4.8e+05,2014,170,4,1,2080,5500,1,0,0,3,7,1040,1040,1941,1941,98117,47.684,122.39,1280,4000,73,0,5,3360,6080
3.2e+05,2015,374,3,1.75,2300,41900,1,0,0,4,8,1310,990,1939,1939,98168,47.477,122.29,1160,8547,76,0,4.75,3460,10847
3.39e+05,2014,174,3,1,1100,4128,1,0,0,4,7,720,380,1942,1942,98126,47.53,122.38,1510,4538,72,0,4,2610,5638
1.7541e+05,2014,278,4,1.5,1450,5530,1,0,0,4,6,1450,0,1969,1969,98042,47.361,122.09,1060,5200,45,0,5.5,2510,6650
2.508e+05,2014,275,3,1.75,1290,4000,1,0,0,3,6,1170,120,1943,1943,98106,47.531,122.35,1140,4000,71,0,4.75,2430,5290
3.15e+05,2014,188,2,1,1080,2674,1,0,0,4,6,720,360,1919,1919,98108,47.559,122.32,1250,5000,95,0,3,2330,6080
7.51e+05,2014,132,4,2.5,3110,6142,2,0,0,3,9,3110,0,2004,2004,98052,47.701,122.11,3200,6826,10,0,6.5,6310,9936
6.45e+05,2015,472,4,2.5,2250,10696,2,0,0,3,8,2250,0,1996,1996,98006,47.572,122.13,2340,13286,19,0,6.5,4590,15536
3.185e+05,2014,196,4,2,1780,7350,1,0,0,5,7,900,880,1974,1974,98058,47.456,122.16,1480,7350,40,0,6,3260,9130
5.58e+05,2014,339,3,2.25,2220,15757,1,0,0,3,8,1280,940,1982,1982,98074,47.621,122.04,2020,14098,32,0,5.25,4240,16318
5.3e+05,2014,177,4,1.75,2860,48351,1,0,0,3,8,1710,1150,1978,1978,98077,47.761,122.08,2460,43560,36,0,5.75,5320,46420
4.2e+05,2015,430,3,1.5,2390,4600,2,0,0,3,8,1750,640,1920,1995,98118,47.538,122.27,1690,5220,95,1,4.5,4080,7610
2.955e+05,2014,243,3,1.75,1590,41550,1,0,0,3,6,1290,300,1933,1989,98168,47.482,122.28,2990,6464,81,1,4.75,4580,8054
3.95e+05,2014,204,3,2.5,2130,5088,2,0,0,3,8,1840,290,2011,2011,98019,47.733,121.98,2130,5762,3,0,5.5,4260,7892
1.555e+06,2014,326,5,2.5,2870,16238,2,0,0,4,8,2870,0,1962,1962,98039,47.631,122.24,2870,16238,52,0,7.5,5740,19108
7.8e+05,2014,290,3,1.75,2430,4524,1,0,0,4,7,1830,600,1924,1924,98103,47.674,122.35,1610,4100,90,0,4.75,4040,6530
8.49e+05,2014,338,5,3.25,2450,6534,2,0,0,3,8,1770,680,1951,2014,98115,47.688,122.28,1620,6534,63,1,8.25,4070,8984
7.35e+05,2015,459,4,2.25,2410,4250,1,0,0,5,7,1460,950,1929,1929,98117,47.685,122.38,1360,5074,86,0,6.25,3770,7484
1.2007e+06,2015,485,5,3,3640,28531,2,0,0,3,10,3640,0,1996,1996,98006,47.55,122.13,3330,17186,19,0,8,6970,20826
2.95e+05,2015,474,3,2,1230,3405,1,0,0,3,7,1230,0,2010,2010,98058,47.438,122.18,1440,4066,5,0,5,2670,5296
3.45e+05,2014,243,3,2.5,1870,3584,2,0,0,3,8,1870,0,2003,2003,98058,47.452,122.12,1900,3920,11,0,5.5,3770,5790
8.1e+05,2015,382,4,2.75,2820,5000,1,0,0,3,8,2170,650,1927,1927,98199,47.638,122.39,1740,5000,88,0,6.75,4560,7820
4.2995e+05,2014,290,3,1.75,1430,9750,1,0,0,5,7,1430,0,1962,1962,98133,47.744,122.36,1630,9282,52,0,4.75,3060,10712
9.265e+05,2014,306,4,2.75,2900,17802,1,0,2,3,9,1750,1150,1981,1981,98034,47.7,122.23,2900,15720,33,0,6.75,5800,18620
2.39e+05,2015,477,3,1,940,8571,1,0,0,3,6,940,0,1950,1950,98146,47.501,122.34,1100,8573,65,0,4,2040,9513
5.9e+05,2015,424,4,2.5,2940,12600,1,0,0,4,8,1850,1090,1974,1974,98074,47.629,122.06,2030,11770,41,0,6.5,4970,14710
4e+05,2014,153,3,1.5,1200,4800,1,0,0,4,7,1200,0,1962,1962,98007,47.608,122.14,1510,7668,52,0,4.5,2710,8868
4.2495e+05,2015,481,3,2.5,1650,4777,2,0,0,3,8,1650,0,2013,2013,98065,47.534,121.84,1800,3331,2,0,5.5,3450,4981
5.29e+05,2014,149,3,1,1590,6420,1,0,0,3,7,1590,0,1944,1944,98136,47.535,122.39,1780,5900,70,0,4,3370,7490
1.16e+06,2014,195,4,2.5,4240,43995,2,0,0,3,10,4240,0,1989,1989,98075,47.601,122.04,3720,59522,25,0,6.5,7960,63762
2.65e+05,2015,440,4,2,1600,10160,1,0,0,4,7,1600,0,1972,1972,98022,47.202,122,1540,9352,43,0,6,3140,10952
2.027e+06,2014,167,4,3.75,4100,22798,1,0,3,5,11,2540,1560,1934,1979,98040,47.565,122.21,3880,18730,80,1,7.75,7980,22830
2.1e+05,2014,248,3,1,1200,7200,1,0,0,3,6,1200,0,1977,1977,98030,47.375,122.18,1200,7420,37,0,4,2400,8620
3.15e+05,2014,263,4,2.75,2300,18360,1,0,0,4,7,1560,740,1979,1979,98058,47.452,122.16,1870,9588,35,0,6.75,4170,11888
5.404e+05,2015,392,4,1.75,1680,6758,1,0,0,3,8,1680,0,1974,1974,98008,47.641,122.11,1910,7000,41,0,5.75,3590,8680
2.85e+05,2015,474,3,2.25,1840,9040,1,0,0,3,8,1370,470,1979,1979,98023,47.314,122.34,1870,8992,36,0,5.25,3710,10832
7.7013e+05,2014,277,4,2.75,2390,9300,1,0,0,3,8,1430,960,1979,1979,98004,47.603,122.21,1910,9348,35,0,6.75,4300,11738
2.5e+05,2015,446,4,1.75,1910,8250,1,0,0,4,7,1910,0,1959,1959,98008,47.613,122.12,1500,8250,56,0,5.75,3410,10160
3.095e+05,2014,215,3,1.5,1340,13560,1,0,0,3,7,1340,0,1968,1968,98028,47.741,122.23,1540,15000,46,0,4.5,2880,16340
1.37e+06,2014,129,4,2.75,3720,9450,1,0,4,5,10,1960,1760,1962,1962,98006,47.563,122.16,2900,8605,52,0,6.75,6620,12325
4.15e+05,2014,204,5,2.75,2060,8906,1,0,0,4,7,1220,840,1978,1978,98118,47.536,122.29,1840,8906,36,0,7.75,3900,10966
1.9999e+05,2015,376,3,1,840,5200,1,0,0,3,6,840,0,1969,2014,98042,47.368,122.08,870,5200,46,1,4,1710,6040
4.249e+05,2014,203,4,2.75,2950,49658,1,0,0,4,8,2950,0,1960,1998,98010,47.36,121.92,1720,54672,54,1,6.75,4670,57622
3.2495e+05,2015,387,3,2,1340,9750,1,0,0,4,7,890,450,1974,1974,98024,47.564,121.9,1460,12900,41,0,5,2800,14240
5.1e+05,2015,451,4,2.5,1620,8125,2,0,0,4,7,1620,0,1983,1983,98074,47.626,122.06,1480,8120,32,0,6.5,3100,9740
3.05e+05,2015,368,2,1,1290,3383,2,0,0,3,7,1290,0,2008,2008,98053,47.697,122.03,1290,2828,7,0,3,2580,4118
4.25e+05,2014,277,4,2,1330,9188,1,0,0,3,7,1330,0,1928,2004,98198,47.401,122.32,1770,10419,86,1,6,3100,11749
4.8495e+05,2015,415,3,2.25,1670,5004,2,0,0,3,8,1670,0,1987,1987,98029,47.569,122.02,1850,5276,28,0,5.25,3520,6946
1.175e+06,2015,458,4,3.25,3780,10099,1,0,1,3,11,2240,1540,2006,2006,98006,47.551,122.19,3120,10669,9,0,7.25,6900,14449
1.965e+06,2015,416,5,3.75,3940,13738,1,0,3,4,9,3940,0,1951,1951,98004,47.62,122.21,2370,13320,64,0,8.75,6310,17260
2.8879e+05,2014,198,3,1.75,1290,1237,2,0,0,3,7,1060,230,2008,2008,98027,47.54,122.03,1370,942,6,0,4.75,2660,2232
4.27e+05,2014,317,3,1,1200,5252,1,0,0,3,7,1200,0,1962,1962,98007,47.608,122.13,1800,7920,52,0,4,3000,9120
5.85e+05,2015,422,2,1,1110,6000,1,0,0,3,7,1010,100,1951,1951,98118,47.563,122.28,1410,3500,64,0,3,2520,4610
2.81e+05,2014,203,3,2.5,1760,7601,2,0,0,3,8,1760,0,1992,1992,98003,47.267,122.31,1920,6851,22,0,5.5,3680,8611
2.4e+06,2014,150,4,3.25,4140,20734,1,0,1,3,10,3300,840,1977,2005,98004,47.634,122.22,4020,20008,37,1,7.25,8160,24148
5.95e+05,2014,143,2,1.5,1030,4500,1,0,0,3,7,830,200,1924,1924,98109,47.645,122.35,1250,4000,90,0,3.5,2280,5030
3.95e+05,2015,467,4,2.5,2810,10951,2,0,0,3,8,2810,0,2003,2003,98092,47.325,122.19,1680,6625,12,0,6.5,4490,9435
9.01e+05,2014,297,4,2.75,3030,18400,1,0,3,3,9,2360,670,1973,1973,98034,47.702,122.24,3030,12486,41,0,6.75,6060,15516
7.2e+05,2014,333,3,1.5,2180,5000,1,0,3,4,8,1090,1090,1941,1941,98116,47.579,122.4,2070,5000,73,0,4.5,4250,7180
3.5e+05,2014,298,3,1.75,1900,10225,1,0,0,4,8,1220,680,1963,1963,98166,47.478,122.36,1850,12630,51,0,4.75,3750,14530
6.28e+05,2015,453,3,2.25,1720,8521,1,0,0,4,7,1140,580,1984,1984,98033,47.688,122.18,1530,8692,31,0,5.25,3250,10412
5.225e+05,2014,136,3,2.5,2370,7875,2,0,0,3,9,2370,0,2003,2003,98065,47.543,121.86,2660,7752,11,0,5.5,5030,10122
3e+05,2014,237,3,1,1300,20812,1,0,0,3,6,1300,0,1927,1927,98106,47.544,122.36,1210,17340,87,0,4,2510,18640
8.4e+05,2015,480,4,2.5,2170,9796,1,0,0,4,8,1650,520,1980,1980,98006,47.55,122.15,2350,9796,35,0,6.5,4520,11966
2.9583e+05,2014,147,5,1,1410,6400,1,0,0,5,7,960,450,1955,1955,98198,47.421,122.33,1400,6500,59,0,6,2810,7910
9.45e+05,2015,451,5,3.5,4380,14925,2,0,0,3,11,4380,0,2003,2003,98075,47.585,121.97,4310,14633,12,0,8.5,8690,19013
1.03e+06,2014,125,5,2.75,3190,16920,1,0,3,3,9,1690,1500,1976,1976,98006,47.564,122.16,3100,13100,38,0,7.75,6290,16290
3.25e+05,2015,471,3,2.5,2540,4260,2,0,0,3,7,2540,0,2005,2005,98042,47.399,122.16,2190,4260,10,0,5.5,4730,6800
4.1e+05,2014,313,4,1,1140,7208,1,0,0,3,7,900,240,1970,1970,98072,47.742,122.17,1300,7991,44,0,5,2440,9131
8.26e+05,2014,176,4,2.5,3060,7140,2,0,0,3,9,3060,0,2006,2006,98027,47.539,122,3240,6218,8,0,6.5,6300,9278
4.83e+05,2014,174,2,1.75,1240,3000,1,0,0,3,7,1240,0,1906,1906,98105,47.669,122.33,1800,4080,108,0,3.75,3040,5320
6.47e+05,2014,132,4,2.5,3040,6887,2,0,0,3,8,3040,0,1999,1999,98074,47.607,122.02,2790,7196,15,0,6.5,5830,10236
7.3e+05,2015,473,4,1.5,2340,5000,2,0,0,3,8,2100,240,1912,1912,98122,47.606,122.29,2320,5500,103,0,5.5,4660,7840
3.05e+05,2015,467,2,1,890,7200,1,0,0,3,7,740,150,1949,1949,98115,47.7,122.28,1290,7200,66,0,3,2180,8090
3.05e+05,2015,478,3,2.25,1740,6650,1,0,0,3,7,1240,500,1978,1978,98023,47.298,122.38,1740,7000,37,0,5.25,3480,8740
2.475e+05,2014,272,3,2,1530,8749,1,0,0,3,7,1530,0,1995,1995,98023,47.297,122.37,1750,8749,19,0,5,3280,10279
8.05e+05,2015,459,4,2,1890,4500,1,0,0,3,7,1490,400,1907,1993,98103,47.668,122.36,1640,4010,108,1,6,3530,5900
2.3e+05,2014,174,4,1.75,1850,6000,1,0,0,4,6,1270,580,1944,1944,98178,47.492,122.25,1270,6600,70,0,5.75,3120,8450
3.7e+05,2014,217,2,1,820,6550,1,0,0,3,7,820,0,1949,2012,98126,47.548,122.38,1640,6550,65,1,3,2460,7370
4.42e+05,2015,474,5,3,2560,5445,1,0,0,4,7,1760,800,1927,1927,98108,47.55,122.31,1080,5445,88,0,8,3640,8005
5.3e+05,2014,243,2,2.5,1900,2983,2,0,0,3,8,1900,0,2006,2006,98053,47.703,122.02,1510,3876,8,0,4.5,3410,5776
3.63e+05,2014,162,3,3.25,1651,1779,2,0,0,3,8,1341,310,2008,2008,98133,47.708,122.35,1650,2908,6,0,6.25,3301,4559
6.35e+05,2015,477,3,1.75,1480,6985,1,0,0,4,7,1200,280,1926,1926,98117,47.686,122.37,1480,5588,89,0,4.75,2960,7068
2.27e+05,2014,251,4,1,1120,8763,1,0,0,3,6,1120,0,1971,1971,98146,47.508,122.36,1120,8636,43,0,5,2240,9756
4.85e+05,2015,458,4,1.75,1260,3880,1,0,0,5,7,860,400,1918,1918,98117,47.687,122.39,1000,3880,97,0,5.75,2260,5140
2.6e+05,2014,236,3,1,1790,11884,1,0,0,3,7,1790,0,1951,1951,98031,47.389,122.22,1660,11513,63,0,4,3450,13303
9.7197e+05,2014,176,4,3.75,3460,6738,2,0,0,3,11,3460,0,2013,2013,98059,47.506,122.14,3340,6120,1,0,7.75,6800,9580
6.881e+05,2014,318,4,2.5,2370,10513,2,0,0,4,8,2370,0,1987,1987,98052,47.691,122.1,2110,9540,27,0,6.5,4480,11910
4.71e+05,2014,333,4,1.75,1760,5750,1,0,2,5,7,1070,690,1962,1962,98126,47.552,122.37,1860,5750,52,0,5.75,3620,7510
3.7004e+05,2015,451,2,1,1250,9270,1,0,0,4,7,1250,0,1948,1948,98133,47.728,122.34,1130,6800,67,0,3,2380,8050
3.08e+05,2014,298,2,1,1080,6250,1,0,2,4,7,1080,0,1942,1968,98118,47.513,122.25,2100,6875,72,1,3,3180,7955
3.45e+05,2014,331,2,1.75,1820,8409,1,0,0,4,6,910,910,1948,1948,98155,47.754,122.33,1300,8409,66,0,3.75,3120,10229
3.45e+05,2014,304,3,1,960,3844,1,0,0,3,7,960,0,1972,1972,98133,47.703,122.35,1020,3844,42,0,4,1980,4804
6.46e+05,2014,169,4,2.5,2310,4079,2,0,0,3,8,2310,0,2008,2008,98117,47.694,122.36,1220,4800,6,0,6.5,3530,7110
3.89e+05,2014,147,5,2,2330,10750,1,0,0,4,7,1190,1140,1962,1962,98028,47.733,122.25,1830,10180,52,0,7,4160,12510
1.425e+05,2015,459,1,1,690,6825,1,0,0,4,5,690,0,1917,1917,98002,47.311,122.22,1330,5381,98,0,2,2020,6071
4e+05,2014,279,3,1,1000,7800,1,0,0,4,6,860,140,1930,1930,98125,47.71,122.28,1700,7800,84,0,4,2700,8800
2.2e+06,2014,333,4,3,3540,11098,2,0,0,3,10,3000,540,1940,1940,98112,47.634,122.29,3430,8214,74,0,7,6970,11754
7.6e+05,2014,215,3,1.5,1170,7645,1,0,0,4,7,1170,0,1955,1955,98004,47.608,122.19,1870,7678,59,0,4.5,3040,8848
2.2e+05,2014,331,2,2.5,1000,1092,2,0,0,3,7,990,10,2004,2004,98118,47.542,122.27,1330,1466,10,0,4.5,2330,2466
4.825e+05,2014,139,3,2.25,1450,1445,2,0,0,3,7,980,470,2005,2005,98122,47.618,122.3,1510,1370,9,0,5.25,2960,2820
7.13e+05,2014,262,5,2.75,2580,9242,2,0,2,4,8,1720,860,1967,1967,98007,47.594,122.13,2240,9316,47,0,7.75,4820,11896
5.15e+05,2015,395,2,1,1060,4228,1,0,0,3,7,860,200,1906,1906,98112,47.623,122.29,1060,4187,109,0,3,2120,5247
7.75e+05,2014,204,4,2.5,2070,8473,1,0,0,4,8,1250,820,1976,1976,98033,47.661,122.19,2070,9499,38,0,6.5,4140,11569
5.9e+05,2014,257,3,2.5,2520,10223,2,0,0,3,10,2520,0,1988,1988,98074,47.631,122.04,2630,10091,26,0,5.5,5150,12611
4.6495e+05,2014,191,4,2.5,2230,64438,1,0,0,4,7,1230,1000,1978,1978,98027,47.475,122.01,2230,71002,36,0,6.5,4460,73232
6.29e+05,2015,369,5,2,2050,3000,1,0,0,3,7,1470,580,1912,1984,98103,47.686,122.35,1560,4500,103,1,7,3610,6550
3.06e+05,2014,136,3,2.5,1870,5874,2,0,0,3,7,1870,0,2005,2005,98042,47.399,122.16,2090,4060,9,0,5.5,3960,5930
1.25e+06,2014,264,4,3.25,3160,10043,2,0,2,3,9,3160,0,2011,2011,98034,47.7,122.24,3450,10043,3,0,7.25,6610,13203
1.925e+05,2014,339,3,1,1100,9750,1,0,0,4,7,1100,0,1966,1966,98023,47.325,122.34,1190,9750,48,0,4,2290,10850
3.05e+05,2014,182,2,1,2160,12960,1,0,0,3,7,1360,800,1968,1968,98168,47.47,122.26,2070,12960,46,0,3,4230,15120
5.65e+05,2014,139,4,2.25,2110,10698,2,0,0,4,8,2110,0,1979,1979,98027,47.561,122.08,2220,8252,35,0,6.25,4330,10362
4.68e+05,2014,147,2,1,1160,6000,1,0,0,4,7,860,300,1942,1942,98115,47.69,122.29,1330,6000,72,0,3,2490,7160
5.02e+05,2014,173,6,2.5,2890,8122,1,0,0,3,8,1630,1260,1977,1977,98008,47.589,122.11,2730,9915,37,0,8.5,5620,12805
3.35e+05,2014,263,4,1.75,1670,9472,1,0,0,3,7,1100,570,1960,1960,98106,47.53,122.36,1080,5195,54,0,5.75,2750,6865
5.965e+05,2015,367,4,2.25,1770,8505,2,0,0,3,8,1770,0,1986,1986,98052,47.69,122.1,1880,8939,29,0,6.25,3650,10709
3.75e+05,2014,349,2,1,980,3915,1,0,0,4,7,980,0,1919,1919,98118,47.559,122.29,1425,1576,95,0,3,2405,2556
3.5e+05,2014,334,2,1.5,1320,73600,1,0,0,3,7,1320,0,1993,1993,98001,47.276,122.27,1320,33600,21,0,3.5,2640,34920
3.78e+05,2014,187,3,2.5,1601,2491,3,0,0,3,7,1536,65,2007,2007,98125,47.719,122.32,1420,1156,7,0,5.5,3021,2757
6.55e+05,2015,463,2,1.75,1450,15798,2,1,4,3,7,1230,220,1915,1978,98166,47.45,122.38,2030,13193,100,1,3.75,3480,14643
3.1e+05,2014,203,3,2.5,1990,3600,2,0,0,3,7,1990,0,2004,2004,98038,47.384,122.04,1790,3600,10,0,5.5,3780,5590
8.22e+05,2015,415,3,2,2410,13300,2,0,0,3,9,1840,570,1985,1985,98006,47.563,122.15,2930,10900,30,0,5,5340,13310
9.65e+05,2015,410,4,3.5,3290,5559,1,0,0,3,8,2290,1000,1906,2004,98103,47.679,122.35,1790,6000,109,1,7.5,5080,9290
5.2e+05,2015,369,3,1.75,1540,7558,1,0,0,3,8,1540,0,1964,1964,98052,47.671,122.16,1540,7863,51,0,4.75,3080,9403
9.81e+05,2014,264,4,2.5,2110,10100,1,0,2,3,8,2110,0,1968,2005,98006,47.567,122.15,2230,10100,46,1,6.5,4340,12210
2.85e+05,2015,488,5,1.5,1840,8050,1,0,0,4,7,1840,0,1962,1962,98198,47.367,122.31,1690,8151,53,0,6.5,3530,9991
3.29e+05,2014,341,4,2,1190,7877,1,0,0,5,7,1190,0,1946,1946,98155,47.754,122.32,1480,9975,68,0,6,2670,11165
6.53e+05,2014,331,4,2.5,2160,7000,2,0,0,4,9,2160,0,1989,1989,98029,47.566,122.01,2300,7440,25,0,6.5,4460,9600
2.95e+05,2014,271,3,2.5,1460,7936,2,0,0,3,7,1460,0,1995,1995,98038,47.367,122.02,1830,7936,19,0,5.5,3290,9396
8.4875e+05,2014,202,6,3.75,3160,5000,2,0,0,3,8,3160,0,1989,1989,98107,47.675,122.38,1740,5000,25,0,9.75,4900,8160
4e+05,2015,444,3,2.5,1950,18533,2,0,0,3,8,1950,0,1988,1988,98024,47.565,121.9,1810,18401,27,0,5.5,3760,20351
2.87e+05,2014,286,5,1.5,2040,11772,1,0,0,4,7,1030,1010,1963,1963,98056,47.502,122.17,1560,9435,51,0,6.5,3600,11475
8.6e+05,2015,447,3,2,1880,8494,1,0,0,4,7,1200,680,1968,1968,98004,47.622,122.19,1290,9128,47,0,5,3170,11008
4.9995e+05,2014,132,3,1,980,6380,1,0,0,3,7,760,220,1941,1941,98115,47.692,122.31,1390,6380,73,0,4,2370,7360
6.905e+05,2014,335,4,2.75,3130,8920,2,0,0,3,8,3130,0,2014,2014,98155,47.74,122.32,1450,9183,0,0,6.75,4580,12313
9.52e+05,2014,304,3,2.5,2450,4400,2,0,0,4,9,1800,650,1922,1922,98102,47.644,122.32,2220,5500,92,0,5.5,4670,7950
1.22e+06,2015,467,3,3.25,3030,5600,2,0,2,3,9,2220,810,1905,2005,98144,47.598,122.29,2040,6600,110,1,6.25,5070,9630
5.1e+05,2014,203,6,4.5,3300,7200,2,0,0,3,8,3300,0,1980,1980,98052,47.68,122.1,2470,7561,34,0,10.5,5770,10861
3.45e+05,2015,431,4,2.75,2200,13498,2,0,0,3,8,2200,0,1987,1987,98023,47.315,122.35,2190,11850,28,0,6.75,4390,14050
4.25e+05,2015,430,3,2.5,1480,1386,3,0,0,3,8,1480,0,2005,2005,98029,47.547,122,1470,1593,10,0,5.5,2950,3073
3.99e+05,2014,176,4,3,3060,5000,2,0,0,3,8,3060,0,2001,2001,98042,47.379,122.13,3060,5668,13,0,7,6120,8728
6.14e+05,2014,359,5,2.5,3150,5150,2,0,0,5,8,1870,1280,1907,2004,98118,47.551,122.27,1550,5150,107,1,7.5,4700,8300
4.9e+05,2015,466,4,3.5,3200,6420,2,0,0,3,9,3200,0,2006,2006,98038,47.355,122,3200,6291,9,0,7.5,6400,9491
5.35e+05,2014,260,4,2,1970,3515,1,0,0,5,8,1030,940,1969,1969,98115,47.687,122.31,1650,4275,45,0,6,3620,6245
4.42e+05,2014,198,4,1.5,1960,12688,1,0,0,4,7,1960,0,1962,1962,98052,47.63,122.1,2050,9375,52,0,5.5,4010,11335
1.8e+05,2014,142,4,1.5,1740,7292,1,0,0,3,7,1020,720,1962,1962,98168,47.479,122.3,1740,7573,52,0,5.5,3480,9313
7.4e+05,2015,465,3,1,1230,6380,1,0,0,3,7,1230,0,1927,1927,98115,47.695,122.31,1250,6380,88,0,4,2480,7610
3.968e+05,2014,194,4,2.5,2200,6018,2,0,0,3,8,2200,0,2010,2010,98019,47.734,121.97,2480,5899,4,0,6.5,4680,8099
2.5492e+05,2014,273,2,1,780,8160,1,0,0,4,6,780,0,1953,1953,98133,47.736,122.34,1310,8160,61,0,3,2090,8940
5.45e+05,2014,190,3,2.5,2060,7184,2,0,0,3,8,2060,0,1987,1987,98029,47.567,122.01,2230,7788,27,0,5.5,4290,9848
3.36e+05,2015,453,1,1,1160,5000,2,0,0,3,7,1160,0,2000,2000,98144,47.588,122.31,2060,5000,15,0,2,3220,6160
6.35e+05,2014,257,4,2.5,3050,7238,2,0,0,3,8,3050,0,1989,1989,98029,47.577,122.01,2580,7228,25,0,6.5,5630,10278
3.3495e+05,2014,353,4,2.5,2190,7000,2,0,0,3,8,2190,0,1997,1997,98042,47.372,122.11,2040,7700,17,0,6.5,4230,9890
5.97e+05,2014,210,4,2.5,2340,7877,2,0,0,3,9,2340,0,2004,2004,98125,47.73,122.31,1920,9116,10,0,6.5,4260,11456
1.525e+06,2014,169,4,3.25,3620,5131,2,0,3,4,11,2350,1270,1927,1927,98119,47.65,122.37,2550,5174,87,0,7.25,6170,8794
3e+05,2014,276,5,2.75,2000,9276,2,0,0,4,7,2000,0,1968,1968,98055,47.444,122.19,1240,8270,46,0,7.75,3240,10270
7.75e+05,2014,201,3,1,1175,10454,1,0,0,4,6,1175,0,1949,1949,98004,47.639,122.22,2010,10800,65,0,4,3185,11975
5.65e+05,2014,279,4,2.5,2280,9725,2,0,0,3,8,2280,0,1986,1986,98072,47.757,122.14,2140,8780,28,0,6.5,4420,11060
9.1e+05,2014,163,5,2.5,2350,4000,2,0,0,3,9,2350,0,1993,1993,98112,47.627,122.3,1840,4000,21,0,7.5,4190,6350
3.435e+05,2014,174,4,1.75,1760,6204,1,0,2,4,7,1180,580,1950,1950,98178,47.505,122.24,1990,6240,64,0,5.75,3750,8000
2.18e+05,2014,174,3,1.5,1330,7600,1,0,0,4,7,1330,0,1968,1968,98023,47.31,122.37,1500,7776,46,0,4.5,2830,9106
3.3e+05,2014,339,4,2.25,2440,8098,2,0,0,3,8,2440,0,1983,1983,98023,47.313,122.35,2110,7911,31,0,6.25,4550,10351
5.36e+05,2014,167,4,2.25,1990,5948,2,0,0,3,8,1990,0,1991,1991,98029,47.571,122,2150,6459,23,0,6.25,4140,8449
5.5e+05,2015,417,3,2.5,1930,6604,2,0,0,3,7,1930,0,2014,2014,98166,47.469,122.35,910,6604,1,0,5.5,2840,8534
7.68e+05,2014,230,3,2.5,3220,54160,2,0,2,4,9,2690,530,1981,1981,98006,47.547,122.11,3460,44374,33,0,5.5,6680,47594
3.8396e+05,2014,180,4,2.5,2700,6998,2,0,0,3,8,2700,0,2001,2001,98188,47.469,122.26,2350,10550,13,0,6.5,5050,13250
1.3e+05,2015,399,3,1,1110,7520,1,0,0,4,7,1110,0,1960,1960,98033,47.683,122.18,1440,8400,55,0,4,2550,9510
7.15e+05,2015,390,4,2.25,1900,8272,1,0,0,4,9,1460,440,1966,1966,98040,47.58,122.23,2040,8479,49,0,6.25,3940,10379
4.321e+05,2015,461,3,2.25,1790,2240,2,0,0,4,8,1790,0,1975,1975,98052,47.634,122.11,1780,2560,40,0,5.25,3570,4350
2.69e+05,2014,160,3,2.5,1560,4200,2,0,0,3,7,1560,0,2003,2003,98038,47.384,122.03,1560,4200,11,0,5.5,3120,5760
2.4e+05,2014,361,3,1.75,1590,7931,1,0,0,3,7,1190,400,1979,1979,98038,47.363,122.05,1680,7931,35,0,4.75,3270,9521
3.7995e+05,2014,324,4,2.5,2580,4818,2,0,0,3,8,2580,0,2005,2005,98038,47.361,122.04,2570,5386,9,0,6.5,5150,7966
2.17e+05,2014,298,2,1,970,5600,1,0,0,3,6,970,0,1951,1951,98118,47.53,122.28,1020,5600,63,0,3,1990,6570
6.54e+05,2014,204,4,2.5,2240,7540,1,0,0,3,8,1540,700,1962,1962,98115,47.697,122.31,1960,7250,52,0,6.5,4200,9490
2.17e+05,2014,258,3,1,1110,9827,1,0,0,3,7,1110,0,1966,1966,98198,47.369,122.31,1540,10187,48,0,4,2650,11297
2.65e+05,2015,413,5,1.75,1580,5292,1,0,0,3,6,980,600,1913,1913,98118,47.568,122.29,1600,2976,102,0,6.75,3180,4556
3e+05,2014,196,3,2.5,2090,4590,2,0,0,3,7,2090,0,2005,2005,98042,47.399,122.16,2190,4060,9,0,5.5,4280,6150
2.07e+05,2014,262,3,1.5,1460,11100,1,0,0,3,7,1460,0,1956,1956,98003,47.325,122.3,1460,11100,58,0,4.5,2920,12560
9.935e+05,2014,231,4,2.25,4070,23321,2,0,0,4,10,4070,0,1968,1968,98040,47.556,122.22,2820,10871,46,0,6.25,6890,14941
2.6e+05,2014,128,4,1.5,2130,8800,1,0,0,3,7,1100,1030,1962,1962,98032,47.383,122.29,1480,8120,52,0,5.5,3610,10250
8.89e+05,2015,458,4,3.5,3920,9555,2,0,0,3,9,3920,0,2004,2004,98053,47.68,122.03,3920,8598,11,0,7.5,7840,12518
4e+05,2015,413,2,1,700,8120,1,0,0,3,7,700,0,1927,1927,98115,47.696,122.32,1130,5599,88,0,3,1830,6299
1.95e+06,2014,205,4,3.5,4065,18713,2,0,0,4,10,4065,0,1987,1987,98039,47.621,122.24,3070,18713,27,0,7.5,7135,22778
6.87e+05,2014,172,4,2.5,2370,10083,2,0,0,5,8,2370,0,1966,1966,98033,47.672,122.17,2370,10133,48,0,6.5,4740,12503
5.35e+05,2015,491,4,1,1610,2982,1,0,0,4,7,1610,0,1925,1925,98144,47.587,122.29,1610,4040,90,0,5,3220,5650
3.2e+05,2014,173,3,2.5,2280,7417,2,0,0,3,8,2280,0,1998,1998,98001,47.356,122.28,2370,6443,16,0,5.5,4650,8723
3.2e+05,2014,273,4,1.75,1760,11180,1,0,0,4,8,1760,0,1968,1968,98059,47.471,122.12,1730,11180,46,0,5.75,3490,12940
1.8e+05,2014,136,3,1,1000,18513,1,0,0,3,6,1000,0,1940,1940,98146,47.512,122.35,1280,8113,74,0,4,2280,9113
4.5e+05,2015,479,4,1.75,2190,11625,1,0,0,4,8,2020,170,1956,1956,98146,47.498,122.36,1920,8855,59,0,5.75,4110,11045
5.45e+05,2014,150,4,2.5,2720,4738,2,0,0,3,8,2720,0,2012,2012,98065,47.515,121.87,2590,5740,2,0,6.5,5310,8460
3.27e+05,2014,338,3,2.5,1860,5321,2,0,0,3,7,1860,0,2000,2000,98038,47.385,122.03,1940,5205,14,0,5.5,3800,7065
2.34e+05,2014,237,4,2.5,1820,8217,1,0,0,3,7,1120,700,1987,1987,98001,47.263,122.24,1310,8217,27,0,6.5,3130,10037
5.3665e+05,2015,457,3,1.75,2090,8910,1,0,0,3,8,1230,860,1975,1975,98034,47.715,122.22,2310,10695,40,0,4.75,4400,12785
4.3e+05,2014,196,3,2.25,1550,1469,3,0,0,3,8,1550,0,2004,2004,98103,47.691,122.34,1520,1465,10,0,5.25,3070,3015
1.465e+06,2015,396,3,1.5,2480,9900,2,0,3,3,10,2130,350,1940,1940,98177,47.702,122.38,2860,9288,75,0,4.5,5340,11768
2.655e+05,2015,456,3,2.5,1450,8977,1,0,0,3,8,1450,0,1990,1990,98092,47.258,122.21,2410,8850,25,0,5.5,3860,10300
2.39e+05,2014,317,2,1.5,680,772,2,0,0,3,7,680,0,2005,2005,98103,47.695,122.34,690,1059,9,0,3.5,1370,1739
4.75e+05,2015,362,4,3.5,2440,3052,2,0,0,3,8,1940,500,2006,2006,98108,47.555,122.31,2390,4600,9,0,7.5,4830,7040
3.32e+05,2014,167,3,2.5,1530,9406,1,0,0,3,7,1270,260,1993,1993,98059,47.485,122.16,1700,7682,21,0,5.5,3230,9212
4.135e+05,2014,139,2,1,770,4000,1,0,0,5,5,770,0,1924,1924,98117,47.696,122.36,1420,5040,90,0,3,2190,5810
9.2399e+05,2014,248,4,2.5,3600,6055,2,0,0,3,9,3600,0,2014,2014,98052,47.705,122.13,3590,6050,0,0,6.5,7190,9650
7.6e+05,2014,230,4,2.5,4660,7157,2,0,0,3,9,3020,1640,2003,2003,98059,47.535,122.16,3300,7047,11,0,6.5,7960,11707
1.476e+06,2014,201,3,2.25,4470,22518,2,0,2,3,9,3240,1230,1953,2004,98006,47.574,122.18,2930,21837,61,1,5.25,7400,26307
1.05e+06,2015,426,4,2.5,4080,11054,2,0,0,3,11,4080,0,2001,2001,98059,47.519,122.15,3520,11914,14,0,6.5,7600,15994
2.195e+05,2014,270,1,1,820,1060,1,0,0,3,8,760,60,2007,2007,98126,47.547,122.37,1770,1924,7,0,2,2590,2744
2.95e+05,2015,410,4,1,1260,7800,1,0,0,3,7,1260,0,1947,2007,98125,47.733,122.31,1639,7492,68,1,5,2899,8752
5.025e+05,2015,472,2,1,1100,4750,1,0,0,3,7,1100,0,1946,1946,98116,47.577,122.38,1830,4750,69,0,3,2930,5850
4.1e+05,2014,332,3,3.25,2650,7819,1,0,2,4,8,1760,890,1956,1956,98056,47.482,122.19,2400,7727,58,0,6.25,5050,10377
5.125e+05,2014,252,4,2.25,2200,6900,2,0,0,4,8,2200,0,1975,1975,98028,47.768,122.26,2400,6900,39,0,6.25,4600,9100
6.885e+05,2014,317,3,1.75,1760,4125,1,0,3,4,7,1760,0,1927,1927,98103,47.675,122.35,1760,4000,87,0,4.75,3520,5760
4.64e+05,2014,335,2,2.75,730,5000,1,0,0,3,7,730,0,1929,1929,98126,47.538,122.37,980,5000,85,0,4.75,1710,5730
3.9e+05,2014,313,3,1,950,3621,1,0,0,4,6,950,0,1947,1947,98144,47.575,122.29,1540,4080,67,0,4,2490,5030
1.035e+06,2014,359,4,2.5,3170,47502,2,0,0,3,10,3170,0,1988,1988,98033,47.65,122.19,3190,35110,26,0,6.5,6360,38280
4.87e+05,2015,479,2,1,1440,4046,1,0,0,3,7,960,480,1946,1946,98117,47.69,122.38,1400,4046,69,0,3,2840,5486
2.2e+05,2015,458,4,2,1400,7140,1,0,0,3,7,1400,0,1969,1969,98155,47.772,122.31,1610,10500,46,0,6,3010,11900
6.41e+05,2014,143,3,1.75,1620,3975,1,0,0,5,7,940,680,1926,1926,98117,47.679,122.37,1320,3922,88,0,4.75,2940,5542
8.56e+05,2015,396,3,2.5,2160,3920,2,0,0,3,9,2160,0,2014,2014,98116,47.576,122.42,1500,4920,1,0,5.5,3660,7080
5.6e+05,2014,127,3,3,4120,60392,2,0,2,3,9,3180,940,1994,1994,98014,47.68,121.91,2770,64033,20,0,6,6890,68153
7.98e+05,2014,155,3,3.5,3590,6402,2,0,0,3,10,3590,0,1999,1999,98074,47.634,122.06,3230,7305,15,0,6.5,6820,10895
5.1e+05,2014,228,4,1,1060,7200,1,0,1,3,6,880,180,1925,1925,98118,47.559,122.27,1910,7200,89,0,5,2970,8260
2.75e+05,2014,135,4,2.5,1840,1562,2,0,0,3,7,1400,440,2004,2004,98106,47.535,122.36,1840,1766,10,0,6.5,3680,3606
3.315e+05,2015,368,4,1.75,1700,14756,1,0,0,3,7,850,850,1955,1955,98006,47.576,122.14,1680,10250,60,0,5.75,3380,11950
8.65e+05,2014,299,4,2.5,2710,4069,3,0,0,4,10,2710,0,1990,1990,98122,47.604,122.29,1810,3586,24,0,6.5,4520,6296
2.9e+05,2014,222,4,1.75,2340,7200,1,0,0,3,8,1590,750,1960,1960,98146,47.497,122.37,1970,7800,54,0,5.75,4310,10140
5e+05,2014,180,4,3,3720,15048,3,0,0,3,7,3720,0,1979,2014,98059,47.512,122.14,2020,15180,35,1,7,5740,18900
9.525e+05,2014,181,4,1.5,2550,5055,2,0,0,4,10,2550,0,1910,1910,98112,47.636,122.3,1970,4431,104,0,5.5,4520,6981
6.7995e+05,2014,223,5,2.75,3600,9437,2,0,0,3,9,3600,0,2014,2014,98059,47.482,122.13,3550,9421,0,0,7.75,7150,13021
3.3e+05,2014,164,3,1.75,1430,8865,1,0,0,3,7,1430,0,1950,1950,98125,47.733,122.3,1250,8154,64,0,4.75,2680,9584
5.5e+05,2015,465,3,1.75,1670,10798,1,0,0,4,8,1670,0,1962,1962,98006,47.549,122.17,2290,10798,53,0,4.75,3960,12468
6.5e+05,2014,277,6,4.5,3900,9100,2,0,0,3,8,2870,1030,1979,1979,98052,47.661,122.14,2080,9216,35,0,10.5,5980,13116
1.77e+05,2014,169,3,1.75,1150,8079,1,0,0,4,7,1150,0,1983,1983,98030,47.377,122.18,1540,7399,31,0,4.75,2690,8549
4.25e+05,2015,415,4,2.5,2689,6688,2,0,0,3,9,2689,0,2006,2006,98030,47.38,122.18,2665,5700,9,0,6.5,5354,8389
3.8e+05,2014,140,3,1.75,1690,1468,2,0,0,3,8,1380,310,2008,2008,98108,47.563,122.3,1690,1936,6,0,4.75,3380,3626
1.26e+06,2014,310,3,3,3230,8625,2,0,3,3,10,2220,1010,1998,1998,98116,47.562,122.4,2330,6022,16,0,6,5560,9252
2.5e+05,2014,191,3,1,920,4429,1,0,0,3,7,920,0,1952,1952,98118,47.537,122.29,1320,7860,62,0,4,2240,8780
6.65e+05,2015,368,4,2.75,3320,10574,2,0,0,5,8,2220,1100,1960,1960,98056,47.538,122.18,2720,8330,55,0,6.75,6040,11650
6.85e+05,2014,166,4,3.5,2840,4637,3,0,0,3,8,2840,0,2008,2008,98125,47.703,122.32,1730,5279,6,0,7.5,4570,8119
4.9995e+05,2014,252,3,1.75,1340,6250,1,0,0,4,7,1090,250,1941,1941,98136,47.543,122.39,1550,1755,73,0,4.75,2890,3095
1.88e+06,2014,134,4,2.75,3260,19542,1,0,0,4,10,2170,1090,1968,1968,98039,47.624,122.24,3480,19863,46,0,6.75,6740,23123
4.19e+05,2014,232,2,2.5,1470,2034,2,0,0,4,8,1470,0,1985,1985,98007,47.621,122.15,1510,2055,29,0,4.5,2980,3525
1.22e+05,2015,472,2,1,760,5280,1,0,0,3,6,760,0,1946,1946,98168,47.483,122.33,1710,6594,69,0,3,2470,7354
2.25e+05,2014,148,3,2,2030,24829,1,0,0,4,7,1220,810,1979,1979,98001,47.272,122.29,1980,15204,35,0,5,4010,17234
1.6e+05,2015,401,4,2.25,1800,14722,1,0,0,3,7,1440,360,1962,1962,98055,47.487,122.22,2400,10000,53,0,6.25,4200,11800
6.48e+05,2014,249,4,2.5,2740,9959,2,0,0,3,9,2740,0,1989,1989,98029,47.567,122.01,2630,9905,25,0,6.5,5370,12645
4.2e+05,2014,278,3,2.5,1770,3993,2,0,0,3,8,1770,0,1999,1999,98074,47.603,122.02,1820,4046,15,0,5.5,3590,5816
4e+05,2014,224,6,2,2350,6554,2,0,1,3,8,2000,350,1905,1905,98178,47.511,122.26,1560,6554,109,0,8,3910,8904
4.5e+05,2014,223,3,2.5,1670,2589,2,0,0,3,8,1670,0,2000,2000,98027,47.531,122.05,1670,2897,14,0,5.5,3340,4567
2.4e+05,2015,472,3,1.5,1070,8886,1,0,0,4,7,1070,0,1984,1984,98030,47.352,122.17,1730,9461,31,0,4.5,2800,10531
4.2e+05,2014,221,3,2.75,2300,8000,1,0,0,3,7,1430,870,1965,1965,98003,47.329,122.31,2070,10200,49,0,5.75,4370,12500
6e+05,2015,368,5,2.75,3380,8179,2,0,0,3,9,3380,0,2011,2011,98059,47.483,122.14,2840,8179,4,0,7.75,6220,11559
9.75e+05,2014,175,5,3,2620,5477,2,0,0,3,10,2620,0,2009,2009,98115,47.68,122.29,1680,5217,5,0,8,4300,7837
4.415e+05,2014,284,2,1.75,1010,4000,1,0,0,5,7,1010,0,1919,1919,98105,47.666,122.29,1470,4000,95,0,3.75,2480,5010
2.6995e+05,2015,409,2,1.75,1340,7250,1,0,0,5,5,700,640,1949,1949,98198,47.408,122.33,1830,9750,66,0,3.75,3170,11090
4.4706e+05,2014,194,4,2.5,2448,4949,2,0,0,3,9,2448,0,2014,2014,98030,47.343,122.18,2815,5446,0,0,6.5,5263,7894
5e+05,2014,333,3,1.75,1800,7199,1,0,0,3,7,1300,500,1972,1972,98125,47.726,122.31,1800,8100,42,0,4.75,3600,9900
2.625e+05,2014,284,3,2,1130,7200,1,0,0,4,6,1130,0,1944,1944,98166,47.478,122.34,1270,7500,70,0,5,2400,8630
5.5e+05,2014,345,3,1.75,1520,5618,1,0,0,3,7,1170,350,1953,1953,98115,47.68,122.28,1550,5618,61,0,4.75,3070,7138
2.3e+05,2014,317,3,1.5,1500,11616,1,0,0,3,7,1100,400,1980,1980,98031,47.406,122.17,1830,8288,34,0,4.5,3330,9788
5.65e+05,2015,400,3,2.5,2700,6037,2,0,0,3,8,2700,0,2004,2004,98065,47.538,121.88,2740,6054,11,0,5.5,5440,8754
8.8e+05,2014,317,4,2.75,2560,7961,1,0,2,4,8,1450,1110,1975,1975,98033,47.65,122.2,2500,9009,39,0,6.75,5060,11569
3.475e+05,2014,128,4,2.5,2460,7350,2,0,0,3,9,2460,0,1989,1989,98023,47.306,122.35,2390,8568,25,0,6.5,4850,11028
5.162e+05,2014,160,3,2,2110,5150,1,0,0,5,6,1080,1030,1919,1919,98118,47.552,122.27,1170,5107,95,0,5,3280,7217
1.025e+06,2014,154,3,1.75,2640,8000,1,0,3,4,9,1320,1320,1960,1960,98040,47.583,122.25,2740,6000,54,0,4.75,5380,8640
5.6e+05,2014,279,3,1.5,2790,6900,1,0,2,3,8,1700,1090,1955,1955,98125,47.733,122.29,2410,8100,59,0,4.5,5200,10890
5.36e+05,2014,159,3,2.5,1900,6224,2,0,0,3,7,1900,0,2005,2005,98075,47.594,122,2260,5450,9,0,5.5,4160,7350
5.6995e+05,2014,249,5,4.25,3380,7805,2,0,0,3,8,3380,0,2014,2014,98148,47.435,122.33,2790,7805,0,0,9.25,6170,11185
2.52e+05,2015,386,3,1,1530,9465,1,0,0,4,7,1530,0,1960,1960,98059,47.492,122.15,1530,9465,55,0,4,3060,10995
6.7e+05,2014,194,2,1.75,1650,7500,1,0,0,4,7,1000,650,1959,1959,98033,47.687,122.21,2530,9000,55,0,3.75,4180,10650
6.15e+05,2014,128,2,1,1540,6872,1,0,0,4,7,820,720,1946,1946,98119,47.645,122.37,1420,5538,68,0,3,2960,7078
5.11e+05,2014,134,3,2.5,1820,4883,2,0,0,3,9,1820,0,2005,2005,98028,47.736,122.22,2720,5002,9,0,5.5,4540,6822
2.35e+05,2014,218,4,1,1500,6360,1,0,0,3,6,1500,0,1944,1944,98178,47.498,122.24,1190,6360,70,0,5,2690,7860
3.16e+05,2014,235,3,1,1130,7200,1,0,0,4,6,1130,0,1942,1942,98133,47.73,122.36,1350,1358,72,0,4,2480,2488
1.9e+06,2015,408,4,2.5,3070,7830,2,0,2,3,11,1970,1100,2009,2009,98144,47.593,122.29,2440,4682,6,0,6.5,5510,7752
4.35e+05,2015,407,4,2,1960,50112,1,0,0,4,7,1050,910,1963,1963,98058,47.435,122.08,2340,44967,52,0,6,4300,46927
4.3e+05,2014,205,4,1,1350,9000,1,0,0,4,7,1350,0,1964,1964,98103,47.695,122.33,1940,8000,50,0,5,3290,9350
9.146e+05,2015,388,4,3,3180,80837,2,0,0,3,11,3180,0,1985,1985,98072,47.734,122.13,3180,38715,30,0,7,6360,41895
2.65e+06,2015,438,4,3.5,4700,13730,2,0,3,3,11,3500,1200,1958,1995,98033,47.69,122.22,3210,15306,57,1,7.5,7910,20006
5.56e+05,2015,431,4,2.5,2240,5402,2,0,0,3,8,2240,0,2005,2005,98133,47.772,122.35,2240,7560,10,0,6.5,4480,9800
2.6595e+05,2014,197,3,2.5,1490,3840,2,0,0,3,7,1490,0,2002,2002,98042,47.374,122.13,2060,4384,12,0,5.5,3550,5874
5.45e+05,2014,249,4,2.5,2710,6937,2,0,0,3,7,2710,0,2009,2009,98065,47.515,121.87,2380,5866,5,0,6.5,5090,8576
4.15e+05,2014,150,2,1.75,1340,4664,1,0,0,3,8,1340,0,2004,2004,98053,47.718,122.03,1350,4236,10,0,3.75,2690,5576
2.575e+06,2014,335,4,4.25,5540,15408,2,0,1,3,11,4280,1260,2006,2006,98004,47.607,122.21,3570,14750,8,0,8.25,9110,20290
1.89e+05,2015,401,3,1,1380,7282,1,0,0,5,6,1380,0,1915,1915,98002,47.301,122.22,860,4826,100,0,4,2240,6206
1e+06,2014,152,3,2.5,2730,5832,2,0,0,3,9,2730,0,1998,1998,98005,47.622,122.16,2360,5832,16,0,5.5,5090,8562
3.385e+05,2015,448,2,2.25,1150,711,2,0,0,3,7,1150,0,2013,2013,98027,47.532,122.07,1150,748,2,0,4.25,2300,1898
3.84e+05,2014,210,3,2.25,1430,800,2,0,0,3,8,1140,290,2011,2011,98136,47.548,122.39,1430,1387,3,0,5.25,2860,2817
5.56e+05,2014,141,3,2.25,2020,3600,2,0,0,3,8,2020,0,1998,1998,98033,47.668,122.17,2070,3699,16,0,5.25,4090,5719
3.95e+05,2014,287,4,2,1780,8149,1,0,0,4,7,1780,0,1948,1948,98155,47.745,122.3,1180,8149,66,0,6,2960,9929
1.1155e+06,2015,485,4,3.5,2830,4000,1,0,0,3,7,1840,990,1919,2014,98144,47.584,122.29,2340,4000,96,1,7.5,5170,6830
2.649e+05,2015,474,4,2.5,2040,7000,1,0,0,3,7,1250,790,1979,1979,98031,47.406,122.18,1900,7378,36,0,6.5,3940,9418
5.4495e+05,2015,437,3,1.75,1830,7371,1,0,0,3,7,1830,0,1957,1957,98008,47.606,122.12,1600,7700,58,0,4.75,3430,9530
2.57e+05,2014,304,3,1.75,1397,18000,1,0,0,3,7,1397,0,1965,2014,98092,47.339,122.17,1950,31294,49,1,4.75,3347,32691
4.7e+05,2015,464,3,1,1460,8227,1,0,0,3,6,880,580,1948,1948,98125,47.701,122.3,1530,8128,67,0,4,2990,9588
3.81e+05,2014,161,3,1.5,1460,11407,1,0,0,3,7,1460,0,1954,1954,98155,47.746,122.29,1470,11407,60,0,4.5,2930,12867
3.8e+05,2014,241,5,1.75,1320,38125,1,0,0,4,7,1120,200,1947,1947,98198,47.394,122.32,2360,15070,67,0,6.75,3680,16390
8.65e+05,2014,209,4,1.75,1800,4180,2,0,3,4,8,1800,0,1921,1921,98102,47.646,122.32,2180,4620,93,0,5.75,3980,6420
4.37e+05,2014,134,3,2.75,2580,5200,2,0,0,3,8,2580,0,2008,2008,98059,47.496,122.15,2700,5602,6,0,5.75,5280,8182
4.3e+05,2014,188,3,2,1550,6039,1,0,0,5,7,830,720,1942,1942,98126,47.544,122.38,1330,6042,72,0,5,2880,7592
3.78e+05,2015,395,4,2.5,2790,4650,2,0,0,3,8,2790,0,2004,2004,98038,47.356,122.03,2820,4650,11,0,6.5,5610,7440
3.67e+05,2014,139,2,1,700,2334,1,0,0,3,7,700,0,1945,1945,98117,47.701,122.39,2300,5000,69,0,3,3000,5700
6.525e+05,2014,177,4,2.5,2540,38677,2,0,0,3,9,2540,0,1987,1987,98053,47.669,122.04,2560,36280,27,0,6.5,5100,38820
7e+05,2014,245,3,2.5,2410,9916,2,0,0,4,10,2410,0,1989,1989,98052,47.691,122.1,2310,8212,25,0,5.5,4720,10622
2.884e+05,2014,140,4,2.5,1860,6687,1,0,0,4,7,1220,640,1983,1983,98031,47.405,122.19,1860,6117,31,0,6.5,3720,7977
5.3995e+05,2015,400,3,2.25,1860,1558,3,0,0,3,8,1860,0,2014,2014,98103,47.701,122.34,1760,2456,1,0,5.25,3620,4316
8.4e+05,2015,477,4,3.25,3500,5960,2,0,0,3,9,3500,0,2010,2010,98053,47.694,122.02,3390,6856,5,0,7.25,6890,10356
4.79e+05,2015,466,2,2.5,1730,1037,3,0,0,3,8,1730,0,2008,2008,98118,47.559,122.28,1280,1026,7,0,4.5,3010,2756
8.45e+05,2014,292,4,2.75,3160,7143,1,0,0,3,8,2100,1060,1933,1933,98199,47.651,122.41,2200,6122,81,0,6.75,5360,9282
4.485e+05,2015,440,3,2.25,1830,7943,2,0,0,3,8,1830,0,1985,1985,98028,47.747,122.25,2100,8070,30,0,5.25,3930,9900
6.96e+05,2015,473,3,2.5,1670,8023,1,0,0,5,7,1170,500,1960,1960,98008,47.615,122.12,1960,8964,55,0,5.5,3630,10634
5.28e+05,2014,177,2,0.75,840,40642,1,1,4,4,6,840,0,1937,1937,98070,47.404,122.45,1850,64069,77,0,2.75,2690,64909
5.4e+05,2014,318,3,1.75,1680,4240,1,0,0,4,7,1680,0,1926,1926,98144,47.575,122.31,1460,4240,88,0,4.75,3140,5920
4.45e+05,2015,417,3,2.5,2380,5269,2,0,0,3,8,2380,0,2008,2008,98056,47.507,122.19,2150,7600,7,0,5.5,4530,9980
3.4e+05,2014,250,5,2.75,2440,6858,2,0,0,3,8,2440,0,2003,2003,98030,47.365,122.17,2300,6858,11,0,7.75,4740,9298
3.3e+05,2014,182,4,2.5,2105,6093,2,0,0,3,8,2105,0,2003,2003,98042,47.353,122.15,1930,8022,11,0,6.5,4035,10127
9.68e+05,2014,221,4,1.75,2630,9645,1,0,0,4,9,2630,0,1963,1963,98040,47.546,122.23,2690,10439,51,0,5.75,5320,13069
4.16e+05,2014,242,4,2.5,2890,6322,2,0,0,3,8,2890,0,2011,2011,98038,47.349,122.04,2380,5738,3,0,6.5,5270,8628
7e+05,2014,290,2,1,1300,12000,1,0,0,4,8,1300,0,1959,1959,98004,47.637,122.23,2420,15000,55,0,3,3720,16300
7.87e+05,2014,125,3,1.75,1330,7500,1,0,0,3,8,1330,0,1961,1961,98004,47.607,122.19,1690,7800,53,0,4.75,3020,9130
5.5e+05,2015,492,2,1,1420,3100,1,0,0,3,7,820,600,1924,1924,98107,47.674,122.36,1420,3915,91,0,3,2840,5335
6.99e+05,2014,251,3,2,2010,4320,2,0,2,3,9,2010,0,1999,1999,98118,47.515,122.26,1640,5225,15,0,5,3650,7235
4.5e+05,2014,332,3,2.25,2530,27227,2,0,0,3,8,2530,0,1987,1987,98056,47.527,122.19,2160,30192,27,0,5.25,4690,32722
4.4e+05,2014,230,4,1.75,2800,49149,1,0,0,4,7,1400,1400,1978,1978,98027,47.465,122.03,2560,61419,36,0,5.75,5360,64219
1.365e+06,2014,150,3,2.5,2090,6000,1,0,0,4,9,2090,0,1928,1928,98105,47.657,122.28,2730,6000,86,0,5.5,4820,8090
3.5e+05,2014,202,3,2.5,2100,3574,2,0,0,3,7,1690,410,2005,2005,98019,47.745,121.98,1970,2962,9,0,5.5,4070,5062
3.35e+05,2014,223,2,1.75,1660,11437,2,0,0,3,7,1660,0,1958,1992,98146,47.49,122.34,1290,7860,56,1,3.75,2950,9520
5.371e+05,2015,444,3,2.5,2450,7051,1,0,0,3,8,1870,580,1990,1990,98056,47.531,122.17,2450,8788,25,0,5.5,4900,11238
7.8495e+05,2014,348,4,2.75,2840,4227,3,0,0,3,9,2840,0,2014,2014,98052,47.71,122.11,2880,4227,0,0,6.75,5720,7067
6.7e+05,2015,423,3,1.75,2160,5760,1,0,0,4,8,1260,900,1954,1954,98136,47.535,122.39,2090,5760,61,0,4.75,4250,7920
4.5895e+05,2014,292,2,1,1530,4370,1,0,0,3,7,1130,400,1946,1946,98115,47.689,122.31,1580,4275,68,0,3,3110,5805
3.131e+05,2015,458,3,2,1720,11875,1,0,0,5,6,1720,0,1905,1905,98056,47.507,122.19,1860,7500,110,0,5,3580,9220
3.699e+05,2014,297,1,0.75,760,10079,1,1,4,5,5,760,0,1936,1936,98070,47.468,122.44,1230,14267,78,0,1.75,1990,15027
3.5e+05,2014,141,3,1.5,980,7790,1,0,0,5,7,980,0,1969,1969,98034,47.714,122.21,1390,7280,45,0,4.5,2370,8260
9.07e+05,2014,239,3,1.75,2170,12220,1,0,0,5,8,2170,0,1965,1965,98033,47.654,122.19,1980,9000,49,0,4.75,4150,11170
4e+05,2014,298,2,1.75,960,6200,1,0,0,4,7,960,0,1946,1946,98136,47.555,122.4,1000,6000,68,0,3.75,1960,6960
3.6525e+05,2014,150,3,2.25,1490,4522,2,0,0,3,7,1490,0,2009,2009,98028,47.761,122.23,1580,4667,5,0,5.25,3070,6157
8.11e+05,2014,235,2,2.5,2510,17986,2,0,0,3,9,2510,0,1943,2014,98052,47.683,122.16,2440,8039,71,1,4.5,4950,10549
6.95e+05,2014,237,2,1.75,1570,1207,3,0,0,3,9,1570,0,2007,2007,98004,47.621,122.2,1570,1206,7,0,3.75,3140,2776
8.75e+05,2014,148,3,2.75,2280,4280,1,0,0,5,7,1280,1000,1917,1917,98103,47.669,122.33,1650,4280,97,0,5.75,3930,6560
5.38e+05,2014,339,3,2.25,2570,7242,2,0,0,3,7,2170,400,1951,1991,98125,47.721,122.32,1690,7639,63,1,5.25,4260,10209
8.6e+05,2014,162,4,3.25,3960,7012,2,0,0,3,10,3960,0,2005,2005,98075,47.585,122.08,3680,8522,9,0,7.25,7640,12482
9e+05,2014,225,4,2,1980,7200,2,0,3,3,8,1700,280,1910,1910,98119,47.632,122.37,2490,4200,104,0,6,4470,6180
4.25e+05,2014,256,4,1,1080,6095,1,0,0,4,6,1080,0,1924,1924,98103,47.696,122.35,1200,5060,90,0,5,2280,6140
5.75e+05,2014,174,4,2.5,4620,20793,2,0,0,4,11,4620,0,1991,1991,98023,47.293,122.34,3640,20793,23,0,6.5,8260,25413
4.6e+05,2014,235,3,1.75,1440,7070,1,0,0,3,7,1440,0,1980,1980,98052,47.695,122.13,1440,7210,34,0,4.75,2880,8650
2.83e+05,2014,266,4,1.5,1480,47045,1,0,0,5,6,1480,0,1942,1942,98168,47.481,122.3,1530,11000,72,0,5.5,3010,12480
7e+05,2014,141,4,3.25,2780,7875,2,0,0,3,9,2780,0,2006,2006,98133,47.729,122.35,1000,7500,8,0,7.25,3780,10280
3.6e+05,2014,235,4,1.75,3730,16980,1,0,0,4,7,2150,1580,1974,1974,98022,47.178,122.02,1880,16963,40,0,5.75,5610,20693
5.75e+05,2014,229,2,1.5,1750,19709,1,0,0,4,8,1440,310,1978,1978,98010,47.335,122.04,1950,21075,36,0,3.5,3700,22825
2.45e+05,2014,142,4,2,1580,8000,1,0,0,3,7,1040,540,1967,1967,98003,47.347,122.3,1550,8000,47,0,6,3130,9580
2.68e+05,2014,278,3,2.5,1850,6676,2,0,0,3,7,1850,0,1986,1986,98023,47.31,122.36,1700,6663,28,0,5.5,3550,8513
2.9138e+05,2014,230,4,2.5,2220,6233,2,0,0,3,7,2220,0,2001,2001,98059,47.489,122.15,2220,5352,13,0,6.5,4440,7572
3.4e+05,2014,305,2,1.75,1010,1461,1,0,0,3,7,670,340,2003,2003,98199,47.651,122.4,1500,2499,11,0,3.75,2510,3509
5.61e+05,2014,126,3,2,2000,7000,2,0,0,3,7,2000,0,1916,1986,98136,47.545,122.39,1840,7000,98,1,5,3840,9000
2.499e+05,2014,141,2,1,1140,5500,1,0,0,3,6,1140,0,1947,1947,98106,47.519,122.36,1110,5500,67,0,3,2250,6640
5.05e+05,2015,445,3,1,1380,4000,1,0,0,3,7,1380,0,1910,1910,98112,47.626,122.3,1690,4000,105,0,4,3070,5380
3.19e+05,2014,265,4,1,1730,36356,1,0,0,4,6,1730,0,1954,1954,98031,47.413,122.2,1380,14060,60,0,5,3110,15790
2.9e+05,2014,283,4,2.5,1850,5674,2,0,0,3,7,1850,0,1993,1993,98042,47.354,122.14,1750,6875,21,0,6.5,3600,8725
3.5e+05,2014,177,5,1.75,2330,14322,1,0,0,4,7,1180,1150,1968,1968,98059,47.477,122.16,1690,10010,46,0,6.75,4020,12340
3.1995e+05,2015,458,4,2.5,2020,7200,1,0,0,4,6,2020,0,1954,1954,98065,47.522,121.82,1440,7200,61,0,6.5,3460,9220
7.75e+05,2014,317,4,2.5,3220,38448,2,0,0,3,10,3220,0,1993,1993,98053,47.685,122.05,3090,38448,21,0,6.5,6310,41668
7.625e+05,2015,362,5,3.5,3290,5880,2,0,0,3,9,2670,620,2005,2005,98052,47.707,122.12,3090,5680,10,0,8.5,6380,8970
5.85e+05,2015,436,3,1,1350,4800,1,0,0,3,7,1350,0,1928,1928,98116,47.575,122.41,1360,4800,87,0,4,2710,6150
3.75e+05,2014,224,3,2,3120,42247,1,0,0,4,7,2150,970,1980,1980,98042,47.392,122.14,2100,43416,34,0,5,5220,46536
2.6e+05,2014,331,3,2.5,1850,7875,1,0,0,3,7,1250,600,1968,1968,98058,47.434,122.17,1930,8062,46,0,5.5,3780,9912
2.685e+05,2014,237,3,2.25,1140,977,2,0,0,3,7,850,290,2008,2008,98126,47.544,122.38,1140,976,6,0,5.25,2280,2116
5.921e+05,2014,216,4,2.75,2310,7851,1,0,0,4,8,1790,520,1989,1989,98006,47.547,122.19,2230,7359,25,0,6.75,4540,9669
2.8e+05,2014,161,3,2.5,1860,6607,2,0,0,3,7,1860,0,1989,1989,98023,47.289,122.35,1760,6766,25,0,5.5,3620,8626
4.61e+05,2015,460,4,2.75,1700,7495,1,0,0,4,7,1200,500,1964,1964,98133,47.759,122.35,1650,7495,51,0,6.75,3350,9195
4.855e+05,2014,217,2,1.5,1340,1286,2,0,0,3,8,1190,150,2006,2006,98122,47.617,122.31,1460,1245,8,0,3.5,2800,2585
2.38e+05,2015,362,2,1,750,6480,1,0,0,3,6,750,0,1943,1943,98106,47.52,122.35,1050,6390,72,0,3,1800,7140
2.65e+05,2014,132,2,1,1290,2828,2,0,0,3,7,1290,0,2008,2008,98053,47.697,122.03,1290,2628,6,0,3,2580,3918
5.315e+05,2014,175,4,2.75,3110,49765,1,0,0,4,8,3110,0,1958,1972,98010,47.334,122.04,1880,19709,56,1,6.75,4990,22819
1.18e+06,2014,277,5,5,3960,94089,2,0,0,3,10,3960,0,1998,1998,98038,47.38,122.01,2240,64468,16,0,10,6200,68428
8.02e+05,2014,134,3,2.5,2580,13096,2,0,0,3,9,2580,0,1986,1986,98052,47.662,122.14,2580,7988,28,0,5.5,5160,10568
4e+05,2015,440,3,1.75,1830,9620,1,0,0,4,8,1830,0,1978,1978,98023,47.312,122.39,1990,8280,37,0,4.75,3820,10110
3.85e+05,2014,293,3,0.75,1330,7020,1,0,0,5,7,1330,0,1924,1924,98126,47.538,122.38,1410,5802,90,0,3.75,2740,7132
5.2e+05,2015,484,4,2.75,2700,9882,2,0,0,3,7,2700,0,1958,1989,98155,47.767,122.29,2250,10797,57,1,6.75,4950,13497
4.05e+05,2014,127,3,2.25,1660,8307,1,0,0,4,8,1660,0,1961,1961,98133,47.758,122.35,2510,7800,53,0,5.25,4170,9460
2.85e+05,2015,386,4,2.5,1870,8190,1,0,0,3,7,1100,770,1977,1977,98058,47.452,122.16,1590,9150,38,0,6.5,3460,11020
5.38e+05,2014,134,3,1.75,1400,3825,1,0,0,4,6,1100,300,1904,1904,98117,47.679,122.39,1720,5100,110,0,4.75,3120,6500
6.775e+05,2014,232,3,1.75,2020,9718,1,0,0,3,8,2020,0,1956,1956,98040,47.574,122.21,2370,8604,58,0,4.75,4390,10624
6.99e+05,2014,259,3,2,1820,4080,2,0,2,3,8,1820,0,1937,1987,98107,47.673,122.4,2160,5400,77,1,5,3980,7220
3.9e+05,2015,447,2,1,1080,4725,1,0,0,3,7,1080,0,1944,1944,98126,47.528,122.38,1520,4961,71,0,3,2600,6041
3.865e+05,2015,443,4,1,1400,3600,1,0,0,4,6,700,700,1901,1901,98144,47.597,122.3,1690,3600,114,0,5,3090,5000
4.1e+05,2015,479,2,2.25,1660,2128,2,0,0,4,8,1660,0,1974,1974,98028,47.753,122.25,1640,2128,41,0,4.25,3300,3788
7e+05,2014,310,3,2,1940,4500,1,0,3,3,7,1090,850,1926,1926,98107,47.666,122.36,1700,4500,88,0,5,3640,6440
2.0425e+05,2015,380,3,2.25,1960,7708,1,0,0,4,7,1490,470,1984,1984,98023,47.298,122.37,1580,8063,31,0,5.25,3540,10023
3.096e+05,2014,287,4,1.75,1275,20000,1,0,0,4,6,1275,0,1991,1991,98070,47.38,122.49,1660,20000,23,0,5.75,2935,21275
2.8e+05,2014,305,3,1,1310,22652,1,0,0,3,7,1310,0,1968,1968,98092,47.257,122.07,1600,1.0367e+05,46,0,4,2910,1.0498e+05
3.6e+05,2014,325,6,1.75,2230,10080,1,0,0,3,7,1390,840,1969,1969,98034,47.709,122.2,2110,8475,45,0,7.75,4340,10705
6.75e+05,2014,339,4,2.75,2670,6780,2,0,3,5,8,1630,1040,1908,1908,98118,47.513,122.26,2400,5989,106,0,6.75,5070,8659
1.34e+06,2014,176,4,3.5,3190,5040,2,0,3,3,10,2160,1030,2003,2003,98144,47.593,122.29,2390,4800,11,0,7.5,5580,7990
4.6495e+05,2014,208,3,1.5,1200,890,2,0,0,3,8,1030,170,2008,2008,98109,47.638,122.34,1230,2120,6,0,4.5,2430,3320
4.15e+05,2014,313,3,2.5,1280,5040,2,0,0,4,7,1280,0,1985,1985,98118,47.561,122.28,1500,5040,29,0,5.5,2780,6320
4.15e+05,2015,451,3,1.75,1340,63597,1,0,0,4,7,1340,0,1963,1963,98038,47.438,122.01,1950,87120,52,0,4.75,3290,88460
5.63e+05,2015,436,3,1.5,1730,9509,2,0,0,3,8,1270,460,1955,1955,98125,47.707,122.28,1810,8795,60,0,4.5,3540,10525
1.295e+06,2015,432,4,3.5,3790,90169,2,0,0,3,11,3790,0,1998,1998,98053,47.659,122.02,3410,46951,17,0,7.5,7200,50741
4.4e+05,2014,333,3,2,1650,6408,2,0,0,4,8,1650,0,1977,1977,98052,47.664,122.13,1750,6402,37,0,5,3400,8052
5e+05,2015,365,3,1.75,1700,6120,1,0,0,3,7,1700,0,1952,1952,98116,47.581,122.4,1330,6120,63,0,4.75,3030,7820
1.2474e+05,2014,148,3,1,1340,15600,1,0,0,4,6,1340,0,1978,1978,98042,47.322,122.14,1320,9800,36,0,4,2660,11140
2.06e+05,2015,389,3,1,1060,10350,1,0,0,4,7,1060,0,1980,1980,98038,47.365,122.03,1500,9660,35,0,4,2560,10720
4.65e+05,2014,338,2,2.25,1390,1222,3,0,0,3,7,1340,50,2009,2009,98052,47.675,122.12,1480,1369,5,0,4.25,2870,2759
4e+05,2015,436,3,2,1010,12252,1,0,0,3,8,1010,0,1980,1980,98074,47.622,122.05,1840,11497,35,0,5,2850,12507
3.45e+05,2015,407,5,2.5,3150,9134,1,0,0,4,8,1640,1510,1966,1966,98056,47.493,122.19,1990,9133,49,0,7.5,5140,12283
4.66e+05,2015,388,3,2.25,1880,7279,1,0,0,3,7,1280,600,1962,1962,98155,47.757,122.32,2020,8274,53,0,5.25,3900,10154
4.675e+05,2014,269,3,1.75,2260,8512,1,0,0,3,7,1130,1130,1948,1948,98125,47.713,122.3,2240,8040,66,0,4.75,4500,10300
2.45e+05,2014,276,3,2.25,1900,7250,1,0,0,3,7,1250,650,1967,1967,98146,47.487,122.34,1560,9420,47,0,5.25,3460,11320
3.38e+05,2014,235,4,2.5,2370,10631,2,0,0,3,8,2370,0,1999,1999,98003,47.347,122.3,2200,8297,15,0,6.5,4570,10667
5.2e+05,2015,362,3,1,940,3000,1,0,0,3,7,940,0,1903,1903,98122,47.603,122.3,1210,3500,112,0,4,2150,4440
4.155e+05,2014,163,4,2.5,1750,4779,2,0,0,3,7,1750,0,2009,2009,98028,47.761,122.23,1580,4687,5,0,6.5,3330,6437
3.1e+05,2015,444,3,2.75,2090,9620,1,0,0,3,8,1340,750,1987,1987,98023,47.274,122.34,2150,9660,28,0,5.75,4240,11750
2.33e+05,2014,175,3,1,1250,6180,1,0,0,3,7,1250,0,1955,1955,98155,47.747,122.33,1490,6180,59,0,4,2740,7430
4.89e+05,2015,408,3,2.5,3080,5598,2,0,0,3,8,3080,0,2006,2006,98055,47.437,122.21,3080,5303,9,0,5.5,6160,8383
5.4995e+05,2015,459,4,2.5,3780,6800,2,0,0,3,8,3780,0,2004,2004,98038,47.353,122.01,3640,7326,11,0,6.5,7420,11106
3.39e+05,2014,174,4,2,2470,5080,1,0,0,3,6,1970,500,1948,1988,98106,47.531,122.35,1060,5080,66,1,6,3530,7550
1.185e+06,2015,487,4,2.75,2850,3000,2,0,0,3,9,2530,320,2003,2003,98112,47.641,122.3,2083,4500,12,0,6.75,4933,7350
5.3e+05,2014,228,3,2.25,2010,11817,2,0,0,4,8,2010,0,1986,1986,98029,47.566,122.02,2190,10168,28,0,5.25,4200,12178
2.6e+05,2014,350,4,2.75,2240,7200,1,0,0,3,7,1140,1100,1967,1967,98001,47.336,122.28,1580,7416,47,0,6.75,3820,9656
3.215e+05,2015,451,4,2.5,1930,6228,2,0,0,3,8,1930,0,2000,2000,98030,47.357,122.19,1930,6168,15,0,6.5,3860,8098
2.19e+05,2015,381,3,1.5,1740,5200,1,0,0,4,7,1060,680,1977,1977,98042,47.366,122.09,1540,5200,38,0,4.5,3280,6940
4.02e+05,2015,472,3,1.5,1320,3145,2,0,0,3,7,1320,0,1998,1998,98144,47.591,122.3,1320,3002,17,0,4.5,2640,4322
2.75e+05,2015,470,4,2,2220,8229,1,0,0,4,7,2220,0,1958,1958,98030,47.372,122.22,1660,8396,57,0,6,3880,10616
3.09e+05,2015,402,3,2.5,1450,11480,2,0,0,3,7,1450,0,1990,1990,98014,47.672,121.86,2080,87991,25,0,5.5,3530,89441
4.51e+05,2015,488,3,1.75,1790,9813,2,0,0,3,7,1790,0,1949,1949,98155,47.749,122.31,1520,10125,66,0,4.75,3310,11915
2.6e+05,2015,413,3,1,1150,3090,1,0,0,3,6,1150,0,1910,1910,98118,47.551,122.28,1150,5664,105,0,4,2300,6814
2.63e+05,2014,195,3,1.75,1790,7485,1,0,0,4,8,1330,460,1979,1979,98023,47.312,122.34,1970,8097,35,0,4.75,3760,9887
5.45e+05,2014,155,3,1.75,1700,51649,1,0,0,5,6,1700,0,1931,1931,98059,47.47,122.08,1100,39504,83,0,4.75,2800,41204
4.237e+05,2014,248,3,2.5,2070,3986,2,0,0,3,8,2070,0,1999,1999,98065,47.535,121.88,2090,3986,15,0,5.5,4160,6056
2.8e+05,2015,374,3,2.75,1740,5639,1,0,3,3,7,1740,0,2010,2010,98022,47.194,121.98,2380,5331,5,0,5.75,4120,7071
3.41e+05,2015,462,2,1,1040,4000,1,0,0,3,6,1040,0,1914,1914,98144,47.575,122.3,1740,4000,101,0,3,2780,5040
3.3254e+05,2014,290,2,1.75,1710,4187,1,0,0,3,7,1710,0,1987,1987,98055,47.473,122.19,1760,4084,27,0,3.75,3470,5794
4.47e+05,2014,293,2,1,850,2700,1,0,0,5,6,850,0,1924,1924,98105,47.668,122.32,1630,3000,90,0,3,2480,3850
3.29e+05,2014,349,3,2,1840,6755,1,0,2,3,8,1840,0,1989,1989,98003,47.351,122.31,1790,6459,25,0,5,3630,8299
1.16e+06,2014,208,3,2.75,2380,5572,2,0,4,3,9,1930,450,1939,1939,98105,47.663,122.27,3370,5500,75,0,5.75,5750,7880
2.35e+05,2014,177,3,1.75,1950,8712,1,0,0,3,7,1950,0,1960,1960,98055,47.439,122.19,1820,11520,54,0,4.75,3770,13470
4.73e+05,2014,250,2,1.75,1510,4555,1,0,0,3,8,1510,0,2005,2005,98053,47.714,122.03,1640,4500,9,0,3.75,3150,6010
3.785e+05,2014,304,4,1.75,1700,8640,1,0,0,3,7,850,850,1955,1955,98006,47.577,122.15,1620,9000,59,0,5.75,3320,10700
2.15e+05,2014,148,2,1,1320,8865,1,0,0,4,6,1320,0,1943,1943,98168,47.495,122.3,1190,6490,71,0,3,2510,7810
3.53e+05,2014,272,3,1.75,2190,7021,1,0,2,4,7,1390,800,1953,1953,98178,47.503,122.23,2180,7155,61,0,4.75,4370,9345
1.3878e+06,2014,176,3,3,2480,5500,2,0,3,3,10,1730,750,1950,2005,98199,47.647,122.4,2950,5670,64,1,6,5430,8150
6.18e+05,2015,372,2,1,1890,4700,1,0,0,4,7,1030,860,1928,1928,98107,47.675,122.39,2150,4700,87,0,3,4040,6590
4.76e+05,2014,321,4,1.75,1880,4175,1,0,0,3,7,1090,790,1944,1944,98107,47.665,122.36,1700,3758,70,0,5.75,3580,5638
3.35e+05,2014,201,3,1.5,1560,9600,1,0,0,4,7,1560,0,1961,1961,98033,47.692,122.16,1520,10000,53,0,4.5,3080,11560
3.25e+05,2015,382,3,1.75,2080,6554,1,0,0,3,7,1040,1040,1950,1950,98118,47.514,122.26,1230,5650,65,0,4.75,3310,7730
5.08e+05,2014,303,2,1,1200,2500,2,0,2,3,7,1090,110,1927,1927,98112,47.63,122.3,2690,4800,87,0,3,3890,6000
4.6e+05,2014,258,3,2.5,1690,5131,1,0,0,3,7,1690,0,1941,1998,98126,47.523,122.38,860,5137,73,1,5.5,2550,6827
7.88e+05,2014,132,4,3.25,3680,5759,2,0,0,3,9,2840,840,2003,2003,98027,47.537,122.07,3620,6006,11,0,7.25,7300,9686
6.59e+05,2014,319,4,2,1980,23625,2,0,0,3,8,1980,0,1938,1984,98072,47.755,122.09,2300,24640,76,1,6,4280,26620
4.25e+05,2014,319,4,1.75,1980,8400,1,0,0,3,7,1330,650,1968,1968,98052,47.672,122.15,1920,8400,46,0,5.75,3900,10380
2.15e+05,2014,258,3,1.5,1610,5304,1,0,0,4,6,1610,0,1968,1968,98042,47.363,122.09,1060,5304,46,0,4.5,2670,6914
4.465e+05,2015,424,3,2.5,2650,7286,2,0,0,3,8,2650,0,1990,1990,98059,47.508,122.15,2400,7220,25,0,5.5,5050,9870
3.131e+05,2015,471,3,2,1730,12821,1,0,0,3,8,1730,0,1994,1994,98001,47.353,122.27,1980,11336,21,0,5,3710,13066
7.1e+05,2015,447,3,1,1400,2250,1,0,0,3,7,1400,0,1909,1909,98119,47.637,122.36,1630,3600,106,0,4,3030,5000
3.34e+05,2015,491,2,1,890,6000,1,0,0,3,6,890,0,1941,1941,98118,47.544,122.28,1090,5900,74,0,3,1980,6790
3.15e+05,2014,264,4,2,2020,7767,1,0,0,3,8,2020,0,1995,1995,98003,47.339,122.31,1940,8239,19,0,6,3960,10259
2.15e+05,2014,239,4,1.75,1630,8000,1,0,0,3,7,1630,0,1959,1959,98031,47.395,122.2,1630,7700,55,0,5.75,3260,9330
2.8995e+05,2014,342,4,1.75,2090,7416,1,0,0,4,7,1050,1040,1970,1970,98031,47.411,122.18,1710,7527,44,0,5.75,3800,9617
3.945e+05,2014,182,4,2.5,3002,6042,2,0,0,3,8,3002,0,2004,2004,98055,47.423,122.19,2566,6390,10,0,6.5,5568,9392
3.5e+05,2015,415,3,1.75,1830,9425,1,0,0,3,8,1590,240,1946,1946,98146,47.504,122.38,1670,8430,69,0,4.75,3500,10260
3.02e+05,2014,176,4,1.75,1530,17664,1,0,0,3,7,1530,0,1968,1968,98058,47.455,122.16,1530,11625,46,0,5.75,3060,13155
6.75e+05,2015,394,3,1.75,1710,5913,1,0,0,4,8,1120,590,1941,1941,98199,47.648,122.41,2920,5922,74,0,4.75,4630,7632
3.25e+05,2014,153,3,1.75,2250,26337,1,0,0,3,8,2250,0,1980,1980,98092,47.303,122.12,1830,26337,34,0,4.75,4080,28587
2.05e+05,2014,293,2,1,970,8185,1,0,0,5,6,970,0,1904,1904,98031,47.403,122.2,1500,12541,110,0,3,2470,13511
1.35e+06,2015,423,4,3.5,4680,12495,2,0,0,3,10,3040,1640,2008,2008,98033,47.698,122.21,3240,10749,7,0,7.5,7920,15429
3e+05,2014,178,4,1,1370,8499,1,0,0,3,7,1370,0,1949,1949,98155,47.736,122.3,1370,8187,65,0,5,2740,9557
2.6e+05,2015,408,3,1.75,1360,15210,1,0,0,3,7,1360,0,1987,1987,98038,47.366,122.05,1610,7800,28,0,4.75,2970,9160
1.25e+06,2014,152,5,3.25,3160,13238,2,0,0,5,8,3160,0,1972,1972,98040,47.537,122.22,2360,12042,42,0,8.25,5520,15202
5.175e+05,2014,319,3,1,1190,7000,1,0,0,3,7,1190,0,1943,1943,98199,47.645,122.4,1350,7000,71,0,4,2540,8190
4.95e+05,2015,484,5,3.25,2500,7620,1,0,3,3,7,1250,1250,1962,1962,98106,47.53,122.34,2020,7620,53,0,8.25,4520,10120
3.5e+05,2014,263,3,2.25,1840,9929,1,0,0,3,7,1200,640,1987,1987,98028,47.741,122.24,1710,9929,27,0,5.25,3550,11769
7.65e+05,2014,285,4,2.75,2660,4500,1,0,0,5,8,1860,800,1909,1909,98103,47.686,122.35,1830,4000,105,0,6.75,4490,6660
3.75e+05,2015,456,4,2.5,2510,7245,2,0,0,3,9,2510,0,2007,2007,98146,47.51,122.36,1830,8900,8,0,6.5,4340,11410
5.25e+05,2015,450,3,2.5,3030,4500,2,0,0,3,8,3030,0,2009,2009,98059,47.494,122.15,3030,4501,6,0,5.5,6060,7531
5.5e+05,2014,311,4,2,2100,4500,1,0,0,5,7,1060,1040,1924,1924,98105,47.67,122.32,1920,3900,90,0,6,4020,6000
4.4375e+05,2014,332,3,2.25,1460,968,2,0,0,3,7,1140,320,2003,2003,98199,47.66,122.4,1460,1531,11,0,5.25,2920,2991
2.3e+05,2014,332,6,1.5,2140,36509,1,0,0,4,8,2140,0,1903,1979,98001,47.267,122.25,1710,12000,111,1,7.5,3850,14140
7.25e+05,2015,452,6,3,2480,12000,2,0,0,3,8,2480,0,1972,1972,98007,47.613,122.14,2220,8580,43,0,9,4700,11060
3.1e+05,2014,314,5,1.75,2190,27260,1,0,0,4,7,2190,0,1947,1974,98166,47.455,122.34,1620,39480,67,1,6.75,3810,41670
6.7792e+05,2014,201,3,2,1740,3600,1,0,0,5,7,990,750,1923,1923,98119,47.645,122.36,1250,3600,91,0,5,2990,5340
6.49e+05,2014,305,4,2.5,2980,12764,2,0,0,3,10,2980,0,1994,1994,98075,47.586,122.03,3080,9810,20,0,6.5,6060,12790
3.3995e+05,2014,182,3,2.5,2390,34041,1,0,0,3,8,1840,550,1984,1984,98042,47.355,122.08,2460,35686,30,0,5.5,4850,38076
3.4917e+05,2014,305,4,1.75,1670,8856,1,0,2,3,7,1070,600,1955,1955,98178,47.506,122.25,1660,8088,59,0,5.75,3330,9758
2e+05,2014,348,3,1.5,1090,10454,1,0,0,3,6,1090,0,1963,1963,98042,47.343,122.08,1230,12196,51,0,4.5,2320,13286
4.63e+05,2015,366,3,1,1250,7700,1,0,0,4,7,1250,0,1955,1955,98007,47.597,122.15,1520,7700,60,0,4,2770,8950
4.5e+05,2014,235,3,1.75,1360,5445,1,0,0,4,7,1360,0,1957,1957,98008,47.607,122.12,1570,7840,57,0,4.75,2930,9200
8.79e+05,2014,298,3,3,3030,5156,1,0,0,4,9,2080,950,1929,1929,98119,47.647,122.37,1910,5720,85,0,6,4940,8750
3.1e+05,2014,276,2,1,720,5750,1,0,0,2,6,720,0,1943,1943,98136,47.553,122.39,980,6125,71,0,3,1700,6845
5.7e+05,2014,133,3,2,1530,5401,1,0,0,4,7,1530,0,1937,1937,98115,47.686,122.3,1640,5467,77,0,5,3170,6997
1.23e+06,2014,180,3,1.75,2200,14630,1,0,1,3,8,2200,0,1948,2003,98004,47.607,122.21,2850,15803,66,1,4.75,5050,18003
5.85e+05,2014,147,3,1.75,1850,7735,1,0,0,4,8,1850,0,1983,1983,98027,47.561,122.08,2220,7639,31,0,4.75,4070,9489
6.75e+05,2014,145,3,3,2980,28000,1,0,0,3,10,1820,1160,1981,1981,98052,47.732,122.14,2570,28500,33,0,6,5550,31480
5.1e+05,2014,277,4,4,3530,10935,2,0,0,3,10,3530,0,1992,1992,98023,47.302,122.34,3360,11250,22,0,8,6890,14780
2.75e+05,2014,264,3,2.5,1730,5799,2,0,0,4,7,1730,0,1987,1987,98030,47.35,122.18,1710,6490,27,0,5.5,3440,8220
2.59e+05,2015,464,3,2,1390,7120,1,0,0,3,7,1390,0,1988,1988,98030,47.379,122.18,1530,7688,27,0,5,2920,9078
2.8995e+05,2014,231,3,2.5,2070,5013,2,0,0,3,8,2070,0,1987,1987,98023,47.32,122.39,1670,5013,27,0,5.5,3740,7083
6.5e+05,2014,194,4,2.5,2530,6500,1,0,0,3,8,1720,810,1975,1975,98115,47.674,122.28,2150,5280,39,0,6.5,4680,7810
8.2e+05,2014,347,4,2.5,3720,8633,2,0,0,3,10,3720,0,1999,1999,98074,47.608,122.01,3515,9660,15,0,6.5,7235,13380
4.9e+05,2014,312,3,2.25,1500,1290,2,0,0,3,8,1220,280,2006,2006,98117,47.678,122.38,1460,1375,8,0,5.25,2960,2875
3.45e+05,2014,180,2,1,970,5750,1,0,0,4,6,970,0,1932,1932,98126,47.552,122.37,1650,8625,82,0,3,2620,9595
1.35e+06,2014,159,4,3.25,3300,15907,2,0,0,5,10,3300,0,1985,1985,98040,47.541,122.22,2740,11358,29,0,7.25,6040,14658
1.55e+06,2015,396,3,4,5120,4600,3,0,2,3,11,4490,630,2008,2008,98034,47.705,122.22,2510,5918,7,0,7,7630,11038
2.65e+05,2015,410,3,1.75,1450,5858,1,0,0,4,7,1450,0,1991,1991,98038,47.348,122.04,1520,6573,24,0,4.75,2970,8023
4.72e+05,2014,251,3,1.75,2180,7200,1,0,3,4,8,1090,1090,1954,1954,98178,47.504,122.23,2180,7140,60,0,4.75,4360,9320
3.12e+05,2015,388,4,1,1730,8706,1,0,0,4,7,1010,720,1962,1962,98058,47.459,122.17,1369,8418,53,0,5,3099,10148
7.134e+05,2014,190,3,2.25,1810,9845,1,0,0,4,8,1810,0,1959,1991,98040,47.55,122.22,1900,10083,55,1,5.25,3710,11893
1.05e+06,2014,235,4,4,4320,8709,2,0,0,3,11,3190,1130,2006,2006,98027,47.537,122.07,4010,8321,8,0,8,8330,12641
3.225e+05,2014,168,4,2.5,1820,6753,2,0,0,3,7,1820,0,1994,1994,98038,47.385,122.03,1820,7107,20,0,6.5,3640,8927
8.61e+05,2014,235,3,2,2520,3959,1,0,0,5,8,1270,1250,1931,1931,98105,47.669,122.29,1660,3959,83,0,5,4180,6479
4.95e+05,2015,408,3,1,1570,5510,1,0,0,4,7,1070,500,1940,1940,98115,47.694,122.32,1770,6380,75,0,4,3340,7950
2.4e+05,2014,229,3,1,1280,9000,1,0,0,4,6,1280,0,1954,1954,98146,47.492,122.34,1430,4500,60,0,4,2710,5780
6.5e+05,2014,217,4,2.25,2100,2500,3,0,0,3,8,2100,0,2001,2001,98115,47.673,122.3,1660,4000,13,0,6.25,3760,6100
6.255e+05,2014,197,3,2.25,1270,1566,2,0,0,3,8,1060,210,2014,2014,98105,47.665,122.28,1160,1327,0,0,5.25,2430,2597
2.1e+05,2014,332,4,2,1520,6174,1,0,0,5,6,1520,0,1920,1920,98022,47.211,121.99,1390,5407,94,0,6,2910,6927
7.05e+05,2014,203,3,1.75,2180,10221,1,0,2,4,7,1140,1040,1946,1946,98040,47.589,122.25,2180,8535,68,0,4.75,4360,10715
2.35e+05,2014,173,4,1.75,1450,8891,1,0,0,3,7,1180,270,1962,1962,98168,47.478,122.28,1450,9013,52,0,5.75,2900,10463
9e+05,2014,188,3,2.5,3180,12600,2,0,0,4,11,3180,0,1978,1978,98074,47.637,122.06,3030,12835,36,0,5.5,6210,16015
2.2e+05,2014,215,4,1.75,2020,7840,1,0,0,3,7,1010,1010,1968,1968,98003,47.331,122.3,1750,8140,46,0,5.75,3770,10160
1.7625e+05,2015,460,4,2,1440,6702,1,0,0,4,7,1440,0,1966,1966,98002,47.306,122.22,1030,6702,49,0,6,2470,8142
4.9e+05,2015,451,3,1.75,1540,9000,1,0,0,3,8,1540,0,1971,1971,98125,47.715,122.32,1710,7488,44,0,4.75,3250,9028
4.425e+05,2014,307,3,1.5,2710,47419,1,0,0,3,7,2170,540,1980,1980,98053,47.652,121.97,2130,48144,34,0,4.5,4840,50854
3.9e+05,2014,201,4,2.5,2154,4153,2,0,0,3,9,2154,0,2012,2012,98058,47.456,122.13,2154,4091,2,0,6.5,4308,6245
2.69e+05,2015,465,4,1.75,1490,10000,1,0,0,4,8,1100,390,1969,1969,98023,47.31,122.38,2190,8910,46,0,5.75,3680,10400
3.65e+05,2014,239,3,1.75,1410,9150,1,0,0,5,7,1410,0,1959,1959,98006,47.568,122.18,1800,9940,55,0,4.75,3210,11350
4.88e+05,2014,214,3,2.5,1940,5660,2,0,0,3,8,1940,0,2001,2001,98072,47.751,122.17,2110,4581,13,0,5.5,4050,6521
4.85e+05,2014,359,5,2.5,3270,6129,2,0,0,3,9,3270,0,2004,2004,98055,47.446,122.21,2980,5928,10,0,7.5,6250,9198
3.05e+05,2015,436,3,1.75,1460,7862,1,0,0,3,7,1460,0,1965,1965,98155,47.776,122.3,2200,9293,50,0,4.75,3660,10753
2.03e+05,2014,319,3,1.5,1370,7500,1,0,0,3,7,1080,290,1958,1958,98198,47.417,122.32,1400,7500,56,0,4.5,2770,8870
5.95e+05,2014,319,4,2.5,2100,3125,2,0,2,3,7,1400,700,1907,1993,98107,47.663,122.36,2060,5040,107,1,6.5,4160,7140
2.52e+05,2015,444,4,1.5,1550,19800,1,0,0,4,7,1050,500,1969,1969,98001,47.312,122.27,1640,22654,46,0,5.5,3190,24204
8.15e+05,2014,214,5,3.5,3500,10794,2,0,0,3,10,3500,0,1996,1996,98075,47.589,121.97,3110,10837,18,0,8.5,6610,14337
1.75e+05,2015,408,2,1,1160,6911,1,0,0,3,7,1160,0,1947,1947,98125,47.715,122.32,1120,6948,68,0,3,2280,8108
2.645e+05,2015,412,3,2.5,1630,8346,1,0,0,3,8,1630,0,1990,1990,98092,47.262,122.22,2110,8619,25,0,5.5,3740,10249
1.65e+05,2014,206,3,1,910,8700,1,0,0,4,6,910,0,1943,1943,98188,47.449,122.29,1090,8700,71,0,4,2000,9610
3.7e+05,2014,310,2,1,780,1133,2,0,0,3,7,780,0,2009,2009,98144,47.592,122.3,1130,1270,5,0,3,1910,2050
3.7495e+05,2014,189,3,2.25,1390,1484,3,0,0,3,8,1390,0,2007,2007,98103,47.691,122.34,1250,1087,7,0,5.25,2640,2477
3.2e+05,2014,292,4,3,1820,3120,1,0,0,3,7,1000,820,1997,1997,98118,47.547,122.27,1600,5001,17,0,7,3420,6821
9.6e+05,2014,153,5,2.75,3040,10257,2,0,0,3,10,3040,0,1993,1993,98006,47.553,122.12,2860,9327,21,0,7.75,5900,12367
2.55e+05,2014,354,3,1.5,1110,10296,1,0,0,5,7,1110,0,1964,1964,98042,47.422,122.15,1330,10296,50,0,4.5,2440,11406
2.299e+05,2014,201,3,1,1010,8848,1,0,0,4,7,1010,0,1968,1968,98003,47.274,122.3,1380,10650,46,0,4,2390,11660
6.7e+05,2014,333,3,2.25,3340,13805,1,0,0,3,8,3340,0,1950,1992,98155,47.744,122.29,2060,12304,64,1,5.25,5400,15644
5.49e+05,2014,318,3,1.75,2000,6130,1,0,0,4,8,1120,880,1951,1951,98117,47.693,122.39,2140,7150,63,0,4.75,4140,9150
4.85e+05,2015,473,3,1,1260,7250,1,0,2,3,7,960,300,1940,1940,98115,47.695,122.31,1540,7250,75,0,4,2800,8510
3.25e+05,2015,447,2,1,1060,6050,1,0,0,3,7,940,120,1939,1939,98125,47.703,122.32,1540,5279,76,0,3,2600,6339
4.5e+05,2014,210,3,1,1450,3350,1,0,0,4,7,1450,0,1919,1919,98126,47.561,122.38,1340,4255,95,0,4,2790,5705
4.52e+05,2014,140,4,1,1210,3760,1,0,0,3,6,1210,0,1900,1900,98103,47.687,122.34,1540,3800,114,0,5,2750,5010
1.03e+06,2014,141,3,4,3880,13095,2,0,3,3,11,3700,180,2009,2009,98034,47.7,122.23,3880,10830,5,0,7,7760,14710
3.25e+05,2014,188,2,1,810,4080,1,0,0,4,6,810,0,1941,1941,98126,47.534,122.38,1400,4080,73,0,3,2210,4890
2.8e+05,2014,209,4,2.75,2230,10160,1,0,0,3,7,1400,830,1968,1968,98168,47.512,122.32,1740,10080,46,0,6.75,3970,12310
4.425e+05,2015,439,4,2.5,2400,7092,2,0,0,3,7,2400,0,1997,1997,98133,47.752,122.34,2350,8310,18,0,6.5,4750,10710
1.98e+05,2015,458,3,1,860,5185,1,0,0,4,6,860,0,1968,1968,98042,47.363,122.09,1120,5494,47,0,4,1980,6354
3.25e+05,2014,333,3,2,1570,5600,1,0,0,3,8,1570,0,1999,1999,98058,47.429,122.19,2010,5600,15,0,5,3580,7170
7e+05,2015,464,2,1.5,1850,4945,1,0,2,4,7,1850,0,1907,1969,98126,47.574,122.38,1850,4950,108,1,3.5,3700,6800
1.705e+05,2014,187,2,1,1060,7700,1,0,0,3,7,820,240,1981,1981,98055,47.46,122.2,1370,8833,33,0,3,2430,9893
3.25e+05,2015,409,3,1,1300,8879,1,0,0,3,7,920,380,1950,1950,98155,47.746,122.33,1530,6960,65,0,4,2830,8260
5.3725e+05,2014,300,4,2.5,2590,9530,1,0,0,4,8,1640,950,1978,1978,98155,47.775,122.28,2710,10970,36,0,6.5,5300,13560
2.3e+05,2015,362,3,1.75,1520,15344,1,0,0,3,8,1520,0,1968,1968,98023,47.331,122.36,2270,14981,47,0,4.75,3790,16501
6.8e+05,2014,189,3,2,1780,5720,1,0,0,5,7,980,800,1925,1925,98103,47.679,122.35,1620,5050,89,0,5,3400,6830
5.6323e+05,2015,383,3,1,2460,4000,1,0,0,4,7,1370,1090,1918,1918,98112,47.627,122.3,1680,4000,97,0,4,4140,6460
3.05e+05,2014,251,4,2.25,2130,9600,1,0,0,4,7,2130,0,1966,1966,98031,47.412,122.21,1710,9600,48,0,6.25,3840,11730
3.4e+05,2014,313,3,2.5,1240,1115,3,0,0,3,8,1240,0,2003,2003,98103,47.699,122.34,1410,1355,11,0,5.5,2650,2595
5.7e+05,2014,249,3,1.75,2910,37461,1,0,0,4,7,1530,1380,1967,1967,98052,47.702,122.16,2520,18295,47,0,4.75,5430,21205
1.311e+06,2014,317,4,3.75,3490,5625,2,0,0,3,9,2610,880,2014,2014,98103,47.669,122.33,1940,5000,0,0,7.75,5430,8490
2.75e+05,2015,415,5,2.25,1820,10500,1,0,0,4,7,1080,740,1979,1979,98031,47.406,122.18,1820,7500,36,0,7.25,3640,9320
6.3e+05,2014,188,2,2.5,2290,3507,2,0,0,3,9,2290,0,2005,2005,98029,47.554,122,2290,3640,9,0,4.5,4580,5930
1.25e+06,2014,216,5,5,5000,32909,2,0,0,3,10,5000,0,2000,2000,98075,47.601,122.02,3030,12601,14,0,10,8030,17601
5.5e+05,2015,367,3,2,1810,2159,1,0,0,3,7,1010,800,1922,1922,98109,47.627,122.34,1810,2159,93,0,5,3620,3969
3.68e+05,2015,446,5,1.75,2590,9394,1,0,0,4,7,1390,1200,1963,1963,98198,47.394,122.31,2580,9049,52,0,6.75,5170,11639
3.32e+05,2014,352,5,1.5,2420,43560,1,0,2,3,8,1500,920,1962,1962,98022,47.208,121.96,1620,17331,52,0,6.5,4040,19751
6.67e+05,2014,196,3,1.75,1770,3880,1,0,0,3,8,1300,470,1963,1963,98117,47.685,122.39,1430,3880,51,0,4.75,3200,5650
4.65e+05,2014,154,3,1,910,4500,1,0,0,3,7,910,0,1948,1948,98117,47.683,122.39,1370,5000,66,0,4,2280,5910
2.25e+06,2014,299,4,3.5,4440,8125,2,0,3,5,10,3140,1300,1922,1922,98144,47.574,122.28,3990,8505,92,0,7.5,8430,12945
5.13e+05,2014,163,4,2.75,2020,7070,1,0,0,5,7,1010,1010,1958,1958,98126,47.52,122.38,1390,6000,56,0,6.75,3410,8020
2.2674e+05,2014,196,3,1.5,1410,8800,1,0,0,4,7,1410,0,1965,1965,98092,47.293,122.18,2180,10108,49,0,4.5,3590,11518
5e+05,2014,166,4,2.75,2280,15347,1,0,0,5,7,2280,0,1960,1960,98059,47.522,122.16,2280,15347,54,0,6.75,4560,17627
2.35e+05,2014,270,3,1.75,1200,9266,1,0,0,4,7,1200,0,1960,1960,98002,47.314,122.21,1200,9266,54,0,4.75,2400,10466
2.995e+05,2014,232,4,2.5,2010,12085,2,0,0,3,8,2010,0,1986,1986,98042,47.341,122.06,1910,12133,28,0,6.5,3920,14143
9.57e+05,2014,175,5,3.25,3160,5000,2,0,2,3,10,2180,980,2005,2005,98199,47.646,122.41,3160,5746,9,0,8.25,6320,8906
3.15e+05,2014,277,2,2.25,1240,705,2,0,0,3,7,1150,90,2009,2009,98027,47.532,122.07,1240,750,5,0,4.25,2480,1990
3.68e+05,2014,223,3,1.75,1750,14400,1,0,0,4,7,1750,0,1951,1951,98166,47.453,122.36,2030,14400,63,0,4.75,3780,16150
6.7e+05,2015,451,5,3,2520,13001,2,0,1,3,8,2010,510,1973,1973,98008,47.639,122.11,2170,8215,42,0,8,4690,10735
3.1e+05,2014,257,4,2.75,2370,7320,2,0,0,3,7,2370,0,1989,1989,98023,47.307,122.36,1960,7320,25,0,6.75,4330,9690
6.233e+05,2014,196,4,3.5,4170,4524,2,0,0,3,9,3500,670,2007,2007,98072,47.773,122.16,3510,5001,7,0,7.5,7680,9171
4.1e+05,2014,306,2,1,1030,4366,1,0,0,3,7,1030,0,1912,1912,98136,47.531,122.38,1890,4499,102,0,3,2920,5529
8.05e+05,2014,251,4,2.5,3320,38032,2,0,0,4,10,3320,0,1991,1991,98077,47.748,122.04,3270,37804,23,0,6.5,6590,41124
5.15e+05,2014,126,3,2.5,1790,7167,2,0,0,3,8,1790,0,1989,1989,98074,47.618,122.05,1680,7418,25,0,5.5,3470,9208
4.705e+05,2015,464,4,2.25,2070,14000,1,0,0,3,7,1720,350,1958,1958,98028,47.748,122.24,1690,14444,57,0,6.25,3760,16514
3.25e+05,2014,285,2,0.75,1020,1076,2,0,0,3,7,1020,0,2008,2008,98144,47.594,122.3,1020,1357,6,0,2.75,2040,2377
2.7e+05,2014,242,3,1.5,1610,8375,2,0,0,3,7,1610,0,1927,1927,98155,47.753,122.31,1610,9107,87,0,4.5,3220,10717
7.74e+05,2015,388,4,2.75,2830,10240,2,0,0,4,9,2830,0,1998,1998,98075,47.59,121.99,3490,10240,17,0,6.75,6320,13070
5.55e+05,2014,277,4,1.5,3050,82764,1,0,0,3,8,1650,1400,1966,1966,98056,47.527,122.19,2930,10074,48,0,5.5,5980,13124
6.74e+05,2014,257,4,2.5,2810,11560,1,0,0,5,7,1740,1070,1962,1962,98008,47.585,122.12,1970,11560,52,0,6.5,4780,14370
4.25e+05,2014,345,4,2.5,1950,5000,2,0,0,3,8,1950,0,2012,2012,98065,47.515,121.87,2710,5000,2,0,6.5,4660,6950
6.075e+05,2014,169,3,3.25,1530,1612,3,0,0,3,8,1530,0,2006,2006,98107,47.671,122.38,1530,1611,8,0,6.25,3060,3141
2.1665e+05,2014,285,3,3.5,1480,1077,2,0,0,3,7,1300,180,2007,2007,98109,47.542,122.32,1140,2003,7,0,6.5,2620,3483
3.5995e+05,2014,160,3,1.75,1890,9100,2,0,0,4,7,1890,0,1952,1952,98133,47.768,122.34,1640,9100,62,0,4.75,3530,10990
1.58e+06,2015,488,4,2.75,3480,19991,2,0,2,4,10,2630,850,1979,1979,98004,47.635,122.21,3770,20271,36,0,6.75,7250,23751
3.649e+05,2015,386,4,2.5,2490,9346,2,0,2,3,9,2490,0,1996,1996,98042,47.383,122.15,2650,9454,19,0,6.5,5140,11944
5.0001e+05,2015,443,2,1.75,1820,6050,1,0,0,3,7,910,910,1950,1950,98115,47.693,122.32,1730,6050,65,0,3.75,3550,7870
1.94e+05,2015,430,4,2,1760,7700,1,0,0,4,7,1760,0,1962,1962,98003,47.33,122.32,1870,7316,53,0,6,3630,9076
5.7e+05,2014,255,3,3.5,1460,1021,2,0,0,3,8,1150,310,2006,2006,98122,47.617,122.31,1460,1245,8,0,6.5,2920,2705
4.01e+05,2014,237,3,3.25,1770,1977,3,0,0,3,8,1770,0,2001,2001,98125,47.719,122.31,1860,2210,13,0,6.25,3630,3980
3.035e+05,2014,129,3,1.5,1060,10464,1,0,0,4,7,1060,0,1973,1973,98034,47.731,122.23,1420,10464,41,0,4.5,2480,11524
8.0825e+05,2014,244,3,2,1750,2640,1,0,0,3,8,1010,740,1914,2005,98119,47.642,122.37,1750,4560,100,1,5,3500,6310
4.59e+05,2015,438,2,2.25,1010,1107,2,0,0,3,8,710,300,2006,2006,98119,47.636,122.37,1140,1531,9,0,4.25,2150,2541
4.99e+05,2014,169,3,1.75,1840,5000,1,0,0,4,7,920,920,1910,1910,98117,47.681,122.38,1220,5000,104,0,4.75,3060,6840
4.65e+05,2014,198,4,2.25,2340,13383,1,0,0,3,8,1170,1170,1983,1983,98074,47.621,122.04,1810,12532,31,0,6.25,4150,14872
3.675e+05,2015,444,3,3.25,1400,1343,2,0,0,3,7,1160,240,2005,2005,98118,47.548,122.28,1400,1326,10,0,6.25,2800,2726
2.24e+05,2014,176,3,1.75,1500,11968,1,0,0,3,6,1500,0,2014,2014,98010,47.309,122,1320,11303,0,0,4.75,2820,12803
2.27e+05,2015,408,3,1.75,1680,7455,1,0,0,4,8,1680,0,1968,1968,98023,47.311,122.38,2040,8214,47,0,4.75,3720,9894
4.2e+05,2014,236,4,2.5,2480,8626,2,0,0,3,10,2480,0,2001,2001,98001,47.319,122.26,2990,9033,13,0,6.5,5470,11513
6.4e+05,2014,135,4,2,2560,7798,1,0,0,4,7,1890,670,1947,1947,98115,47.691,122.3,1330,7798,67,0,6,3890,10358
5.1e+05,2014,174,3,2.25,1420,1309,3,0,0,3,8,1420,0,2006,2006,98103,47.653,122.35,1500,1282,8,0,5.25,2920,2702
3.72e+05,2015,453,4,2.5,2520,9604,2,0,0,3,9,2520,0,1990,1990,98031,47.389,122.22,2540,9793,25,0,6.5,5060,12313
8.7665e+05,2014,132,3,3.25,2170,12508,1,0,0,5,9,1650,520,1928,1970,98040,47.566,122.23,2720,21070,86,1,6.25,4890,23240
3.495e+05,2015,446,3,2,1130,16875,1,0,0,4,7,1130,0,1947,1947,98155,47.749,122.3,1600,14300,68,0,5,2730,15430
4.17e+05,2015,460,3,2.75,1820,52889,2,0,0,3,8,1820,0,1991,1991,98070,47.501,122.46,1820,45528,24,0,5.75,3640,47348
2.875e+05,2015,445,5,2,2020,67953,1,0,0,4,7,1620,400,1936,1936,98178,47.489,122.26,1270,13198,79,0,7,3290,15218
4.9995e+05,2014,155,3,2.5,2370,12753,2,0,0,3,7,2370,0,2001,2001,98019,47.736,121.98,2280,16808,13,0,5.5,4650,19178
3.59e+05,2015,423,3,2,3085,7280,1,0,0,4,7,1560,1525,1959,1959,98056,47.496,122.18,1480,7900,56,0,5,4565,10985
5.2e+05,2015,424,3,2.25,2210,10794,1,0,0,3,7,1540,670,1967,1967,98178,47.491,122.22,2230,10753,48,0,5.25,4440,12963
4.185e+05,2015,463,3,2,1800,12440,1,0,0,3,8,1220,580,1978,1978,98074,47.625,122.05,2460,12352,37,0,5,4260,14152
8.65e+05,2015,443,3,2.25,2670,1.5027e+05,2,0,0,3,9,2670,0,1985,1985,98072,47.76,122.13,3080,81054,30,0,5.25,5750,83724
3.445e+05,2015,365,3,1.75,1890,9535,1,0,0,3,7,1210,680,1976,1976,98055,47.487,122.22,2040,11108,39,0,4.75,3930,12998
3.52e+05,2014,319,4,2.5,2650,6366,2,0,0,3,9,2650,0,1998,1998,98092,47.333,122.17,2650,6200,16,0,6.5,5300,8850
4.51e+05,2014,235,4,1.5,1620,5444,1,0,0,3,8,1620,0,1955,1955,98125,47.706,122.3,1620,6912,59,0,5.5,3240,8532
2.85e+05,2015,458,4,1,1430,3600,1,0,0,3,6,980,450,1947,1947,98106,47.534,122.36,1170,4000,68,0,5,2600,5430
6.25e+05,2014,175,5,2.5,2700,21208,1,0,0,4,8,1950,750,1955,1955,98005,47.608,122.15,2550,20409,59,0,7.5,5250,23109
6.25e+05,2015,485,3,2,2168,12616,2,0,1,4,7,2168,0,1950,1950,98146,47.493,122.37,2168,9750,65,0,5,4336,11918
3.7e+05,2014,195,4,2.5,2130,4750,2,0,0,3,8,2130,0,2009,2009,98058,47.432,122.18,2130,4071,5,0,6.5,4260,6201
4.7935e+05,2015,494,5,3,3223,6371,2,0,0,3,9,3223,0,2014,2014,98042,47.358,122.16,1979,9008,1,0,8,5202,12231
8.38e+05,2014,122,4,2.5,3310,42998,2,0,0,3,9,3310,0,2001,2001,98052,47.723,122.13,3350,42847,13,0,6.5,6660,46157
3.58e+05,2015,484,4,2.5,1830,7308,2,0,0,3,7,1830,0,2002,2002,98038,47.356,122.02,1830,5692,13,0,6.5,3660,7522
4.63e+05,2014,348,4,2.75,1900,6000,1,0,2,3,7,1300,600,1961,1961,98178,47.495,122.23,2230,6000,53,0,6.75,4130,7900
8.95e+05,2014,182,4,2.25,1950,5950,1,0,0,3,8,1330,620,1947,1947,98109,47.639,122.35,2600,5593,67,0,6.25,4550,7543
4.2e+05,2015,409,4,2.25,2930,9840,1,0,0,4,8,1560,1370,1977,1977,98023,47.31,122.38,2800,8374,38,0,6.25,5730,11304
3.2e+05,2015,465,4,2.5,2110,6295,2,0,0,3,8,2110,0,2000,2000,98030,47.364,122.19,2720,6311,15,0,6.5,4830,8421
5.22e+05,2014,161,3,1.75,1730,8400,1,0,0,4,7,1400,330,1980,1980,98052,47.679,122.11,1830,8636,34,0,4.75,3560,10366
6.25e+05,2014,191,4,3,2530,5625,1,0,0,3,8,1470,1060,1976,1976,98034,47.709,122.23,1840,7070,38,0,7,4370,9600
1.91e+05,2015,439,2,1,700,5000,1,0,0,5,6,700,0,1952,1952,98056,47.493,122.17,1040,5200,63,0,3,1740,5900
3.86e+05,2015,414,3,1.5,1550,8000,1,0,0,3,6,1330,220,1980,1980,98118,47.554,122.29,1150,5150,35,0,4.5,2700,6700
6.1e+05,2014,204,4,2.5,2410,15899,2,0,3,3,9,2410,0,1990,1990,98074,47.624,122.04,2360,11412,24,0,6.5,4770,13822
4.99e+05,2014,160,2,1,1220,3000,1,0,0,3,7,920,300,1926,1926,98117,47.682,122.36,1270,3000,88,0,3,2490,4220
2.85e+05,2014,248,3,2.5,1890,3629,2,0,0,3,7,1890,0,2005,2005,98038,47.361,122.04,1980,4000,9,0,5.5,3870,5890
2.088e+05,2014,259,3,2.5,1390,2450,2,0,0,3,7,1390,0,2009,2009,98118,47.53,122.27,1390,2450,5,0,5.5,2780,3840
6.37e+05,2015,413,4,2.5,2120,15000,2,0,0,4,8,2120,0,1983,1983,98052,47.716,122.1,2170,15000,32,0,6.5,4290,17120
2.87e+05,2015,372,4,2.25,1980,7081,1,0,0,3,7,1470,510,1977,1977,98032,47.367,122.29,1980,7081,38,0,6.25,3960,9061
6.19e+05,2014,230,3,2,1990,3000,1,0,2,5,8,1430,560,1927,1927,98144,47.589,122.29,1780,5000,87,0,5,3770,6990
2.847e+05,2014,312,3,1,1700,8645,1,0,0,3,6,1700,0,1955,1955,98146,47.49,122.34,1500,7980,59,0,4,3200,9680
2.12e+05,2015,413,4,2,1880,7500,1,0,0,5,6,980,900,1946,1946,98178,47.495,122.27,1670,14350,69,0,6,3550,16230
4.2995e+05,2014,272,3,1.75,1830,9758,1,0,0,3,8,1300,530,1977,1977,98034,47.711,122.23,1850,8000,37,0,4.75,3680,9830
2.4995e+05,2014,301,5,2,1730,7375,1,0,0,4,6,1730,0,1944,1944,98178,47.495,122.24,1550,7125,70,0,7,3280,8855
3.099e+05,2014,224,3,2.5,2020,26670,2,0,0,3,7,2020,0,1987,1987,98003,47.26,122.31,1680,10939,27,0,5.5,3700,12959
4.985e+05,2014,162,5,2.75,2990,7420,2,0,0,3,8,2990,0,1996,1996,98059,47.494,122.16,2290,7678,18,0,7.75,5280,10668
8.59e+05,2014,174,4,2.25,3550,13900,1,0,0,3,8,1830,1720,2010,2010,98006,47.568,122.13,2770,12200,4,0,6.25,6320,15750
3.88e+05,2014,269,4,2.5,2090,5040,2,0,0,3,9,2090,0,2014,2014,98055,47.48,122.23,1430,12000,0,0,6.5,3520,14090
1.085e+06,2014,237,4,3,3410,6541,2,0,2,3,9,2680,730,2007,2007,98126,47.542,122.38,2300,6345,7,0,7,5710,9755
3.15e+05,2014,150,3,2,1060,5750,1,0,0,3,7,1060,0,1981,1981,98126,47.552,122.37,1080,5750,33,0,5,2140,6810
9.35e+05,2015,452,3,2.5,3570,15151,1,0,0,4,8,2400,1170,1981,1981,98177,47.748,122.36,3140,14375,34,0,5.5,6710,17945
2.12e+05,2014,270,3,1.5,1830,12233,1,0,0,4,5,1830,0,1930,1930,98022,47.206,122,1520,12233,84,0,4.5,3350,14063
4.68e+05,2015,463,2,1.75,1510,4500,1,0,0,3,8,1510,0,1978,1978,98052,47.664,122.13,1740,6000,37,0,3.75,3250,7510
2.75e+05,2015,388,4,2.25,2400,17842,2,0,0,4,7,2400,0,1973,1973,98002,47.287,122.22,1610,12100,42,0,6.25,4010,14500
6.035e+05,2014,154,4,2.5,4060,9734,1,0,4,3,9,2150,1910,1977,1977,98028,47.768,122.25,2750,10370,37,0,6.5,6810,14430
5.21e+05,2014,293,3,2,1840,6000,1,0,0,4,6,1840,0,1908,1944,98136,47.551,122.39,2010,6000,106,1,5,3850,7840
3.185e+05,2014,260,5,1.75,1550,6986,1,0,0,3,7,1030,520,1978,1978,98106,47.55,122.36,1550,6986,36,0,6.75,3100,8536
5.15e+05,2014,250,4,1.75,1730,7980,1,0,0,4,8,1730,0,1965,1965,98007,47.622,122.14,2080,8400,49,0,5.75,3810,10130
4.8e+05,2014,188,2,1,1060,3040,1,0,0,3,7,860,200,1924,1924,98103,47.672,122.33,1470,3814,90,0,3,2530,4874
4.75e+05,2014,342,3,1.75,2020,8970,1,0,0,4,7,1180,840,1981,1981,98072,47.757,122.14,2140,8008,33,0,4.75,4160,10028
2.4e+05,2015,368,4,1.5,1780,14810,1,0,0,4,8,1180,600,1950,1950,98032,47.358,122.29,1450,6728,65,0,5.5,3230,8508
3.1e+05,2015,403,4,2.75,1950,9720,1,0,0,3,7,1400,550,1986,1986,98031,47.397,122.2,2300,10530,29,0,6.75,4250,12480
2.6195e+05,2014,339,3,2.5,1880,5000,2,0,0,3,7,1880,0,2010,2010,98042,47.336,122.05,2260,5000,4,0,5.5,4140,6880
5.79e+05,2014,257,4,2.75,3220,9825,2,0,0,3,8,3220,0,2012,2012,98059,47.486,122.14,2820,8566,2,0,6.75,6040,11786
5.1e+05,2014,127,4,2.5,2430,5203,2,0,0,3,8,2430,0,2003,2003,98155,47.74,122.32,2260,7474,11,0,6.5,4690,9904
3.5795e+05,2014,314,2,1,810,3880,1,0,0,3,7,810,0,1952,1952,98107,47.663,122.36,900,4365,62,0,3,1710,5175
2.295e+05,2015,465,3,1,1780,7470,1,0,0,3,7,1050,730,1960,1960,98146,47.512,122.34,1780,8113,55,0,4,3560,9893
2.185e+05,2015,436,2,1,1600,8961,1,0,0,4,7,1390,210,1949,1949,98002,47.31,122.21,1502,6798,66,0,3,3102,8398
1.94e+06,2015,433,5,2.25,3120,16672,2,0,0,4,9,3120,0,1969,1969,98004,47.646,122.22,3740,17853,46,0,7.25,6860,20973
6.3e+05,2015,455,3,1,1590,4080,1,0,0,3,7,1590,0,1922,1922,98105,47.662,122.33,1570,4080,93,0,4,3160,5670
4.82e+05,2014,122,4,2.5,2710,35868,2,0,0,3,9,2710,0,1989,1989,98038,47.375,122.02,2780,36224,25,0,6.5,5490,38934
6.85e+05,2014,360,3,2.5,1460,8800,1,0,0,4,7,1460,0,1956,1956,98040,47.59,122.23,2200,8800,58,0,5.5,3660,10260
2.9e+05,2014,332,2,1,900,2728,2,0,0,3,7,900,0,1998,1998,98144,47.588,122.3,900,2728,16,0,3,1800,3628
3.655e+05,2014,319,4,2.5,2030,4499,2,0,0,3,8,2030,0,2003,2003,98058,47.451,122.12,2030,4539,11,0,6.5,4060,6569
5.445e+05,2014,242,5,1,1690,3240,1,0,0,3,7,1690,0,1914,1914,98115,47.675,122.33,1230,4500,100,0,6,2920,6190
2.3e+05,2014,211,3,1.75,1140,1165,2,0,0,3,8,1140,0,2014,2014,98108,47.564,122.3,1150,1552,0,0,4.75,2290,2692
1.325e+06,2014,190,6,4.25,5720,10213,2,0,0,3,10,4170,1550,2004,2004,98006,47.546,122.12,4300,10224,10,0,10.25,10020,15944
4.5e+05,2015,457,3,2.25,1940,8312,1,0,1,4,7,1220,720,1963,1963,98166,47.456,122.35,2060,9503,52,0,5.25,4000,11443
7.75e+05,2014,294,3,2,2010,7017,2,0,3,3,7,2010,0,1951,1988,98115,47.683,122.27,2450,6045,63,1,5,4460,8055
3.68e+05,2015,473,4,2.75,3430,8000,1,0,0,4,8,3430,0,1972,1972,98023,47.318,122.38,2090,8000,43,0,6.75,5520,11430
3.57e+05,2014,251,3,2,2460,53882,1,1,4,3,7,2460,0,1955,1955,98198,47.381,122.33,2660,32625,59,0,5,5120,35085
1.6e+06,2014,142,3,2.5,3160,12824,1,0,2,4,9,1820,1340,1966,1966,98004,47.615,122.22,3390,11985,48,0,5.5,6550,15145
5.49e+05,2014,174,2,1,2034,13392,1,1,4,5,7,1159,875,1947,1947,98070,47.331,122.5,1156,15961,67,0,3,3190,17995
7.42e+05,2014,161,4,2.5,2810,10986,2,0,0,3,10,2810,0,1997,1997,98075,47.594,121.98,3540,10986,17,0,6.5,6350,13796
2.7e+05,2015,481,3,1,1130,7920,1,0,0,3,7,1130,0,1961,1961,98059,47.485,122.13,1390,8580,54,0,4,2520,9710
4.02e+05,2015,484,2,1,1210,5600,1,0,0,3,7,1210,0,1922,1922,98136,47.532,122.39,1400,5028,93,0,3,2610,6238
8.25e+05,2015,446,4,3.25,3040,4155,2,0,0,3,8,2350,690,2013,2013,98029,47.543,122.01,2680,4000,2,0,7.25,5720,7040
4.6e+05,2014,148,4,3,2230,52983,2,0,0,3,8,2230,0,1991,1991,98030,47.358,122.19,2060,8755,23,0,7,4290,10985
2.6411e+06,2015,402,5,4.25,4660,16200,2,0,2,3,11,4660,0,2005,2005,98004,47.633,122.22,3340,16200,10,0,9.25,8000,20860
4.646e+05,2014,143,3,1.75,1120,5500,1,0,0,4,7,1120,0,1925,1925,98136,47.544,122.39,1490,5500,89,0,4.75,2610,6620
4.98e+05,2014,198,3,2.5,2480,4136,2,0,0,3,8,2480,0,2009,2009,98059,47.493,122.15,2510,4314,5,0,5.5,4990,6794
4.4e+05,2014,353,3,1.75,1640,8529,1,0,0,5,7,1640,0,1951,1951,98155,47.775,122.32,1730,7769,63,0,4.75,3370,9409
3.2e+05,2014,359,3,2,2320,7800,1,0,0,4,7,1160,1160,1960,1960,98168,47.514,122.32,1380,7800,54,0,5,3700,10120
4e+05,2014,277,5,2.25,2070,10488,1,0,0,4,7,1080,990,1958,1958,98008,47.609,122.12,1740,9225,56,0,7.25,3810,11295
1.15e+05,2015,414,3,1.75,1080,7942,1,0,0,3,7,1080,0,1981,1981,98023,47.314,122.36,1380,8244,34,0,4.75,2460,9324
2.78e+05,2014,237,3,1,860,7632,1,0,0,3,6,860,0,1920,1920,98166,47.462,122.34,890,7632,94,0,4,1750,8492
8.3155e+05,2014,232,5,2.75,3010,4919,2,0,0,3,9,3010,0,2014,2014,98074,47.607,122.05,3230,5415,0,0,7.75,6240,8425
4.7398e+05,2015,387,3,2.5,2330,3610,2,0,0,3,8,2330,0,1999,1999,98074,47.602,122.02,1830,2948,16,0,5.5,4160,5278
5e+05,2014,152,3,2,1720,5525,1,0,2,5,7,960,760,1941,1941,98108,47.559,122.3,1760,5525,73,0,5,3480,7245
8.985e+05,2014,214,4,2.75,2890,5000,1,0,0,3,8,1990,900,1911,2014,98117,47.677,122.36,1080,3750,103,1,6.75,3970,6640
2.79e+05,2014,215,3,1,1400,9450,1,0,0,4,7,1060,340,1955,1955,98056,47.505,122.19,1400,8108,59,0,4,2800,9508
7e+05,2014,182,3,2.5,2490,23891,2,0,0,3,9,2490,0,1993,1993,98053,47.672,122.03,2900,34705,21,0,5.5,5390,37195
3.559e+05,2015,484,3,2.5,2090,3821,2,0,0,3,7,2090,0,2008,2008,98038,47.365,122.02,2040,4200,7,0,5.5,4130,6290
5.63e+05,2014,326,3,2,1580,5289,1,0,0,3,7,870,710,1940,1940,98103,47.688,122.34,1310,5535,74,0,5,2890,7115
8.4e+05,2014,231,4,2.5,3730,9847,2,0,0,3,10,3730,0,1997,1997,98075,47.587,121.98,3490,10219,17,0,6.5,7220,13949
3.675e+05,2014,126,3,1.5,1410,9647,1,0,0,3,8,1410,0,1961,1961,98177,47.761,122.36,2090,9272,53,0,4.5,3500,10682
3.85e+05,2014,140,3,1.5,1490,9630,1,0,0,4,8,1490,0,1959,1959,98028,47.762,122.26,1960,10469,55,0,4.5,3450,11959
2.52e+05,2014,232,3,2.25,1570,8410,1,0,0,3,7,1180,390,1991,1991,98022,47.194,121.99,1540,8410,23,0,5.25,3110,9980
6.55e+05,2014,150,4,2.25,2060,8470,1,0,0,3,8,1440,620,1983,1983,98006,47.56,122.12,2180,8978,31,0,6.25,4240,11038
8.225e+05,2014,163,5,3.5,2320,4960,2,0,0,5,7,1720,600,1926,1926,98103,47.676,122.35,1700,4960,88,0,8.5,4020,7280
2.4e+05,2015,472,3,1.75,1540,6687,1,0,0,3,7,1200,340,1991,1991,98022,47.194,121.98,1540,7242,24,0,4.75,3080,8782
3.57e+05,2014,238,5,2.5,2990,9240,2,0,0,3,8,2990,0,2015,2015,98133,47.738,122.35,1970,18110,-1,0,7.5,4960,21100
4.0719e+05,2014,307,3,1.75,1860,48076,1,0,0,4,8,1860,0,1929,1929,98070,47.505,122.46,1410,23066,85,0,4.75,3270,24926
3.94e+05,2015,465,3,2.5,2550,5349,2,0,0,3,7,2550,0,2004,2004,98038,47.35,122.03,2640,5400,11,0,5.5,5190,7950
5.95e+05,2014,334,2,2,1510,4000,1,0,0,4,7,1010,500,1900,1900,98103,47.658,122.34,1920,4000,114,0,4,3430,5510
2.89e+05,2014,262,3,2.25,1670,6600,2,0,0,4,7,1670,0,1990,1990,98042,47.36,122.09,1670,6801,24,0,5.25,3340,8471
1.65e+05,2014,273,3,1.5,1020,10152,1,0,0,5,6,1020,0,1959,1959,98056,47.497,122.17,1320,8892,55,0,4.5,2340,9912
6.5e+05,2014,230,3,2.5,3060,7831,2,0,2,3,9,3060,0,2004,2004,98065,47.54,121.86,3140,7438,10,0,5.5,6200,10498
2.8e+05,2014,147,3,1,1200,6250,1,0,0,3,6,920,280,1943,1943,98168,47.51,122.33,1280,9375,71,0,4,2480,10575
5.05e+05,2015,450,2,2.5,1900,5065,2,0,0,3,8,1900,0,2005,2005,98053,47.718,122.03,1350,4664,10,0,4.5,3250,6564
3.19e+05,2014,191,3,1.5,1480,1722,3,0,0,3,7,1480,0,2007,2007,98125,47.728,122.29,1480,5764,7,0,4.5,2960,7244
4.3e+05,2014,313,3,2.5,2030,7770,2,0,0,3,8,2030,0,2003,2003,98024,47.525,121.93,1360,10782,11,0,5.5,3390,12812
3.875e+05,2014,284,3,3.25,1860,2218,3,0,0,3,8,1860,0,2001,2001,98125,47.718,122.31,1860,2218,13,0,6.25,3720,4078
4.08e+05,2014,201,3,2,1640,3440,2,0,0,3,7,1640,0,1987,1987,98052,47.683,122.1,1070,3549,27,0,5,2710,5189
2.7e+05,2014,298,3,2,1510,10215,1,0,0,4,7,1510,0,1995,1995,98022,47.208,122,1370,8902,19,0,5,2880,10412
2.7e+05,2014,152,4,2.5,1920,8497,2,0,0,3,8,1920,0,1998,1998,98092,47.261,122.21,1940,8436,16,0,6.5,3860,10356
5.8e+05,2014,163,3,2.5,2040,4627,2,0,0,3,8,2040,0,1992,1992,98052,47.636,122.11,2230,4500,22,0,5.5,4270,6540
3.7e+05,2014,201,3,2.5,1650,1793,3,0,0,3,8,1650,0,2007,2007,98133,47.711,122.33,1650,1863,7,0,5.5,3300,3513
4.41e+05,2015,373,3,2.5,2740,7923,2,0,0,3,9,2740,0,1998,1998,98058,47.435,122.11,2740,8815,17,0,5.5,5480,11555
6.4e+05,2014,237,4,1.75,2020,16120,1,0,0,3,7,2020,0,1969,1969,98010,47.341,122.05,1940,16350,45,0,5.75,3960,18370
5.72e+05,2014,272,4,2.75,2770,3852,2,0,0,3,8,2770,0,2014,2014,98178,47.5,122.23,1810,5641,0,0,6.75,4580,8411
3.5995e+05,2014,211,4,2.5,3010,5701,2,0,0,3,8,3010,0,2003,2003,98042,47.349,122.15,3010,5772,11,0,6.5,6020,8782
8.47e+05,2015,445,6,2.5,3010,17864,2,0,0,3,8,3010,0,1969,1969,98177,47.721,122.37,2560,11532,46,0,8.5,5570,14542
6.82e+05,2014,238,4,2.5,3030,30000,2,0,0,4,9,3030,0,1981,1981,98072,47.747,122.11,2600,34932,33,0,6.5,5630,37962
4.25e+05,2015,423,2,1.75,1550,7800,1,0,0,3,7,1050,500,1940,1940,98136,47.544,122.39,1370,5000,75,0,3.75,2920,6550
4.11e+05,2014,182,4,2,2370,76665,2,0,0,4,8,2370,0,1978,1978,98001,47.283,122.28,2110,19334,36,0,6,4480,21704
2.192e+05,2014,361,3,2,1680,7000,1,0,0,4,7,1680,0,1968,1968,98002,47.278,122.2,1540,7480,46,0,5,3220,9160
6.75e+05,2014,126,2,1,930,36478,1,0,2,3,6,930,0,1951,1951,98006,47.57,122.16,2800,11141,63,0,3,3730,12071
4.25e+05,2014,313,2,1,790,5024,1,0,0,4,7,790,0,1941,1941,98117,47.683,122.39,1330,5024,73,0,3,2120,5814
4.5e+05,2015,410,4,1.75,2190,9752,1,0,0,3,8,2190,0,1964,1964,98034,47.711,122.24,2040,9964,51,0,5.75,4230,12154
3.9995e+05,2015,464,4,2.5,3110,5868,2,0,0,3,8,3110,0,2001,2001,98042,47.378,122.13,2950,5924,14,0,6.5,6060,9034
5.85e+05,2015,436,3,2.5,2060,10839,2,0,0,3,8,2060,0,1987,1987,98029,47.568,122.02,2180,8126,28,0,5.5,4240,10186
4.75e+05,2014,280,4,3.5,3660,14401,2,0,0,3,10,2660,1000,1994,1994,98023,47.308,122.4,2780,10653,20,0,7.5,6440,14313
5.6e+05,2014,305,3,2.5,2280,12498,2,0,0,4,9,2280,0,1987,1987,98029,47.569,122.01,2330,8844,27,0,5.5,4610,11124
1.58e+06,2015,437,4,2.75,3120,20031,1,0,2,4,9,1980,1140,1954,1997,98040,47.539,122.24,3330,18777,61,1,6.75,6450,21897
4.876e+05,2015,450,4,2.5,2340,12080,2,0,0,3,8,2340,0,1999,1999,98019,47.733,121.97,2200,12403,16,0,6.5,4540,14743
5.5e+05,2015,453,4,2.75,1800,7750,1,0,0,4,8,1400,400,1965,1965,98177,47.778,122.38,1800,8275,50,0,6.75,3600,10075
3.48e+05,2014,190,3,2.5,1500,2255,2,0,0,3,7,1500,0,2005,2005,98029,47.554,122,1440,2040,9,0,5.5,2940,3540
5.5e+05,2015,426,3,2.5,1740,3082,2,0,0,3,8,1740,0,2000,2000,98029,47.549,122.01,1910,3075,15,0,5.5,3650,4815
2.435e+05,2014,263,4,2.5,2300,15188,2,0,0,4,7,2300,0,1966,1966,98042,47.368,122.16,1820,10125,48,0,6.5,4120,12425
8.275e+05,2014,333,3,2.5,1810,7200,1,0,0,5,7,1310,500,1960,1960,98033,47.688,122.21,2050,7200,54,0,5.5,3860,9010
4.065e+05,2014,194,2,1.75,1510,5319,2,0,0,4,8,1510,0,1978,1978,98052,47.665,122.13,1740,6160,36,0,3.75,3250,7670
5.6375e+05,2015,470,4,2.75,2690,25000,1,0,0,3,8,1750,940,1978,1978,98029,47.554,122.03,2640,28250,37,0,6.75,5330,30940
2.75e+05,2015,407,2,1,840,4000,1,0,0,3,6,840,0,1942,1942,98108,47.553,122.31,1100,4000,73,0,3,1940,4840
6.2295e+05,2015,459,4,3.25,3030,7644,2,0,0,3,8,2830,200,2006,2006,98065,47.546,121.88,3400,6908,9,0,7.25,6430,9938
3.03e+05,2014,342,3,2.5,2056,3564,2,0,0,3,7,2056,0,2014,2014,98092,47.338,122.18,2056,3577,0,0,5.5,4112,5633
3.88e+05,2014,143,4,2.5,2440,7155,2,0,0,3,8,2440,0,1993,1993,98058,47.45,122.13,2450,8109,21,0,6.5,4890,10549
5.72e+05,2014,196,5,2.25,2340,9225,2,0,0,3,8,2340,0,1973,1973,98052,47.637,122.1,2140,9348,41,0,7.25,4480,11688
5.1e+05,2015,484,4,2,2210,5572,1,0,3,3,7,1760,450,1911,1911,98126,47.573,122.38,1760,4713,104,0,6,3970,6923
3.3989e+05,2014,304,4,1.75,1440,6144,1,0,0,5,6,720,720,1947,1947,98106,47.526,122.36,960,5160,67,0,5.75,2400,6600
7.135e+05,2014,331,5,2.75,2920,9163,1,0,0,4,8,1520,1400,1976,1976,98006,47.567,122.17,2250,9163,38,0,7.75,5170,12083
2.127e+05,2014,177,2,1,940,5040,1,0,0,3,7,940,0,1926,1926,98126,47.538,122.37,940,5040,88,0,3,1880,5980
5.07e+05,2014,168,5,3.25,3850,16249,2,0,2,3,9,3030,820,2002,2002,98092,47.332,122.17,2640,7393,12,0,8.25,6490,11243
9.03e+05,2014,301,3,2.75,3860,12786,2,0,0,4,10,3860,0,1984,1984,98006,47.549,122.14,2820,14636,30,0,5.75,6680,18496
7.34e+05,2015,423,4,2.5,2180,7204,2,0,0,3,8,2180,0,2014,2014,98133,47.722,122.35,1500,7650,1,0,6.5,3680,9830
9.97e+05,2015,418,4,3.5,3430,13609,2,0,0,3,11,3430,0,2001,2001,98059,47.52,122.15,3880,11614,14,0,7.5,7310,15044
2.485e+05,2014,246,3,1.75,2090,12026,1,0,0,4,7,2090,0,1948,1948,98002,47.309,122.22,1700,9496,66,0,4.75,3790,11586
9.75e+05,2014,141,5,4,4850,36450,2,0,0,3,10,4850,0,1977,1977,98005,47.643,122.16,3850,35325,37,0,9,8700,40175
2.65e+05,2014,147,3,2.5,1440,7741,1,0,0,4,7,1000,440,1983,1983,98031,47.404,122.19,1680,7316,31,0,5.5,3120,8756
6.01e+05,2014,292,3,2.5,1740,1251,2,0,0,3,9,1180,560,2012,2012,98199,47.644,122.39,1740,1625,2,0,5.5,3480,3365
7.3169e+05,2014,201,4,3,2630,5772,2,0,0,3,9,2630,0,2006,2006,98052,47.695,122.13,3460,6158,8,0,7,6090,8788
3.8e+05,2015,438,3,2.5,1880,6047,2,0,0,3,8,1880,0,1993,1993,98038,47.372,122.04,2120,7188,22,0,5.5,4000,9068
3.4e+05,2014,290,4,2.5,2441,7316,2,0,0,3,8,2441,0,2007,2007,98023,47.324,122.34,2724,7357,7,0,6.5,5165,9798
1.05e+06,2014,297,5,3.25,4240,9588,2,0,0,3,9,4240,0,2014,2014,98053,47.69,122.02,4080,8425,0,0,8.25,8320,12665
2.12e+05,2015,381,2,1,1070,7386,1,0,0,3,6,1070,0,1949,1949,98108,47.543,122.3,1330,6351,66,0,3,2400,7421
2.025e+05,2014,287,3,1,1120,8576,1,0,0,3,6,1120,0,1943,1943,98178,47.49,122.25,1050,8812,71,0,4,2170,9932
6.3e+05,2015,477,3,1.75,1940,7306,1,0,0,3,8,1470,470,1982,1982,98052,47.663,122.15,2360,8865,33,0,4.75,4300,10805
1.85e+06,2014,288,5,3.25,3680,6060,2,0,0,5,9,2630,1050,1925,1925,98112,47.634,122.3,3050,5850,89,0,8.25,6730,9530
4.11e+05,2014,208,2,2.5,1590,2088,2,0,0,3,9,1590,0,1997,1997,98033,47.69,122.17,2320,3174,17,0,4.5,3910,4764
1.75e+05,2014,331,3,1.5,1390,1882,2,0,0,3,7,1390,0,2014,2014,98108,47.567,122.3,1490,2175,0,0,4.5,2880,3565
4.4e+05,2015,463,3,1.75,1530,7245,1,0,0,4,7,1530,0,1984,1984,98034,47.731,122.19,1530,7490,31,0,4.75,3060,9020
5.982e+05,2015,487,5,3.75,2980,4635,3,0,0,3,8,2980,0,1997,1997,98118,47.551,122.27,1100,5150,18,0,8.75,4080,8130
4.1e+05,2014,264,2,1.5,1660,4000,1,0,0,3,7,1000,660,1950,1950,98115,47.683,122.3,1570,5500,64,0,3.5,3230,7160
3.1e+05,2014,223,4,1.75,1880,12150,1,0,0,3,7,1280,600,1976,1976,98023,47.327,122.36,1980,9680,38,0,5.75,3860,11560
1.882e+05,2015,470,3,1,1260,7265,1,0,0,4,7,1260,0,1954,1954,98002,47.298,122.22,940,7200,61,0,4,2200,8460
6.2525e+05,2015,410,4,2.5,2755,4831,2,0,0,3,7,2755,0,2003,2003,98053,47.685,122.04,2510,4831,12,0,6.5,5265,7586
2.6e+05,2015,414,3,2.5,1600,2244,2,0,0,3,7,1600,0,2005,2005,98056,47.49,122.16,1600,1700,10,0,5.5,3200,3300
1.78e+05,2014,195,3,1,840,6500,1,0,0,5,6,840,0,1969,1969,98042,47.37,122.08,870,5200,45,0,4,1710,6040
3.75e+05,2014,215,3,1.5,1190,20672,1,0,3,3,7,1190,0,1948,1948,98166,47.446,122.36,2150,16239,66,0,4.5,3340,17429
2.16e+05,2014,236,2,1,860,9000,1,0,0,4,6,860,0,1942,1942,98168,47.48,122.31,990,9975,72,0,3,1850,10835
1.15e+06,2014,276,6,3.75,4090,49542,2,0,0,3,9,3100,990,1984,1984,98005,47.641,122.15,2980,43357,30,0,9.75,7070,47447
1.8375e+05,2015,432,5,2.75,1650,5453,1,0,0,3,7,1650,0,1970,1970,98118,47.529,122.28,1670,5885,45,0,7.75,3320,7535
1.145e+06,2014,339,4,2.25,2840,20242,1,0,0,3,8,2240,600,1972,1972,98004,47.639,122.22,2840,20372,42,0,6.25,5680,23212
2.25e+05,2014,259,3,1,1290,8470,1,0,0,4,7,970,320,1966,1966,98023,47.305,122.37,1300,7350,48,0,4,2590,8640
2.85e+05,2014,265,3,2.5,1800,2516,2,0,0,3,7,1800,0,2001,2001,98108,47.54,122.29,1800,2562,13,0,5.5,3600,4362
5e+05,2015,451,2,1,1630,12059,1,0,0,3,7,1270,360,1947,1947,98125,47.723,122.31,1660,8800,68,0,3,3290,10430
3.99e+05,2014,311,3,1.75,1170,8148,1,0,0,3,7,1170,0,1952,1952,98155,47.748,122.32,1200,8147,62,0,4.75,2370,9317
5e+05,2014,235,2,1,960,5000,1,0,0,4,7,960,0,1900,1900,98107,47.675,122.37,1330,5000,114,0,3,2290,5960
4.15e+05,2014,154,4,2.5,2000,5962,2,0,0,3,8,2000,0,1999,1999,98133,47.77,122.35,1790,10500,15,0,6.5,3790,12500
4.27e+05,2015,381,3,2.5,3192,5653,2,0,0,3,8,3192,0,2014,2014,98023,47.296,122.35,3000,5134,1,0,5.5,6192,8326
4.29e+05,2014,341,4,1,1350,3333,1,0,0,3,7,1350,0,1912,1912,98107,47.673,122.4,1530,5000,102,0,5,2880,6350
3.2995e+05,2014,237,4,1,1360,5900,1,0,0,4,7,1360,0,1949,1949,98155,47.751,122.32,1050,5900,65,0,5,2410,7260
5.81e+05,2014,133,4,1.75,2090,8164,1,0,0,4,8,1070,1020,1963,1963,98052,47.672,122.16,1310,7975,51,0,5.75,3400,10065
4.6e+05,2014,129,4,1.75,1750,5500,1,0,0,5,7,1050,700,1926,1926,98117,47.68,122.39,1640,5500,88,0,5.75,3390,7250
8.5e+05,2014,258,3,2.5,3260,91911,2,0,0,4,9,3260,0,1984,1984,98077,47.737,122.07,2520,65775,30,0,5.5,5780,69035
4.25e+05,2014,215,4,2.5,2070,4427,2,0,0,3,7,2070,0,2007,2007,98065,47.521,121.87,2070,4556,7,0,6.5,4140,6626
2.05e+06,2015,493,5,3,3830,8480,2,0,1,5,9,2630,1200,1905,1994,98122,47.617,122.29,3050,7556,110,1,8,6880,11386
3.75e+05,2015,451,3,2.5,2424,5931,2,0,0,3,9,2424,0,2014,2014,98042,47.352,122.13,2424,6036,1,0,5.5,4848,8460
4.02e+05,2014,211,4,1.75,2430,5481,1,0,0,3,8,1430,1000,1953,1953,98108,47.557,122.3,2050,5508,61,0,5.75,4480,7938
2.4e+05,2014,265,4,1.75,1880,9600,1,0,0,5,7,1020,860,1946,1946,98001,47.263,122.28,1560,14400,68,0,5.75,3440,16280
1.629e+06,2015,366,5,2.5,3090,16583,2,0,0,4,9,3090,0,1964,1964,98004,47.646,122.22,3740,17853,51,0,7.5,6830,20943
3.3e+05,2015,416,5,2.5,2620,12763,1,0,0,3,7,1400,1220,1979,1979,98034,47.72,122.21,2390,9156,36,0,7.5,5010,11776
4.4e+05,2014,268,4,2.5,2230,5650,2,0,0,3,7,2230,0,2011,2011,98056,47.507,122.17,1590,7241,3,0,6.5,3820,9471
2.95e+05,2015,417,4,1.75,1400,11934,1,0,0,3,7,1050,350,1961,1961,98028,47.735,122.24,2080,10400,54,0,5.75,3480,11800
2.072e+05,2014,264,4,2,1260,8400,1,0,0,3,6,1260,0,1991,1991,98022,47.195,122,1120,8400,23,0,6,2380,9660
6.37e+05,2014,196,5,3,2460,7240,1,0,0,3,9,1840,620,1991,1991,98006,47.549,122.19,2530,7885,23,0,8,4990,10345
4e+05,2014,313,2,2.5,1340,1240,2,0,0,3,8,1150,190,2008,2008,98052,47.686,122.1,1280,1312,6,0,4.5,2620,2652
1.88e+06,2014,216,5,3.5,4390,6220,2,0,3,3,9,3170,1220,2013,2013,98115,47.679,122.27,2740,6448,1,0,8.5,7130,10838
3.75e+05,2015,392,3,2,1260,7560,2,0,0,5,6,1260,0,1943,1943,98133,47.722,122.35,1260,7595,72,0,5,2520,8855
8.55e+05,2014,227,4,2.5,2810,52062,1,0,0,4,9,2810,0,1988,1988,98075,47.594,122.03,3330,49783,26,0,6.5,6140,52593
1.01e+06,2014,310,4,1,1820,5400,1,0,0,3,8,1820,0,1923,2014,98102,47.648,122.32,1820,5400,91,1,5,3640,7220
9.218e+05,2014,238,4,2.5,2950,7024,2,0,0,3,10,2950,0,2012,2012,98199,47.665,122.4,2950,6339,2,0,6.5,5900,9289
7.5e+05,2014,203,2,2.5,2630,7957,2,0,0,3,8,2630,0,2003,2003,98053,47.711,122.02,2305,7220,11,0,4.5,4935,9850
5.9e+05,2014,259,3,2,3030,9374,1,0,1,4,7,2100,930,1959,1959,98136,47.529,122.39,1990,6012,55,0,5,5020,9042
2.835e+05,2014,222,4,2.25,2100,8050,2,0,0,3,8,2100,0,1978,1978,98055,47.439,122.19,2190,7700,36,0,6.25,4290,9800
3.3e+05,2014,347,3,1,910,10240,1,0,0,4,6,910,0,1969,1969,98053,47.673,122.06,1140,10720,45,0,4,2050,11630
3.8e+05,2014,142,5,3.5,2420,4670,2,0,0,3,7,2420,0,2013,2013,98118,47.524,122.28,1430,4468,1,0,8.5,3850,6888
3.675e+05,2014,174,3,1,1660,11783,1,0,0,4,7,1160,500,1978,1978,98077,47.756,122.08,1320,10541,36,0,4,2980,12201
3.75e+05,2014,224,4,2.5,2310,7800,2,0,0,3,8,2310,0,2011,2011,98042,47.374,122.16,2310,7140,3,0,6.5,4620,9450
5.75e+05,2014,153,4,2.75,3120,7644,2,0,0,3,10,3120,0,2010,2010,98065,47.516,121.88,2980,6050,4,0,6.75,6100,9170
1.925e+05,2014,140,2,1,950,7692,1,0,0,3,6,950,0,1926,1926,98168,47.491,122.3,1820,8221,88,0,3,2770,9171
1.6e+06,2014,271,4,2.75,3680,5000,2,0,3,3,9,2480,1200,1936,1936,98105,47.66,122.27,3200,5000,78,0,6.75,6880,8680
2.41e+05,2014,139,2,2,1470,3128,2,0,0,3,6,1470,0,2005,2005,98038,47.349,122.02,1180,2576,9,0,4,2650,4046
7.2513e+05,2014,126,4,2.5,3200,12369,2,0,0,3,10,3200,0,1998,1998,98059,47.527,122.14,3770,12960,16,0,6.5,6970,16160
4.375e+05,2014,325,3,2,1760,2875,2,0,2,3,7,1290,470,1988,1988,98126,47.56,122.38,1760,4830,26,0,5,3520,6590
4.1e+05,2014,251,4,2.25,2150,27345,2,0,0,5,8,2150,0,1976,1976,98059,47.469,122.12,2200,11923,38,0,6.25,4350,14073
5.8544e+05,2015,453,6,3.75,2740,6924,1,0,2,3,7,1640,1100,1962,1962,98144,47.582,122.3,1940,6000,53,0,9.75,4680,8740
8.35e+05,2014,156,2,2,2280,6815,1,0,0,3,8,2280,0,2002,2002,98053,47.71,122.03,2280,6750,12,0,4,4560,9030
5.05e+05,2014,132,4,2.5,2780,6369,1,0,0,3,8,1590,1190,1978,1978,98034,47.728,122.22,2170,7490,36,0,6.5,4950,10270
5.8e+05,2014,152,4,2.5,2220,7064,2,0,0,3,8,2220,0,1988,1988,98029,47.572,122.02,2220,7451,26,0,6.5,4440,9671
2.435e+05,2014,340,4,2,1610,6200,1,0,0,4,7,1610,0,1979,1979,98198,47.383,122.31,1610,7500,35,0,6,3220,9110
2.43e+05,2015,424,3,1,1480,15416,1,0,2,4,8,1480,0,1955,1955,98022,47.214,121.99,1190,10758,60,0,4,2670,12238
3.75e+05,2014,250,3,1.5,1630,16170,1,0,0,3,7,1630,0,1988,1988,98034,47.71,122.23,1630,9931,26,0,4.5,3260,11561
4.5e+05,2014,273,3,1.75,2290,44866,1,0,0,3,8,1390,900,1981,1981,98077,47.74,122.04,2410,44866,33,0,4.75,4700,47156
5.8e+05,2014,204,4,2.75,3210,6825,1,0,0,5,7,1810,1400,1975,1975,98034,47.734,122.17,1840,8000,39,0,6.75,5050,11210
2.3e+05,2014,242,3,1,1120,7500,1,0,0,3,7,1120,0,1965,1965,98146,47.511,122.36,1120,5000,49,0,4,2240,6120
5.325e+05,2015,424,3,3.25,3140,37120,1,0,0,3,9,1760,1380,1984,1984,98065,47.524,121.84,2100,13500,31,0,6.25,5240,16640
5.75e+05,2015,410,4,2.5,2280,9491,1,0,0,4,7,1290,990,1966,1966,98008,47.63,122.12,1560,8050,49,0,6.5,3840,10330
3.2e+05,2014,211,4,1.5,1100,11824,1,0,0,4,7,1100,0,1954,1954,98006,47.57,122.14,1380,11796,60,0,5.5,2480,12896
4.7e+05,2015,414,6,1.75,2490,8732,1,0,0,4,8,2490,0,1966,1966,98034,47.725,122.19,1840,8024,49,0,7.75,4330,10514
4.35e+05,2014,252,3,2.5,1730,4065,2,0,0,3,8,1730,0,1996,1996,98029,47.567,122,1730,4094,18,0,5.5,3460,5824
6.65e+05,2014,255,4,2.5,2080,8100,1,0,2,5,8,1220,860,1952,1952,98177,47.723,122.37,2090,8100,62,0,6.5,4170,10180
5.925e+05,2015,392,6,4.5,3500,8504,2,0,0,3,7,3500,0,1980,1980,98155,47.735,122.3,1550,8460,35,0,10.5,5050,11960
3.74e+05,2014,150,3,1,1200,9800,1,0,0,4,7,1200,0,1971,1971,98072,47.741,122.11,1220,10220,43,0,4,2420,11420
7.25e+05,2015,494,4,1.75,1980,5850,1,0,1,4,8,1380,600,1960,1960,98116,47.561,122.39,1810,5850,55,0,5.75,3790,7830
6.5e+05,2015,440,3,2.5,2180,37042,2,0,0,3,9,2180,0,1998,1998,98077,47.722,122.03,2880,32688,17,0,5.5,5060,34868
6.25e+05,2015,389,3,1,1020,7650,1,0,0,3,6,1020,0,1919,1919,98033,47.679,122.2,1870,5500,96,0,4,2890,6520
6.45e+05,2015,477,3,3.25,3870,11000,2,0,2,3,9,2970,900,1991,1991,98106,47.554,122.35,2970,11000,24,0,6.25,6840,14870
3.7495e+05,2014,290,2,2.25,1240,1172,2,0,0,3,8,1000,240,2008,2008,98144,47.588,122.32,1260,1111,6,0,4.25,2500,2351
3.59e+05,2014,333,4,1,2180,10617,1,0,0,3,7,2180,0,1950,1950,98155,47.752,122.31,1360,9519,64,0,5,3540,11699
6.76e+05,2014,229,4,2.5,2800,5368,2,0,0,3,8,2800,0,2003,2003,98074,47.608,122.05,2790,5368,11,0,6.5,5590,8168
1.195e+06,2014,188,4,3.5,3960,6654,2,0,0,3,10,2850,1110,2006,2006,98199,47.646,122.39,2840,6400,8,0,7.5,6800,10360
2.93e+05,2014,188,3,2.25,1910,3481,2,0,0,3,8,1910,0,2009,2009,98055,47.429,122.19,1714,3177,5,0,5.25,3624,5087
1.75e+05,2014,263,4,1,1210,6250,1,0,0,3,7,1210,0,1962,1962,98168,47.501,122.33,1210,8291,52,0,5,2420,9501
7.2e+05,2014,229,3,2.25,2120,9297,2,0,0,4,8,2120,0,1981,1981,98006,47.556,122.15,2620,10352,33,0,5.25,4740,12472
1.3e+06,2014,182,4,1.75,2610,21600,1,0,0,4,8,2610,0,1966,1966,98004,47.624,122.23,2920,20330,48,0,5.75,5530,22940
2.43e+05,2014,140,2,1,1770,5522,1,0,0,4,7,960,810,1943,1943,98178,47.497,122.23,1830,7378,71,0,3,3600,9148
2.27e+05,2014,333,3,1,1340,10035,1,0,0,3,7,1340,0,1959,1959,98178,47.492,122.25,2090,10035,55,0,4,3430,11375
7.8e+05,2014,170,3,2.25,2140,3000,2,0,0,3,9,2140,0,1905,2006,98103,47.677,122.35,1430,4712,109,1,5.25,3570,6852
3.45e+05,2014,258,2,1,1130,8081,1,0,0,4,7,1130,0,1921,1921,98133,47.706,122.36,1220,7800,93,0,3,2350,8930
6.55e+05,2014,141,4,3.5,2350,13402,2,0,3,3,8,1670,680,1994,1994,98033,47.695,122.19,2250,9474,20,0,7.5,4600,11824
7.2e+05,2014,169,4,2.5,2440,34290,2,0,0,3,9,2440,0,1987,1987,98053,47.669,122.04,2860,38119,27,0,6.5,5300,40559
3.245e+05,2015,437,3,1.75,1920,11340,1,0,0,4,7,1230,690,1977,1977,98023,47.327,122.36,1980,9638,38,0,4.75,3900,11558
3.3222e+05,2014,265,3,1.5,2580,47480,1,0,0,3,7,1360,1220,1953,1953,98024,47.533,121.93,1760,48181,61,0,4.5,4340,50761
2.37e+05,2014,243,3,2.5,1490,2138,2,0,0,3,7,1490,0,2005,2005,98055,47.432,122.2,1490,2094,9,0,5.5,2980,3584
6e+05,2015,477,4,1.75,3050,9440,1,0,0,3,8,1800,1250,1966,1966,98034,47.723,122.18,2020,8660,49,0,5.75,5070,11710
3.552e+05,2015,457,3,1,1120,7320,1,0,0,4,7,1120,0,1954,1954,98146,47.51,122.38,1410,6328,61,0,4,2530,7448
2.65e+05,2014,179,3,1,1800,7650,1,0,0,5,7,1800,0,1957,1957,98056,47.492,122.18,1230,7650,57,0,4,3030,9450
5.33e+05,2014,217,4,1,1550,4750,1,0,0,3,7,1550,0,1919,1919,98117,47.682,122.39,1320,4750,95,0,5,2870,6300
4.48e+05,2014,195,2,1,1110,5413,1,0,0,3,6,890,220,1937,1937,98115,47.693,122.32,1300,5413,77,0,3,2410,6523
3.23e+05,2015,451,3,1.5,1720,7110,1,0,0,3,8,1720,0,1955,1955,98106,47.542,122.36,1730,6840,60,0,4.5,3450,8560
7.75e+05,2014,201,3,2.5,2890,8470,2,0,0,3,10,2890,0,1996,1996,98075,47.578,122.05,3000,8879,18,0,5.5,5890,11769
5.65e+05,2015,415,3,2.75,3210,15939,2,0,1,3,10,3210,0,1998,1998,98023,47.336,122.35,2870,15939,17,0,5.75,6080,19149
1.68e+06,2014,271,5,3.5,5170,7197,3,1,4,3,11,3520,1650,1998,1998,98155,47.756,122.27,3020,12880,16,0,8.5,8190,18050
1.051e+06,2014,142,4,3.75,3860,5474,2,0,0,3,10,3860,0,2007,2007,98029,47.54,122,3040,5474,7,0,7.75,6900,9334
3.435e+05,2014,262,3,2.5,1900,5194,2,0,0,3,7,1900,0,2004,2004,98058,47.439,122.12,2230,5194,10,0,5.5,4130,7094
3.96e+05,2014,255,3,1.75,2340,5668,1,0,0,4,6,1200,1140,1941,1941,98106,47.559,122.36,860,4800,73,0,4.75,3200,7140
5.9e+05,2014,148,3,2,1650,6150,2,0,0,4,7,1650,0,1926,1993,98116,47.571,122.39,1280,6150,88,1,5,2930,7800
1.7e+05,2015,386,2,1,860,8636,1,0,0,3,6,860,0,1924,1924,98146,47.508,122.36,1100,8636,91,0,3,1960,9496
9.27e+05,2014,132,4,2.75,3300,12090,2,0,0,3,8,3300,0,1953,1953,98004,47.629,122.22,3180,12239,61,0,6.75,6480,15539
7.875e+05,2014,242,2,2.5,2390,6928,2,0,3,4,8,1810,580,1949,1982,98146,47.51,122.39,2390,12852,65,1,4.5,4780,15242
4.485e+05,2014,236,3,1.75,1300,4800,2,0,1,4,7,1300,0,1912,1912,98136,47.546,122.38,1300,4800,102,0,4.75,2600,6100
3.35e+05,2015,478,4,2.25,3220,7889,2,0,0,3,8,3220,0,1978,1978,98023,47.311,122.34,2120,7651,37,0,6.25,5340,10871
1.208e+06,2015,478,4,3.75,3250,10949,2,0,0,4,9,2940,310,1930,1989,98004,47.639,122.22,2340,15234,85,1,7.75,5590,18484
3.2495e+05,2014,174,3,1.5,1460,8710,1,0,0,3,7,1460,0,1955,1955,98166,47.456,122.36,1400,8645,59,0,4.5,2860,10105
3.7e+05,2014,354,3,1,940,7910,1,0,0,4,6,940,0,1959,1959,98008,47.618,122.12,1000,7700,55,0,4,1940,8640
4.9999e+05,2015,460,3,1.75,1630,8400,1,0,0,4,7,1060,570,1955,1955,98007,47.598,122.15,1630,7245,60,0,4.75,3260,8875
3.725e+05,2014,140,4,1.75,1590,10523,2,0,0,4,7,1590,0,1922,1922,98133,47.736,122.34,1610,8568,92,0,5.75,3200,10158
2.595e+05,2015,445,3,2.25,1490,7589,2,0,0,3,7,1490,0,1993,1993,98038,47.347,122.04,1510,6603,22,0,5.25,3000,8093
3.6e+05,2014,196,3,1.75,1520,12282,1,0,0,3,8,1220,300,1978,1978,98155,47.752,122.3,1860,13500,36,0,4.75,3380,15020
4.299e+05,2014,273,4,3.5,2584,5005,2,0,0,3,8,2584,0,2014,2014,98023,47.296,122.35,2767,5201,0,0,7.5,5351,7785
2.485e+05,2015,417,3,2,1240,12285,1,0,0,3,7,620,620,1939,1991,98023,47.322,122.34,1560,11564,76,1,5,2800,12804
3.9e+05,2014,203,4,2.5,1890,15770,2,0,0,4,7,1890,0,1968,1968,98166,47.428,122.34,2410,15256,46,0,6.5,4300,17146
6.95e+05,2015,471,4,2.5,2830,14538,2,0,0,3,8,2830,0,2003,2003,98065,47.541,121.88,2270,6939,12,0,6.5,5100,9769
3.895e+05,2014,196,3,2.5,1350,874,3,0,0,3,8,1270,80,2006,2006,98136,47.549,122.39,1350,886,8,0,5.5,2700,2236
2.49e+05,2014,169,3,1,1050,8498,1,0,0,4,7,1050,0,1959,1959,98031,47.404,122.2,1050,8498,55,0,4,2100,9548
6.95e+05,2014,230,4,2.5,2650,9990,2,0,0,3,10,2650,0,1990,1990,98029,47.56,122.02,2710,8012,24,0,6.5,5360,10662
1.58e+06,2014,126,4,3.25,3760,10920,1,0,0,5,9,2400,1360,1950,1950,98105,47.669,122.26,3430,11050,64,0,7.25,7190,14810
5.359e+05,2015,429,3,2.25,1880,10880,1,0,0,3,8,1480,400,1975,1975,98008,47.594,122.12,2120,10240,40,0,5.25,4000,12120
4.17e+05,2014,177,4,2.25,2300,7700,1,0,0,3,7,1380,920,1959,1959,98125,47.714,122.32,2010,8820,55,0,6.25,4310,11120
7.8e+05,2014,262,2,3.25,3000,24004,1,0,0,3,10,2410,590,1952,1952,98005,47.611,122.16,4270,24506,62,0,5.25,7270,27506
2.1e+05,2015,444,3,1.5,1160,10125,1,0,0,4,7,1160,0,1959,1959,98059,47.492,122.15,1440,10018,56,0,4.5,2600,11178
4e+05,2015,417,3,2.5,1460,1319,3,0,0,3,8,1460,0,2002,2002,98103,47.698,122.35,1430,1530,13,0,5.5,2890,2990
3.05e+05,2015,470,4,2.25,2580,8820,1,0,0,4,9,1620,960,1967,1967,98023,47.312,122.38,2140,8400,48,0,6.25,4720,10980
5.2e+05,2014,154,3,3.25,1540,1487,2,0,0,3,8,1540,0,2011,2011,98027,47.54,122.03,1620,1104,3,0,6.25,3160,2644
5.9e+05,2015,456,5,1,1840,6710,1,0,0,3,7,1840,0,1920,1920,98126,47.569,122.38,1410,4880,95,0,6,3250,6720
1.9e+05,2015,416,3,1,1040,8910,1,0,0,3,6,1040,0,1943,1943,98168,47.502,122.32,1330,9720,72,0,4,2370,10760
6.4e+05,2014,290,4,2.5,3420,21344,2,0,0,3,9,3420,0,2002,2002,98166,47.45,122.33,2110,21344,12,0,6.5,5530,24764
5e+05,2014,235,4,2.25,1960,12436,2,0,0,3,8,1960,0,1984,1984,98074,47.628,122.04,1960,12436,30,0,6.25,3920,14396
6e+05,2015,424,3,1,1480,17360,1,0,1,3,8,1480,0,1954,1954,98136,47.518,122.39,2250,8720,61,0,4,3730,10200
6.35e+05,2015,456,2,2.5,1390,1132,2,0,0,3,8,1130,260,2006,2006,98102,47.623,122.32,1400,1237,9,0,4.5,2790,2627
5.99e+05,2014,305,5,3.25,2590,6180,1,0,0,3,7,1330,1260,1960,1960,98118,47.551,122.27,1560,6180,54,0,8.25,4150,8770
2.25e+05,2014,317,3,2.5,1590,8449,2,0,0,3,7,1590,0,1989,1989,98030,47.349,122.18,1750,7172,25,0,5.5,3340,8762
2.9995e+05,2014,299,3,1,1410,81021,1,0,0,3,7,1410,0,1949,1981,98058,47.43,122.07,2000,81021,65,1,4,3410,82431
5.4e+05,2015,484,3,1.75,2590,25992,1,0,0,3,8,1970,620,1968,1968,98029,47.552,122.03,2590,29250,47,0,4.75,5180,31840
3.5e+05,2014,230,2,1,800,5040,1,0,0,3,6,800,0,1960,1960,98117,47.695,122.36,1020,5040,54,0,3,1820,5840
4.55e+05,2014,211,3,1.75,1320,1014,3,0,0,3,9,1320,0,2015,2015,98122,47.605,122.31,1380,1495,-1,0,4.75,2700,2815
4e+05,2014,232,3,3,2090,7634,1,0,0,3,8,1450,640,2001,2001,98019,47.741,121.97,2090,9600,13,0,6,4180,11690
2.55e+05,2014,147,3,1,960,8100,1,0,0,3,7,960,0,1955,1955,98155,47.777,122.31,1120,8100,59,0,4,2080,9060
2.82e+05,2015,474,3,1,1250,13503,1,0,0,4,6,1250,0,1931,1931,98065,47.526,121.83,1450,13503,84,0,4,2700,14753
5.915e+05,2014,243,4,2.5,1690,4080,1,0,0,4,7,1140,550,1912,1912,98117,47.682,122.38,1600,4590,102,0,6.5,3290,6280
2.3e+05,2015,431,2,1,800,17965,1,0,0,4,5,800,0,1942,1942,98058,47.469,122.16,1500,8925,73,0,3,2300,9725
3.023e+05,2014,359,5,2.75,3130,9450,1,0,0,4,8,1580,1550,1973,1973,98023,47.31,122.38,1900,9000,41,0,7.75,5030,12130
6.1e+05,2014,242,4,2.75,2090,8400,1,0,0,4,8,1240,850,1976,1976,98052,47.687,122.12,2340,9000,38,0,6.75,4430,11090
1.06e+06,2014,236,4,3.75,3880,9979,2,0,0,3,10,3880,0,2007,2007,98029,47.541,121.99,3130,6112,7,0,7.75,7010,9992
2.4e+05,2014,331,4,2.5,1980,7264,2,0,0,3,7,1980,0,1996,1996,98038,47.368,122.02,1600,6380,18,0,6.5,3580,8360
4.05e+05,2014,218,2,1,880,3000,1,0,0,5,7,880,0,1927,1927,98103,47.687,122.35,1300,3000,87,0,3,2180,3880
2.61e+05,2014,242,2,1,750,8125,1,0,0,4,6,750,0,1943,1943,98055,47.473,122.2,1340,8750,71,0,3,2090,9500
4.625e+05,2015,463,3,2.5,1656,1.089e+05,1,0,0,4,7,1656,0,1985,1985,98070,47.376,122.42,2030,29859,30,0,5.5,3686,31515
4.38e+05,2014,174,3,1.75,1520,6380,1,0,0,3,7,790,730,1948,1948,98115,47.695,122.3,1520,6235,66,0,4.75,3040,7755
3.19e+05,2015,471,2,1.5,1090,847,3,0,0,3,8,1090,0,2009,2009,98133,47.724,122.35,1090,1118,6,0,3.5,2180,2208
5.65e+05,2014,314,2,2.5,1950,2457,3,0,0,3,8,1950,0,2009,2009,98144,47.593,122.3,1650,1639,5,0,4.5,3600,3589
6.01e+05,2014,224,4,3.5,2160,3600,2,0,0,3,8,1660,500,1998,1998,98122,47.61,122.3,1230,3840,16,0,7.5,3390,6000
4.93e+05,2015,463,4,2.5,2070,4270,2,0,0,3,8,2070,0,2010,2010,98028,47.773,122.27,2070,4610,5,0,6.5,4140,6680
4.37e+05,2014,154,2,1.75,1500,6800,1,0,0,4,7,910,590,1942,1942,98117,47.7,122.37,1450,6800,72,0,3.75,2950,8300
2.6e+05,2014,245,3,1,1200,4592,1,0,0,3,6,800,400,1950,1950,98106,47.519,122.35,940,4440,64,0,4,2140,5640
4.436e+05,2014,232,3,2.5,1430,1056,3,0,0,3,8,1430,0,2003,2003,98117,47.684,122.39,1310,2135,11,0,5.5,2740,3565
3.96e+05,2014,317,3,1.5,1300,8280,1,0,0,5,7,1300,0,1956,1956,98028,47.74,122.26,1570,8692,58,0,4.5,2870,9992
4.275e+05,2015,393,4,2.5,2010,6294,2,0,0,3,7,2010,0,2000,2000,98028,47.776,122.24,1870,4394,15,0,6.5,3880,6404
5.85e+05,2014,250,4,2.5,2370,15200,1,0,0,3,8,1660,710,1975,1975,98052,47.63,122.09,2360,13879,39,0,6.5,4730,16249
2.45e+06,2014,133,5,4,4430,9000,2,0,0,3,10,4430,0,2013,2013,98004,47.617,122.22,2470,9490,1,0,9,6900,13920
4.11e+05,2014,139,4,2.75,2500,5257,2,0,0,3,8,2500,0,1966,1966,98118,47.529,122.29,1660,5970,48,0,6.75,4160,8470
1.96e+05,2015,424,3,1,1220,6719,1,0,0,3,6,1220,0,1953,1953,98198,47.419,122.33,1580,7200,62,0,4,2800,8420
4.35e+05,2015,471,4,2.5,2180,6500,2,0,0,3,7,1410,770,1945,1945,98126,47.536,122.37,920,6500,70,0,6.5,3100,8680
3.2625e+05,2014,201,3,1,1060,9663,1,0,0,3,7,1060,0,1967,1967,98034,47.724,122.23,1320,10162,47,0,4,2380,11222
4.05e+05,2014,249,3,1.75,1760,5355,1,0,0,3,7,1160,600,1956,1956,98118,47.537,122.27,1790,6225,58,0,4.75,3550,7985
8.5e+05,2014,290,3,2,1540,3600,2,0,0,3,8,1540,0,1900,1988,98112,47.634,122.28,2970,3600,114,1,5,4510,5140
5.2e+05,2014,301,2,2.25,1530,981,3,0,0,3,8,1480,50,2006,2006,98103,47.653,122.35,1530,1282,8,0,4.25,3060,2812
3.7e+05,2015,446,3,1.5,1360,10726,1,0,0,4,7,1360,0,1966,1966,98059,47.495,122.13,1650,10726,49,0,4.5,3010,12086
2.6e+05,2015,464,3,2.75,1730,4131,2,0,2,3,7,1480,250,1975,1975,98106,47.533,122.35,1570,4120,40,0,5.75,3300,5850
5.5029e+05,2015,372,2,1.75,1680,4500,1,0,0,3,8,1680,0,2004,2004,98053,47.713,122.03,1670,4500,11,0,3.75,3350,6180
5.6e+05,2014,150,3,1.5,2000,7350,1,0,0,3,8,2000,0,1953,1953,98177,47.706,122.37,1890,6960,61,0,4.5,3890,8960
3.9e+05,2014,221,2,1,930,3100,1,0,0,3,6,930,0,1911,1911,98144,47.594,122.3,1670,3800,103,0,3,2600,4730
3.05e+05,2014,259,4,2.5,1914,3150,2,0,0,3,8,1914,0,2009,2009,98055,47.43,122.19,1714,3164,5,0,6.5,3628,5078
3.7e+05,2015,414,2,2.5,1390,1821,2,0,0,3,7,1180,210,2007,2007,98118,47.554,122.28,1350,1821,8,0,4.5,2740,3211
4.82e+05,2014,194,4,2.5,2846,85377,1,0,0,3,8,1976,870,2000,2000,98001,47.317,122.28,1696,57934,14,0,6.5,4542,60780
3.635e+05,2014,286,4,1.75,2180,9702,1,0,0,5,7,1090,1090,1962,1962,98178,47.497,122.27,2020,9792,52,0,5.75,4200,11972
4.52e+05,2014,311,4,2.5,2716,7850,2,0,0,3,9,2716,0,2014,2014,98030,47.352,122.2,2580,14448,0,0,6.5,5296,17164
5.36e+05,2015,390,3,1.75,1530,8503,1,0,0,4,7,1150,380,1983,1983,98033,47.687,122.19,1610,8549,32,0,4.75,3140,10079
4.3e+05,2014,298,3,2.25,1470,1703,2,0,0,3,8,1470,0,2005,2005,98029,47.548,122,1380,1107,9,0,5.25,2850,2577
5.5e+05,2015,401,3,2.5,2800,10603,2,0,0,3,9,2800,0,2001,2001,98011,47.753,122.19,2580,10603,14,0,5.5,5380,13403
5.3e+05,2014,340,3,2.5,2640,13775,1,0,0,3,8,1550,1090,1978,1978,98005,47.587,122.18,2120,12432,36,0,5.5,4760,15072
3.6e+05,2014,294,3,2.75,2030,6840,1,0,0,3,7,1210,820,1979,1979,98108,47.541,122.3,1910,6365,35,0,5.75,3940,8395
8.34e+05,2014,331,3,2.25,2550,4089,2,0,0,3,9,2550,0,1983,1983,98112,47.627,122.3,1680,4089,31,0,5.25,4230,6639
5.7e+05,2014,125,3,2.25,2010,6000,1,0,0,3,8,1330,680,1975,1975,98052,47.691,122.11,2080,8260,39,0,5.25,4090,10270
4.59e+05,2015,484,3,3,2440,2076,2,0,0,3,8,1930,510,2006,2006,98126,47.548,122.37,2440,2310,9,0,6,4880,4750
3.54e+05,2014,341,3,1,1130,11250,1,0,0,3,7,1130,0,1965,1965,98034,47.725,122.23,1410,11250,49,0,4,2540,12380
5.7e+05,2015,409,4,2.5,2590,7910,2,0,0,3,9,2590,0,2003,2003,98028,47.738,122.25,2110,11761,12,0,6.5,4700,14351
4.19e+05,2014,180,2,1.75,1510,4980,1,0,0,3,8,1510,0,2006,2006,98053,47.719,122.02,1350,4157,8,0,3.75,2860,5667
6.05e+05,2015,376,3,3.25,2200,2400,2,0,0,3,8,1740,460,1988,1988,98119,47.633,122.37,2200,3600,27,0,6.25,4400,5800
2.72e+05,2014,280,4,2.25,1800,5555,2,0,0,3,7,1800,0,2003,2003,98038,47.35,122.05,1810,5669,11,0,6.25,3610,7469
4.1589e+05,2014,278,3,1,1310,4163,1,0,0,4,7,1310,0,1964,1964,98126,47.53,122.38,1120,4166,50,0,4,2430,5476
8.3e+05,2015,478,4,3.25,3080,4287,2,0,0,3,10,2230,850,2012,2012,98027,47.531,122.08,2250,2520,3,0,7.25,5330,5600
5.65e+05,2014,353,1,1,1370,6250,1,0,0,4,7,1370,0,1921,1921,98136,47.557,122.39,1450,6250,93,0,2,2820,7620
4.85e+05,2015,458,3,1.75,2180,7318,1,0,0,4,7,1210,970,1967,1967,98126,47.525,122.37,2140,7560,48,0,4.75,4320,9740
9.5e+05,2014,167,3,2.75,2750,18029,1,0,2,5,9,1810,940,1978,1978,98006,47.562,122.13,2850,10021,36,0,5.75,5600,12771
2.9995e+05,2015,366,3,1,1030,9916,1,0,0,4,7,1030,0,1972,1972,98034,47.722,122.18,1470,9044,43,0,4,2500,10074
4.035e+05,2014,168,5,2.5,3600,17300,1,0,0,4,8,2410,1190,1968,1968,98166,47.447,122.34,2620,30200,46,0,7.5,6220,33800
2.65e+05,2014,276,3,1.5,1460,8505,1,0,0,4,7,1460,0,1955,1955,98055,47.44,122.19,1580,8505,59,0,4.5,3040,9965
5.25e+05,2014,229,3,1.75,1520,8835,1,0,0,4,7,1520,0,1957,1957,98008,47.605,122.12,1760,8580,57,0,4.75,3280,10100
3.2e+05,2014,325,2,2.25,1550,1827,2,0,0,3,8,1550,0,2008,2008,98106,47.539,122.37,1420,1826,6,0,4.25,2970,3376
5.37e+05,2015,466,4,2.25,2640,8800,1,0,0,3,8,1620,1020,1980,1980,98072,47.755,122.15,2500,11700,35,0,6.25,5140,14340
5.705e+05,2015,407,2,1,1380,1800,2,0,0,3,7,1080,300,1954,1954,98119,47.642,122.36,1600,3600,61,0,3,2980,4980
3.28e+05,2014,208,2,1,700,4350,1,0,0,3,6,700,0,1943,1943,98116,47.558,122.39,1620,5100,71,0,3,2320,5800
2.63e+05,2014,238,3,1.5,1300,7885,1,0,0,3,7,1300,0,1968,1968,98055,47.456,122.21,1840,7600,46,0,4.5,3140,8900
9.5e+05,2015,383,2,2.25,2200,2043,2,0,0,3,9,1760,440,2007,2007,98004,47.621,122.2,2020,1957,8,0,4.25,4220,4157
4.75e+05,2015,492,3,1.75,1720,3825,1,0,0,3,7,1720,0,1925,1925,98105,47.666,122.33,2000,3825,90,0,4.75,3720,5545
4.5e+05,2015,386,2,2.25,1040,1377,2,0,0,3,8,1040,0,2003,2003,98105,47.669,122.28,1264,1892,12,0,4.25,2304,2932
4.36e+05,2014,310,4,2.5,2640,3899,2,0,0,3,7,2640,0,2000,2000,98011,47.754,122.22,2460,4057,14,0,6.5,5100,6697
3.28e+05,2014,243,3,2.25,2020,8379,2,0,0,3,7,2020,0,1994,1994,98038,47.383,122.02,2020,8031,20,0,5.25,4040,10051
3.5e+05,2014,222,4,2.5,2260,13755,1,0,0,4,9,2260,0,1975,1975,98042,47.377,122.16,2650,13650,39,0,6.5,4910,15910
1.8e+05,2014,341,3,1,1384,8960,1,0,0,4,6,1384,0,1965,1965,98023,47.306,122.37,1000,8470,49,0,4,2384,9854
2.1e+05,2015,447,3,1,1040,8970,1,0,0,4,6,1040,0,1961,1961,98023,47.328,122.34,1040,8450,54,0,4,2080,9490
1.55e+05,2014,297,3,1.5,970,8400,1,0,0,3,7,970,0,1966,1966,98003,47.328,122.33,1230,8400,48,0,4.5,2200,9370
4.65e+05,2014,258,3,2,1560,8509,1,0,0,3,8,790,770,1969,1969,98034,47.726,122.22,1410,7428,45,0,5,2970,8988
7.9e+05,2015,367,3,1,1290,6380,1,0,0,3,7,1290,0,1930,1930,98115,47.695,122.32,1630,6380,85,0,4,2920,7670
3.5e+05,2014,205,4,2.5,2610,5866,2,0,0,3,8,2610,0,2005,2005,98038,47.344,122.04,2480,5188,9,0,6.5,5090,7798
2.1e+05,2014,271,2,1,830,6000,1,0,0,3,6,830,0,1940,1940,98126,47.531,122.38,830,4960,74,0,3,1660,5790
5.2e+05,2014,218,4,2.25,1890,3006,2,0,0,3,7,1890,0,2003,2003,98029,47.546,122,1580,3000,11,0,6.25,3470,4890
7.59e+05,2015,393,5,2.75,3490,8230,2,0,0,3,10,3490,0,2005,2005,98075,47.583,121.97,3480,7331,10,0,7.75,6970,10821
5.35e+05,2014,285,4,2.5,2360,15008,1,0,0,3,9,1920,440,1986,1986,98028,47.736,122.25,2680,15344,28,0,6.5,5040,17704
2.7e+05,2014,222,3,2.25,1400,3825,2,0,0,3,7,1400,0,2012,2012,98042,47.36,122.08,2110,3825,2,0,5.25,3510,5225
4.5156e+05,2014,135,2,1,1320,4520,1,0,1,3,6,1320,0,1912,1971,98116,47.566,122.39,1420,4560,102,1,3,2740,5880
5.6e+05,2014,255,4,1.5,1790,3420,1,0,0,4,7,1020,770,1923,1923,98103,47.649,122.34,1680,3420,91,0,5.5,3470,5210
2.288e+06,2014,182,4,2.5,4080,18362,2,0,2,4,11,4080,0,1983,1983,98004,47.634,122.21,4080,19991,31,0,6.5,8160,24071
4.82e+05,2015,415,4,2.25,2240,8322,2,0,0,3,8,2240,0,1979,1979,98034,47.728,122.21,2240,6448,36,0,6.25,4480,8688
2.859e+05,2015,433,5,1.5,1690,7725,1,0,0,4,7,1690,0,1961,1961,98032,47.386,122.29,1690,7739,54,0,6.5,3380,9429
1.3e+06,2014,155,6,4.5,3902,3880,3,0,4,4,9,2782,1120,1977,1977,98116,47.584,122.4,1100,3870,37,0,10.5,5002,7772
4.95e+05,2014,135,4,2,2050,4000,1,0,0,5,7,1210,840,1941,1941,98144,47.58,122.31,1310,4000,73,0,6,3360,6050
1.6e+06,2014,266,5,3.75,3570,10125,2,0,0,3,10,3570,0,2014,2014,98040,47.564,122.22,1760,10125,0,0,8.75,5330,13695
1.245e+06,2014,244,6,3.25,3750,14150,2,0,2,5,9,2750,1000,1936,1968,98117,47.7,122.39,2140,7968,78,1,9.25,5890,11718
1e+06,2015,483,5,1,2010,5210,1,0,0,3,9,1890,120,1927,1927,98119,47.65,122.37,2330,5000,88,0,6,4340,7010
3.055e+05,2014,134,3,1.75,2110,10200,2,0,0,4,7,2110,0,1966,1966,98059,47.474,122.15,1800,10200,48,0,4.75,3910,12310
2.55e+05,2015,474,1,1,810,5000,1,0,1,3,7,590,220,1936,1936,98106,47.57,122.36,1920,5000,79,0,2,2730,5810
3.9214e+05,2015,444,3,2,1460,3696,2,0,0,3,7,1460,0,2010,2010,98053,47.686,122.01,1720,3631,5,0,5,3180,5091
5.1e+05,2014,134,3,1.75,2170,26460,1,0,0,3,8,1450,720,1986,1986,98074,47.615,122.05,2090,29075,28,0,4.75,4260,31245
6.064e+05,2014,279,3,3,1800,5000,1,0,2,3,8,1500,300,1929,1929,98119,47.648,122.37,1670,5000,85,0,6,3470,6800
3.5e+05,2015,445,4,2.75,2990,11210,1,0,1,4,8,1880,1110,1977,1977,98023,47.336,122.34,2790,9858,38,0,6.75,5780,12848
3.9e+05,2014,141,3,2.25,1445,1471,2,0,0,3,7,1300,145,2003,2003,98027,47.534,122.07,1410,1399,11,0,5.25,2855,2844
6e+05,2014,209,4,2.75,2810,17674,1,0,0,4,8,1640,1170,1978,1978,98052,47.675,122.14,2400,11240,36,0,6.75,5210,14050
7.63e+05,2015,429,3,2,1360,8752,1,0,2,4,6,1360,0,1942,1942,98033,47.688,122.21,2530,7680,73,0,5,3890,9040
4.284e+05,2014,245,4,2.5,2650,6000,2,0,0,3,9,2650,0,2000,2000,98038,47.377,122.03,2630,6381,14,0,6.5,5280,9031
1.6e+06,2015,399,3,2.75,3040,21052,2,0,0,4,10,3040,0,1980,1980,98004,47.638,122.22,2950,21052,35,0,5.75,5990,24092
3.42e+05,2014,331,3,2.25,1200,2845,2,0,0,3,7,1200,0,1986,1986,98034,47.715,122.2,1220,2140,28,0,5.25,2420,3340
1.49e+06,2015,451,3,3.5,4560,14608,2,0,2,3,12,4560,0,1990,1990,98034,47.7,122.23,4050,14226,25,0,6.5,8610,18786
6.9995e+05,2014,342,3,2.25,2190,1.0759e+05,2,0,0,4,8,2190,0,1983,1983,98077,47.773,122.08,2570,47777,31,0,5.25,4760,49967
8.8899e+05,2014,258,4,2.75,3540,5500,2,0,0,3,9,3540,0,2014,2014,98074,47.618,122.06,3540,5500,0,0,6.75,7080,9040
4.85e+05,2015,430,3,1.75,2030,10089,1,0,0,4,8,1330,700,1976,1976,98027,47.522,122.05,2030,9827,39,0,4.75,4060,11857
2.65e+05,2015,414,3,1.75,1680,9769,1,0,0,3,8,1340,340,1989,1989,98058,47.463,122.13,1730,9686,26,0,4.75,3410,11366
9.75e+05,2014,168,4,2.5,4270,43386,1,0,0,3,10,2680,1590,1991,1991,98053,47.691,122.05,3630,36180,23,0,6.5,7900,40450
6.1e+05,2015,403,6,2.75,2040,8560,1,0,2,4,7,1100,940,1961,1961,98008,47.616,122.11,2230,8560,54,0,8.75,4270,10600
5.75e+05,2015,408,2,1.5,1400,5810,2,0,0,3,7,1400,0,1940,1940,98103,47.684,122.34,1470,3920,75,0,3.5,2870,5320
1.058e+06,2014,134,4,2,2290,11137,1,0,0,4,8,2290,0,1955,1955,98004,47.589,122.2,2300,10463,59,0,6,4590,12753
3.0995e+05,2015,432,4,1.75,1450,10074,1,0,0,4,7,1450,0,1966,1966,98058,47.455,122.18,1340,8023,49,0,5.75,2790,9473
7.52e+05,2014,167,4,2.5,2940,10382,2,0,0,4,9,2940,0,1991,1991,98059,47.533,122.15,2980,10547,23,0,6.5,5920,13487
4.2225e+05,2015,382,3,1.75,1650,7145,2,0,0,5,8,1300,350,1977,1977,98155,47.773,122.32,1760,7206,38,0,4.75,3410,8856
2.45e+05,2015,464,3,1,990,9599,1,0,0,4,6,990,0,1959,1959,98002,47.293,122.22,1216,10364,56,0,4,2206,11354
3.1995e+05,2015,422,3,2.5,1700,7000,2,0,0,3,7,1700,0,1996,1996,98038,47.38,122.03,1950,7000,19,0,5.5,3650,8700
3.9995e+05,2014,232,4,2.5,3200,7545,2,0,0,3,7,3200,0,2003,2003,98038,47.367,122.03,2840,7137,11,0,6.5,6040,10337
1.364e+06,2015,413,4,2.5,3560,8960,2,0,0,3,10,3560,0,2001,2001,98033,47.69,122.21,1660,7680,14,0,6.5,5220,11240
2.83e+05,2014,325,3,2,1820,15068,2,0,2,3,7,1520,300,1920,2014,98022,47.21,122,1490,9589,94,1,5,3310,11409
2.24e+05,2014,339,3,1.75,1100,10125,1,0,0,4,7,1100,0,1969,1969,98092,47.323,122.1,1520,10125,45,0,4.75,2620,11225
3.2699e+05,2014,211,3,2.5,2060,4200,2,0,0,3,8,2060,0,2014,2014,98038,47.371,122.02,2370,4200,0,0,5.5,4430,6260
8.75e+05,2014,205,3,2,2350,6000,1,0,0,4,8,1990,360,1922,1922,98102,47.648,122.32,2010,5040,92,0,5,4360,7390
4.5e+05,2015,455,4,2.5,1900,9240,1,0,0,3,7,1900,0,1962,1962,98007,47.617,122.14,2040,8052,53,0,6.5,3940,9952
2.52e+05,2015,473,3,1,1300,8184,2,0,0,3,6,1300,0,1947,1947,98155,47.747,122.32,1120,8184,68,0,4,2420,9484
2.25e+05,2014,133,4,1.5,1950,12559,1,0,0,3,6,1950,0,1939,1939,98188,47.436,122.28,1950,9178,75,0,5.5,3900,11128
2.42e+05,2014,148,3,1.75,1310,9645,1,0,0,3,7,1310,0,1979,1979,98198,47.405,122.29,1440,9893,35,0,4.75,2750,11203
1.695e+06,2015,399,3,4,3910,5350,2,0,2,5,10,2610,1300,1933,1933,98199,47.639,122.41,2890,5350,82,0,7,6800,9260
2.3e+05,2015,414,4,2,1220,9100,1,0,0,4,7,1220,0,1970,1970,98023,47.296,122.38,1160,7700,45,0,6,2380,8920
5.3995e+05,2015,450,3,1.75,1820,9875,1,0,0,4,8,1820,0,1966,1966,98008,47.624,122.09,2670,10000,49,0,4.75,4490,11820
4.4e+05,2014,252,4,2.5,2400,8038,2,0,0,3,8,2400,0,2002,2002,98059,47.488,122.14,2040,7756,12,0,6.5,4440,10156
3.685e+05,2015,474,4,2.75,2500,26400,1,0,0,3,8,1780,720,1977,1977,98031,47.344,122.08,2180,31900,38,0,6.75,4680,34400
3.25e+05,2015,415,3,2.5,2130,12245,2,0,0,3,8,2130,0,1989,1989,98042,47.341,122.06,1910,12216,26,0,5.5,4040,14346
2.63e+05,2014,135,3,2.25,1590,7748,2,0,0,4,7,1590,0,1991,1991,98003,47.286,122.3,1590,7606,23,0,5.25,3180,9196
4.25e+05,2014,270,3,1.75,1960,43332,1,0,0,4,7,1400,560,1982,1982,98077,47.739,122.05,2010,44431,32,0,4.75,3970,46391
5.71e+05,2014,161,3,2.5,2600,7465,2,0,0,3,9,2600,0,1988,1988,98011,47.739,122.22,2660,7683,26,0,5.5,5260,10283
4.3e+05,2014,300,3,1,1560,5225,1,0,0,3,7,1260,300,1927,1927,98118,47.555,122.28,1560,5322,87,0,4,3120,6882
5.25e+05,2015,488,4,2.75,2300,26650,1,0,0,4,8,2300,0,1950,1950,98177,47.777,122.36,2000,9879,65,0,6.75,4300,12179
7.75e+05,2014,266,4,2.5,3890,34513,2,0,0,3,10,3890,0,1996,1996,98077,47.775,122.05,3600,28435,18,0,6.5,7490,32325
9.15e+05,2015,430,3,2.25,2390,2750,2,0,0,5,8,1580,810,1925,1925,98109,47.634,122.35,2200,5160,90,0,5.25,4590,7550
6e+05,2015,481,3,1,1310,5000,1,0,0,3,7,1310,0,1906,1906,98103,47.662,122.35,1530,4800,109,0,4,2840,6110
3.25e+05,2015,481,3,2.5,1580,4698,2,0,0,3,7,1580,0,1998,1998,98038,47.354,122.03,2070,4698,17,0,5.5,3650,6278
4e+05,2015,433,3,2.5,2120,3757,2,0,0,3,7,2120,0,2006,2006,98059,47.479,122.13,2230,4103,9,0,5.5,4350,6223
8.526e+05,2014,161,4,2.5,3320,11901,2,0,0,5,9,2650,670,1977,1977,98006,47.554,122.16,2700,11114,37,0,6.5,6020,14434
1.6e+06,2014,156,4,3.5,4280,9583,2,0,0,3,11,4280,0,2005,2005,98004,47.598,122.2,2360,10031,9,0,7.5,6640,14311
2.5e+05,2014,294,3,2.25,1640,4420,2,0,0,4,7,1640,0,1918,1983,98002,47.311,122.21,1230,6632,96,1,5.25,2870,8272
2.89e+05,2014,133,3,1,1090,7315,1,0,0,5,6,1090,0,1981,1981,98056,47.494,122.17,1090,5800,33,0,4,2180,6890
9.2e+05,2015,423,5,2.25,2730,6000,1,0,0,3,8,2130,600,1927,1927,98105,47.657,122.28,2730,6000,88,0,7.25,5460,8730
6.15e+05,2014,255,3,1.75,1920,4000,1,0,0,3,7,1070,850,1950,1950,98102,47.639,122.32,2280,4000,64,0,4.75,4200,5920
4.25e+05,2015,465,2,1,540,2500,1,0,0,3,5,540,0,1905,1905,98107,47.673,122.38,1290,5000,110,0,3,1830,5540
6.05e+05,2015,453,3,1.75,2100,5058,1,0,2,3,7,1340,760,1941,1941,98126,47.574,122.38,1640,5000,74,0,4.75,3740,7100
1.9e+05,2015,403,3,1,1180,8775,1,0,0,3,7,1180,0,1966,1966,98002,47.285,122.22,1300,8100,49,0,4,2480,9280
4.701e+05,2014,248,4,2.5,2320,7800,2,0,0,3,8,2320,0,1986,1986,98028,47.774,122.27,2090,5721,28,0,6.5,4410,8041
2.55e+05,2015,438,3,1.5,1340,8450,1,0,0,4,7,1340,0,1958,1958,98188,47.441,122.28,1340,8920,57,0,4.5,2680,10260
4.325e+05,2015,376,3,2,1720,8145,2,0,0,5,7,1720,0,1949,1949,98155,47.739,122.33,1400,8138,66,0,5,3120,9858
6.5e+05,2014,262,3,2,2520,5980,1,0,0,3,8,1790,730,1957,1957,98116,47.577,122.38,1590,5750,57,0,5,4110,8270
3.75e+05,2014,166,4,2,2400,6000,2,0,0,3,6,2400,0,1913,1945,98011,47.761,122.21,1780,8732,101,1,6,4180,11132
8.8995e+05,2014,203,4,2.75,3080,7242,2,0,0,3,9,3080,0,2014,2014,98033,47.695,122.18,3010,7205,0,0,6.75,6090,10285
3.2495e+05,2015,408,2,1.5,1643,14616,1,0,1,4,7,1643,0,1954,1954,98198,47.397,122.31,2270,9940,61,0,3.5,3913,11583
2.77e+05,2014,237,3,1,1140,8144,1,0,0,3,7,1140,0,1956,1956,98155,47.746,122.32,1150,8144,58,0,4,2290,9284
5.24e+05,2015,389,4,2.25,2190,15491,2,0,0,3,8,2190,0,1981,1981,98074,47.63,122.04,2090,15039,34,0,6.25,4280,17229
5.2e+05,2014,319,5,1.75,2040,5280,1,0,0,4,7,1020,1020,1961,1961,98007,47.594,122.14,1720,7344,53,0,6.75,3760,9384
3.2495e+05,2015,452,2,1.5,1230,1516,3,0,0,3,8,1230,0,2000,2000,98125,47.727,122.31,1352,1411,15,0,3.5,2582,2641
6.1e+05,2014,126,4,3,2450,10117,1,0,0,5,8,1580,870,1967,1967,98006,47.569,122.13,2530,10125,47,0,7,4980,12575
4.8e+05,2014,354,3,1.5,1540,20281,1,0,0,3,7,1540,0,1977,1977,98075,47.582,122.01,1710,21090,37,0,4.5,3250,22630
3.525e+05,2015,429,4,2,1970,7451,1,0,0,3,8,1350,620,1962,1962,98133,47.765,122.33,1980,7510,53,0,6,3950,9480
1.985e+05,2015,426,2,1,1050,9600,1,0,0,4,6,1050,0,1959,1959,98023,47.327,122.35,990,8880,56,0,3,2040,9930
3.25e+05,2014,352,2,2.25,1150,711,2,0,0,3,7,1150,0,2013,2013,98027,47.532,122.07,1150,748,1,0,4.25,2300,1898
5.9983e+05,2015,456,3,2.75,3230,5200,2,0,0,3,9,2680,550,2014,2014,98065,47.519,121.88,3100,4900,1,0,5.75,6330,8130
5.75e+05,2014,352,3,2,2150,3880,1,0,0,3,8,1080,1070,1951,1951,98117,47.681,122.39,2130,4000,63,0,5,4280,6150
2.5448e+06,2014,324,5,4.75,5410,13431,2,0,0,4,10,5050,360,1941,1941,98112,47.631,122.29,3750,11596,73,0,9.75,9160,17006
3.4995e+05,2014,134,5,3,2257,10117,1,0,0,3,8,1363,894,2005,2005,98188,47.452,122.28,1540,10700,9,0,8,3797,12957
3.9e+05,2014,324,3,2.5,2500,21780,1,0,0,3,8,1770,730,1986,1986,98092,47.328,122.2,2670,23400,28,0,5.5,5170,25900
6.7e+05,2015,451,4,2,2250,4200,1,0,0,3,7,1650,600,1909,1909,98122,47.614,122.3,1200,3360,106,0,6,3450,5610
4.39e+05,2015,473,3,2.25,1480,7565,1,0,0,3,7,1220,260,1977,1977,98034,47.729,122.19,1660,7565,38,0,5.25,3140,9045
4.025e+05,2014,195,3,1.75,1480,2211,2,0,0,3,7,1480,0,1995,1995,98103,47.697,122.35,1480,2197,19,0,4.75,2960,3677
5.75e+05,2014,194,4,1.5,2810,7140,1,0,2,3,8,1490,1320,1954,1954,98136,47.525,122.38,2240,6825,60,0,5.5,5050,9635
1.375e+06,2014,195,5,4,3760,22763,1,0,3,4,11,1910,1850,1969,1969,98040,47.533,122.22,3730,11201,45,0,9,7490,14961
4.9e+05,2015,464,3,1,1420,11040,1,0,0,4,7,1420,0,1961,1961,98007,47.597,122.14,1530,8208,54,0,4,2950,9628
5.499e+05,2015,474,4,3.5,3420,4751,2,0,0,3,10,3420,0,2003,2003,98055,47.473,122.19,3490,5700,12,0,7.5,6910,9120
3.54e+05,2014,304,6,3.5,3020,4500,2,0,0,3,7,3020,0,1941,1992,98178,47.498,122.22,900,6000,73,1,9.5,3920,9020
4.02e+05,2014,156,3,2.5,2700,9994,1,0,3,4,7,1350,1350,1959,1959,98198,47.397,122.32,2470,10664,55,0,5.5,5170,13364
8.64e+05,2015,380,3,2.75,3060,13554,2,0,0,3,10,3060,0,1984,1984,98006,47.561,122.11,3060,11455,31,0,5.75,6120,14515
1.15e+05,2014,205,2,1,940,6000,1,0,0,3,6,940,0,1943,1943,98146,47.491,122.34,1310,6000,71,0,3,2250,6940
6.12e+05,2015,479,5,2.5,2300,7000,1,0,0,3,8,1290,1010,1975,1975,98052,47.688,122.12,2080,7280,40,0,7.5,4380,9580
8.75e+05,2014,181,5,3.5,3840,8279,2,0,0,3,9,3840,0,2001,2001,98074,47.604,122.06,3570,8279,13,0,8.5,7410,12119
5.24e+05,2014,128,3,2.25,2430,73151,1,0,0,3,8,2430,0,1974,1974,98059,47.475,122.09,2800,39250,40,0,5.25,5230,41680
5.4e+05,2014,208,4,2,1990,29078,2,0,0,3,9,1990,0,1984,1984,98074,47.647,122.06,2310,28353,30,0,6,4300,30343
4.0625e+05,2015,408,4,3.25,2550,11524,2,0,0,3,8,2550,0,1990,1990,98019,47.732,121.96,2370,14001,25,0,7.25,4920,16551
5.5e+05,2014,196,3,1,1600,5000,1,0,0,3,7,1110,490,1947,1947,98107,47.655,122.36,1380,5000,67,0,4,2980,6600
2.94e+05,2014,266,3,1,1320,9520,1,0,0,3,7,990,330,1953,1953,98178,47.486,122.25,1460,10610,61,0,4,2780,11930
4.74e+05,2015,392,4,2.25,1960,14834,1,0,0,4,8,1330,630,1976,1976,98072,47.743,122.09,1540,15000,39,0,6.25,3500,16960
4.3e+05,2015,464,4,1.75,2070,9120,1,0,0,4,7,1250,820,1958,1958,98008,47.605,122.12,1650,8400,57,0,5.75,3720,10470
4.1e+05,2014,125,3,2.25,1800,36704,1,0,0,4,8,1360,440,1978,1978,98027,47.469,122.01,2730,36404,36,0,5.25,4530,38204
3.3e+05,2014,271,2,1,1160,32251,1,0,0,3,6,580,580,1963,2000,98010,47.354,121.94,1160,33656,51,1,3,2320,34816
2.52e+05,2014,197,3,2,1420,6788,2,0,0,3,7,1420,0,1990,1990,98023,47.289,122.35,1790,6607,24,0,5,3210,8027
9.25e+05,2015,399,3,2.5,2440,7419,1,0,0,3,7,1520,920,1961,1961,98103,47.686,122.33,2440,4880,54,0,5.5,4880,7320
3.15e+05,2014,271,4,2.5,2040,6300,2,0,0,3,8,2040,0,2003,2003,98031,47.392,122.19,2260,5877,11,0,6.5,4300,7917
2.6e+05,2015,472,3,3,2390,8993,2,0,0,3,8,1680,710,1988,1988,98003,47.353,122.31,1820,10362,27,0,6,4210,12752
3.25e+05,2015,440,3,2,1750,9000,1,0,0,4,5,1750,0,1936,1936,98133,47.749,122.35,1830,8100,79,0,5,3580,9850
1.9995e+05,2015,380,3,3,1530,2132,2,0,0,3,8,1530,0,1993,1993,98038,47.375,122.06,1530,3384,22,0,6,3060,4914
4.15e+05,2014,243,2,1,880,3200,1,0,0,3,7,880,0,1910,1970,98199,47.657,122.4,1880,6000,104,1,3,2760,6880
6.455e+05,2014,150,2,1,1890,5202,1,0,0,4,7,1890,0,1909,1909,98117,47.679,122.38,1670,5100,105,0,3,3560,6990
5.3e+05,2015,432,5,2,1810,4850,1,0,0,3,7,1810,0,1900,1900,98107,47.67,122.39,1360,4850,115,0,7,3170,6660
3.6e+05,2014,338,4,2,1920,7803,1,0,0,3,7,1080,840,1962,1962,98155,47.758,122.33,1940,8147,52,0,6,3860,10067
4.275e+05,2014,334,3,1.5,1900,43186,1,0,0,4,7,1300,600,1971,1971,98038,47.42,121.99,2080,1.0803e+05,43,0,4.5,3980,1.0993e+05
4.85e+05,2014,126,3,2,1420,4080,1,0,0,3,7,1420,0,1905,2013,98103,47.687,122.35,1420,4590,109,1,5,2840,6010
6.781e+05,2014,198,3,1.75,1850,2860,1,0,0,5,8,1210,640,1931,1931,98116,47.585,122.39,1660,3120,83,0,4.75,3510,4970
2.51e+05,2015,453,3,1.5,1590,21600,1,0,0,4,7,1590,0,1971,1971,98022,47.216,121.97,1780,21600,44,0,4.5,3370,23190
6e+05,2015,417,2,2.25,2320,18919,2,1,4,4,8,2320,0,1976,1976,98070,47.391,122.46,1610,18919,39,0,4.25,3930,21239
7.25e+05,2015,403,3,2.5,2090,9847,2,0,2,3,9,2090,0,1983,1983,98006,47.565,122.11,2860,11483,32,0,5.5,4950,13573
5e+05,2014,127,2,1,1010,3885,1,0,0,4,7,1010,0,1906,1990,98112,47.622,122.3,1770,4200,108,1,3,2780,5210
2.135e+06,2014,231,4,3.25,3860,17820,1,0,4,4,10,2630,1230,1975,1975,98004,47.622,122.22,4590,23760,39,0,7.25,8450,27620
3.45e+05,2014,284,4,2.5,2390,6976,2,0,0,3,7,2390,0,2003,2003,98056,47.481,122.18,2390,6346,11,0,6.5,4780,8736
4.5e+05,2014,265,3,2.25,1660,10247,1,0,0,5,7,1130,530,1968,1968,98034,47.726,122.22,1680,7637,46,0,5.25,3340,9297
2.5e+05,2015,390,4,2,2130,8400,1,0,0,3,7,1350,780,1962,1962,98031,47.413,122.21,1550,8596,53,0,6,3680,10726
4.8694e+05,2014,265,4,2.5,3250,13360,2,0,0,3,9,3250,0,2014,2014,98030,47.352,122.2,2612,14448,0,0,6.5,5862,17698
1.64e+06,2014,181,3,3.25,3140,5445,2,0,3,4,10,2240,900,1913,1913,98109,47.641,122.35,2950,5250,101,0,6.25,6090,8390
4.55e+05,2014,170,4,2.25,2450,21000,1,0,2,4,8,1650,800,1954,1954,98166,47.456,122.34,1820,12480,60,0,6.25,4270,14930
3.949e+05,2015,408,3,1,1430,13370,1,0,0,3,7,1430,0,1962,1962,98034,47.732,122.24,1670,10075,53,0,4,3100,11505
8.875e+05,2014,353,3,3,4230,54977,2,0,3,3,9,3780,450,1951,2000,98166,47.418,122.34,2880,27201,63,1,6,7110,31431
3.699e+05,2015,393,2,2.5,1770,1853,3,0,0,3,8,1770,0,2007,2007,98126,47.547,122.37,1770,1924,8,0,4.5,3540,3694
3.43e+05,2014,135,4,1.75,2290,10290,1,0,0,3,7,1340,950,1960,1960,98146,47.505,122.37,1800,7605,54,0,5.75,4090,9895
2.675e+05,2014,205,3,1.5,1390,2153,2,0,0,3,7,1390,0,2001,2001,98118,47.551,122.29,1100,2617,13,0,4.5,2490,4007
5.85e+05,2014,159,4,1.75,2470,1.3179e+05,2,0,2,3,8,2470,0,1937,1937,98070,47.442,122.44,1470,92747,77,0,5.75,3940,95217
3.45e+05,2014,225,3,1,1010,3060,1,0,0,3,6,1010,0,1904,1904,98118,47.566,122.28,1330,4590,110,0,4,2340,5600
1.2e+06,2014,132,3,1.75,1560,8078,1,1,4,4,6,1560,0,1928,1928,98040,47.578,122.25,2890,16710,86,0,4.75,4450,18270
2.393e+05,2014,292,3,1,1070,5750,1,0,0,3,7,1070,0,1952,1952,98178,47.507,122.25,1420,6500,62,0,4,2490,7570
3.33e+05,2015,443,4,2.5,2690,5505,2,0,0,3,8,2690,0,2004,2004,98042,47.367,122.12,2690,5505,11,0,6.5,5380,8195
7.15e+05,2014,147,2,2.5,2160,5581,1,0,0,3,8,2160,0,2002,2002,98053,47.702,122.02,2315,5652,12,0,4.5,4475,7812
4.99e+05,2014,255,2,1.75,2040,1.1456e+05,1,0,0,4,7,2040,0,1968,1968,98027,47.498,122.09,1850,94960,46,0,3.75,3890,97000
6.8e+05,2015,403,4,2.5,3290,6012,2,0,0,3,9,3290,0,2005,2005,98075,47.596,121.98,3210,6005,10,0,6.5,6500,9295
2.155e+05,2014,177,2,1.75,1220,15600,1,0,0,3,6,1220,0,1972,1972,98001,47.285,122.27,1510,17818,42,0,3.75,2730,19038
3.64e+05,2014,262,4,2.25,1750,10270,1,0,0,4,8,1750,0,1968,1968,98155,47.761,122.31,1750,10127,46,0,6.25,3500,11877
4.85e+05,2014,245,3,2.5,3110,9015,2,0,0,3,9,3110,0,1990,1990,98058,47.437,122.15,2650,8960,24,0,5.5,5760,12070
6.2e+05,2015,474,4,2,1770,7700,1,0,0,4,7,1770,0,1962,1962,98007,47.592,122.15,1710,7700,53,0,6,3480,9470
6.4875e+05,2015,458,3,2.25,2060,9953,1,0,0,5,8,1070,990,1964,1964,98040,47.577,122.23,2340,9600,51,0,5.25,4400,11660
4.3e+05,2014,135,3,2,1510,7066,1,0,2,3,7,1230,280,1973,1973,98125,47.705,122.3,1950,8089,41,0,5,3460,9599
5.9e+05,2014,347,3,2.5,2400,99752,1,0,0,3,9,2400,0,1996,1996,98058,47.392,122.08,2800,98010,18,0,5.5,5200,1.0041e+05
1.75e+05,2015,402,5,1.75,1680,8400,1,0,0,4,7,1680,0,1979,1979,98003,47.303,122.31,1800,8550,36,0,6.75,3480,10230
1.215e+06,2014,174,4,3.75,3820,53574,1,0,0,3,10,3820,0,1994,1994,98072,47.734,122.12,3140,54014,20,0,7.75,6960,57834
2.95e+06,2014,300,4,4.25,4470,5884,2,0,1,3,11,3230,1240,2010,2010,98199,47.639,122.41,2570,6000,4,0,8.25,7040,10470
3.3049e+05,2015,453,3,2.75,1440,7350,1,0,0,4,7,1040,400,1980,1980,98058,47.443,122.14,1510,7350,35,0,5.75,2950,8790
2.903e+06,2015,433,5,2.5,3750,91681,2,1,4,3,10,3750,0,1925,1925,98118,47.538,122.26,3540,24293,90,0,7.5,7290,28043
5.75e+05,2015,491,4,1.75,2020,6200,1,0,0,4,6,1010,1010,1948,1948,98133,47.701,122.35,1440,4158,67,0,5.75,3460,6178
5.9856e+05,2014,297,3,2.5,3040,7880,2,0,0,3,9,3040,0,2004,2004,98056,47.528,122.18,3040,7880,10,0,5.5,6080,10920
8.06e+05,2014,236,4,2.5,3370,9629,2,0,0,3,10,3370,0,1999,1999,98075,47.59,121.98,3360,10335,15,0,6.5,6730,13705
2.199e+05,2014,125,4,1.5,1120,5427,1,0,0,3,6,1120,0,1969,2014,98042,47.363,122.09,1150,5304,45,1,5.5,2270,6424
3.1e+05,2014,162,5,3,1880,5000,1,0,0,3,7,1100,780,1997,1997,98106,47.545,122.36,1640,5000,17,0,8,3520,6880
4.7045e+05,2014,264,2,1,1010,3400,1,0,0,3,7,1010,0,1921,1921,98103,47.671,122.33,1800,3600,93,0,3,2810,4610
9.65e+05,2014,152,4,2.5,2460,5000,2,0,0,5,8,1620,840,1938,1938,98112,47.628,122.29,2320,5000,76,0,6.5,4780,7460
1.75e+05,2014,141,3,1.75,1230,13056,1,0,0,4,7,1230,0,1962,1962,98001,47.317,122.28,1690,15750,52,0,4.75,2920,16980
2.65e+05,2015,426,4,1.75,1970,8390,1,0,0,3,7,1140,830,1955,1955,98178,47.486,122.25,1710,10890,60,0,5.75,3680,12860
6.07e+05,2014,195,4,2.75,2150,16728,1,0,0,4,8,1240,910,1982,1982,98033,47.691,122.18,2200,9257,32,0,6.75,4350,11407
3.1e+05,2014,352,3,1.5,1150,3323,2,0,0,3,7,1150,0,1988,1988,98029,47.571,122.02,1150,2980,26,0,4.5,2300,4130
5.5e+05,2015,451,4,2.5,1670,5116,2,0,0,3,8,1670,0,1999,1999,98155,47.767,122.33,1910,7210,16,0,6.5,3580,8880
3.57e+05,2014,335,4,2.75,2700,49428,1,0,0,4,9,2700,0,1988,1988,98042,47.317,122.08,2728,85905,26,0,6.75,5428,88605
3.5e+05,2014,290,3,2.5,1630,5996,2,0,0,3,7,1630,0,1986,1986,98055,47.474,122.19,1660,4504,28,0,5.5,3290,6134
3.035e+05,2014,314,4,2.5,1920,7345,2,0,0,3,8,1920,0,1992,1992,98038,47.353,122.06,1860,7364,22,0,6.5,3780,9284
1.175e+06,2014,148,3,2.5,1970,23180,1,1,4,3,8,1100,870,1937,1998,98136,47.55,122.4,3030,34689,77,1,5.5,5000,36659
4.37e+05,2014,169,2,1.75,1440,4225,1,0,0,3,8,1440,0,2005,2005,98053,47.714,122.03,1680,6200,9,0,3.75,3120,7640
7.4e+05,2014,190,3,1.5,1830,4000,1,0,0,4,7,1350,480,1910,1910,98119,47.645,122.37,1570,3672,104,0,4.5,3400,5502
2.635e+05,2014,322,3,1.75,1540,6273,1,0,0,4,6,770,770,1951,1951,98118,47.531,122.28,1140,5512,63,0,4.75,2680,7052
3.89e+05,2014,245,3,2.5,1720,4515,2,0,0,3,7,1720,0,2005,2005,98065,47.543,121.88,2220,4618,9,0,5.5,3940,6338
3.03e+05,2014,190,2,2,970,9750,1,0,0,5,6,970,0,1940,1940,98146,47.507,122.37,1850,9000,74,0,4,2820,9970
2.81e+05,2014,332,2,1,1280,12500,1,0,0,3,7,1060,220,1951,1951,98178,47.483,122.24,1460,17771,63,0,3,2740,19051
1.16e+06,2014,168,4,3.5,4680,9700,2,0,0,3,10,3360,1320,2005,2005,98006,47.57,122.17,2800,12343,9,0,7.5,7480,17023
4.95e+05,2014,271,3,1.75,2080,3000,1,0,0,4,7,1040,1040,1925,1925,98103,47.685,122.35,1000,3193,89,0,4.75,3080,5273
4.51e+05,2014,214,3,2.5,2050,4876,2,0,0,3,8,2050,0,2005,2005,98072,47.775,122.16,2320,4065,9,0,5.5,4370,6115
4.2e+05,2015,365,7,3,2940,8624,1,0,0,3,8,1690,1250,1977,1977,98155,47.755,122.31,1850,8031,38,0,10,4790,10971
3.9e+05,2015,366,2,1,962,1992,2,0,0,3,7,962,0,2012,2012,98115,47.691,122.31,1130,1992,3,0,3,2092,2954
2.2895e+05,2015,472,3,1,1120,6625,1,0,0,3,6,1120,0,1942,1942,98168,47.488,122.33,1120,6794,73,0,4,2240,7914
4.65e+05,2014,346,4,2.5,2820,39413,2,0,0,4,9,2820,0,1989,1989,98092,47.306,122.1,2910,39413,25,0,6.5,5730,42233
4.1e+05,2014,291,4,2.25,2200,8292,2,0,0,3,7,2200,0,1990,1990,98155,47.746,122.31,1090,8290,24,0,6.25,3290,10490
4.275e+05,2014,301,3,1,1480,4200,1,0,0,3,7,1480,0,1925,1925,98122,47.615,122.3,1460,3600,89,0,4,2940,5080
2.79e+05,2015,424,3,2.25,2070,7800,1,0,0,3,7,1170,900,1964,1964,98003,47.343,122.31,1570,8400,51,0,5.25,3640,10470
7.7e+05,2014,244,3,2.5,2900,23550,1,0,0,3,10,1490,1410,1987,1987,98006,47.571,122.15,2900,19604,27,0,5.5,5800,22504
4.3e+05,2014,141,3,1,1150,3000,1,0,0,5,6,1150,0,1906,1906,98103,47.687,122.34,1460,3200,108,0,4,2610,4350
2.9495e+05,2014,194,3,1,1240,8840,1,0,0,3,6,1240,0,1952,1952,98125,47.728,122.31,1250,8840,62,0,4,2490,10080
5.6e+05,2014,306,4,1.5,1810,6000,1,0,1,3,8,1350,460,1952,1952,98136,47.523,122.39,2020,6000,62,0,5.5,3830,7810
3e+05,2015,466,4,2.5,2500,4750,2,0,0,3,8,2500,0,2003,2003,98042,47.367,122.12,2690,4750,12,0,6.5,5190,7250
9.79e+05,2014,126,3,2.5,2690,4047,3,0,0,3,10,2690,0,2014,2014,98117,47.68,122.39,2040,5000,0,0,5.5,4730,7690
7.25e+05,2014,176,6,3,3110,5000,1,0,0,5,7,1810,1300,1921,1921,98103,47.663,122.35,1600,4000,93,0,9,4710,7110
7.3e+05,2015,435,4,2.5,3470,14271,2,0,0,3,9,3470,0,2005,2005,98065,47.542,121.88,3450,9380,10,0,6.5,6920,12850
4.2e+05,2015,480,4,1.75,1340,8400,1,0,0,5,7,1340,0,1967,1967,98056,47.538,122.17,1980,8400,48,0,5.75,3320,9740
5.15e+05,2014,359,5,2,2220,6000,1,0,0,4,7,1390,830,1925,1925,98144,47.582,122.3,1600,6000,89,0,7,3820,8220
2.75e+05,2015,446,3,2.5,1830,7062,2,0,0,3,7,1830,0,1990,1990,98023,47.289,122.35,1820,6434,25,0,5.5,3650,8264
4.5e+05,2014,194,2,1.5,1310,1264,2,0,0,3,8,1120,190,2006,2006,98106,47.577,122.41,1330,1265,8,0,3.5,2640,2575
3.75e+05,2014,136,4,2.5,2790,7956,2,0,0,3,9,2790,0,2005,2005,98198,47.368,122.31,1660,8192,9,0,6.5,4450,10982
3.775e+05,2014,218,3,2.5,1350,886,3,0,0,3,8,1270,80,2006,2006,98136,47.549,122.39,1350,886,8,0,5.5,2700,2236
4.298e+05,2015,417,3,2,1970,7000,1,0,0,3,8,1970,0,1986,1986,98038,47.374,122.04,1970,7365,29,0,5,3940,9335
3.3495e+05,2014,255,3,1.75,1880,16262,1,0,0,5,7,1880,0,1980,1980,98059,47.509,122.16,1900,7972,34,0,4.75,3780,9852
3.69e+05,2014,217,4,2.75,2420,6495,2,0,0,3,8,2420,0,2005,2005,98038,47.377,122.03,2420,6200,9,0,6.75,4840,8620
4.38e+05,2014,257,3,1.75,1990,9885,1,0,0,4,7,1030,960,1978,1978,98052,47.672,122.16,1560,10000,36,0,4.75,3550,11990
9.2e+05,2014,162,4,3.25,2420,4000,1,0,0,5,9,1870,550,1911,1911,98105,47.657,122.33,1810,4000,103,0,7.25,4230,6420
2.99e+05,2014,163,3,1.75,1180,13927,1,0,0,5,7,1180,0,1962,1962,98059,47.482,122.09,1400,13173,52,0,4.75,2580,14353
3.03e+05,2015,479,4,1,2300,9583,1,0,0,3,6,1220,1080,1928,1928,98024,47.567,121.89,1200,11325,87,0,5,3500,13625
3.31e+05,2014,324,3,1.75,1300,9079,1,0,0,3,7,1300,0,1986,1986,98059,47.483,122.16,1890,7369,28,0,4.75,3190,8669
8.69e+05,2014,202,2,1.75,1900,13122,1,1,4,3,7,1100,800,1954,1954,98178,47.512,122.25,1650,13160,60,0,3.75,3550,15060
4.05e+05,2014,305,4,2.5,2620,8960,1,0,0,5,7,1520,1100,1955,1955,98133,47.764,122.33,1880,8960,59,0,6.5,4500,11580
4.39e+05,2014,180,3,2.5,3180,7904,1,0,0,3,8,1810,1370,2006,2006,98056,47.489,122.18,1950,7800,8,0,5.5,5130,10980
3.01e+05,2014,208,4,2.5,2810,6146,2,0,0,3,9,2810,0,1998,1998,98031,47.404,122.21,2810,6180,16,0,6.5,5620,8990
9.25e+05,2015,437,4,2.5,3190,10034,2,0,0,3,9,3190,0,2007,2007,98052,47.638,122.11,2110,9300,8,0,6.5,5300,12490
8.12e+05,2014,188,4,3.5,3370,3634,2,0,0,3,9,2750,620,2007,2007,98029,47.552,122,3200,3650,7,0,7.5,6570,7020
5.55e+05,2015,473,2,2.25,1370,1248,2,0,0,3,7,1200,170,2000,2000,98102,47.64,122.32,1800,3360,15,0,4.25,3170,4730
3.39e+05,2014,204,3,1.75,1150,13278,1,0,0,5,7,1150,0,1966,1966,98053,47.638,121.97,1560,12400,48,0,4.75,2710,13550
7.5e+05,2014,175,3,1.5,1840,5000,1,0,0,5,7,1340,500,1915,1915,98107,47.665,122.36,1840,5000,99,0,4.5,3680,6840
4.06e+05,2015,433,3,1.75,1390,7904,1,0,0,3,7,1390,0,1985,1985,98056,47.489,122.18,1910,7904,30,0,4.75,3300,9294
4.15e+05,2015,456,3,2,1410,4303,1,0,0,4,7,1410,0,1900,1900,98108,47.554,122.32,1660,4326,115,0,5,3070,5736
6.15e+05,2015,464,3,2.25,2300,8067,1,0,0,4,8,1300,1000,1979,1979,98034,47.709,122.2,2120,9524,36,0,5.25,4420,11824
7.9e+05,2014,135,3,1.75,1790,6117,1,0,2,3,8,1350,440,1940,1940,98199,47.637,122.4,1960,5554,74,0,4.75,3750,7344
7.185e+05,2014,177,3,1.5,1200,6240,1,0,0,3,8,1030,170,1952,1952,98112,47.622,122.29,2810,6240,62,0,4.5,4010,7440
8.1e+05,2015,407,4,2.5,3280,25211,2,0,3,3,11,3280,0,1985,1985,98074,47.64,122.05,3280,25211,30,0,6.5,6560,28491
4.54e+05,2015,472,5,2.25,2550,9200,1,0,0,4,8,1580,970,1975,1975,98166,47.467,122.36,2090,9200,40,0,7.25,4640,11750
6.16e+05,2014,307,4,2.5,3440,6915,2,0,0,3,10,3440,0,2006,2006,98038,47.354,122,3200,6915,8,0,6.5,6640,10355
3.7e+05,2014,235,3,2.75,2120,7650,1,0,0,4,7,2120,0,1958,1958,98056,47.492,122.18,1180,7650,56,0,5.75,3300,9770
2.11e+06,2014,170,3,2.25,3230,17833,2,0,0,4,9,3230,0,1973,1973,98006,47.568,122.19,3690,17162,41,0,5.25,6920,20392
3.94e+05,2015,471,2,2,1750,2731,2,0,0,3,8,1750,0,2012,2012,98065,47.517,121.88,1650,2731,3,0,4,3400,4481
5.365e+05,2014,248,4,2.5,1720,3515,2,0,2,3,8,1470,250,2000,2000,98144,47.591,122.29,1140,2208,14,0,6.5,2860,3928
2.95e+05,2015,470,4,1,980,3000,1,0,0,4,7,980,0,1914,1914,98144,47.589,122.31,1525,3000,101,0,5,2505,3980
2e+05,2014,143,4,1,1350,11507,1,0,0,3,7,1350,0,1966,1966,98055,47.427,122.2,1320,25675,48,0,5,2670,27025
2.9e+05,2015,381,4,1.75,1820,22043,2,0,0,4,7,1820,0,1918,1918,98155,47.761,122.28,1880,19961,97,0,5.75,3700,21781
5.3889e+05,2014,151,5,2.75,2080,13189,2,0,0,3,8,2080,0,1987,1987,98074,47.629,122.03,2030,11847,27,0,7.75,4110,13927
2.68e+05,2014,262,4,1.75,1680,9966,1,0,0,3,7,1100,580,1977,1977,98198,47.392,122.31,2400,10369,37,0,5.75,4080,12049
6.05e+05,2014,211,3,1.75,1850,8823,1,0,0,4,8,1370,480,1973,1973,98008,47.638,122.11,1880,7580,41,0,4.75,3730,9430
5.2346e+05,2014,177,5,1.75,1890,5000,1,0,0,3,7,1090,800,1906,1906,98107,47.671,122.37,1610,5000,108,0,6.75,3500,6890
3.675e+05,2014,231,4,2,1960,16015,1,0,0,3,7,1960,0,1980,1980,98002,47.33,122.22,1960,16015,34,0,6,3920,17975
8.31e+05,2015,380,3,2.25,2240,8800,1,0,0,5,8,2240,0,1957,1957,98005,47.594,122.17,2240,8800,58,0,5.25,4480,11040
4.885e+05,2014,300,3,2.75,1820,9490,2,0,0,3,7,1820,0,1994,1994,98011,47.748,122.18,1950,8851,20,0,5.75,3770,10671
1.5e+05,2014,286,2,1,840,12750,1,0,0,3,6,840,0,1925,1925,98055,47.484,122.21,1480,6969,89,0,3,2320,7809
2.79e+05,2014,202,4,2,1560,7569,1,0,0,4,7,1560,0,1966,1966,98058,47.45,122.16,1480,8755,48,0,6,3040,10315
1.537e+06,2014,285,5,3.75,4470,8088,2,0,0,3,11,4470,0,2008,2008,98004,47.632,122.2,2780,8964,6,0,8.75,7250,13434
1.075e+06,2014,280,3,2.5,2830,56628,2,0,0,3,11,2830,0,2001,2001,98011,47.741,122.2,2830,16430,13,0,5.5,5660,19260
3.85e+05,2014,332,4,2.75,2960,10454,1,0,1,3,8,2360,600,1979,1979,98198,47.401,122.32,1870,10500,35,0,6.75,4830,13460
7.5e+05,2014,352,4,2.75,3430,13907,2,0,0,3,11,3430,0,1995,1995,98075,47.588,121.99,3250,13851,19,0,6.75,6680,17281
5.05e+05,2015,478,3,2,1110,8375,1,0,0,5,7,1110,0,1951,1951,98115,47.698,122.3,1410,7734,64,0,5,2520,8844
4.5e+05,2015,425,4,3,2200,4466,2,0,0,3,7,2200,0,1968,1968,98103,47.7,122.34,1780,2250,47,0,7,3980,4450
1.378e+06,2015,453,5,3.5,3680,8680,2,0,0,3,9,3680,0,2003,2003,98033,47.657,122.2,2020,8847,12,0,8.5,5700,12527
1e+05,2014,180,2,1,930,7623,1,0,0,2,6,930,0,1942,1942,98166,47.467,122.35,1300,7641,72,0,3,2230,8571
5.56e+05,2014,286,4,2.5,2230,7200,1,0,0,4,7,1220,1010,1957,1957,98005,47.589,122.16,1920,7200,57,0,6.5,4150,9430
4.85e+05,2014,196,3,2.5,1800,11034,2,0,0,4,8,1800,0,1987,1987,98072,47.756,122.14,1940,8900,27,0,5.5,3740,10700
1.85e+05,2014,195,5,1.75,1990,27810,1,0,0,3,7,1990,0,1955,1955,98023,47.333,122.35,2240,20000,59,0,6.75,4230,21990
1.325e+06,2014,169,4,2.5,2440,3600,2,0,0,4,8,2440,0,1902,1902,98119,47.63,122.36,2440,5440,112,0,6.5,4880,7880
5.3e+05,2014,263,3,1.5,1950,1963,3,0,0,3,8,1950,0,2002,2002,98117,47.69,122.4,1590,2028,12,0,4.5,3540,3978
5.75e+05,2014,314,3,2.5,1870,3485,2,0,0,3,8,1870,0,2001,2001,98029,47.549,122,1940,3485,13,0,5.5,3810,5355
3.2e+05,2014,187,3,1,1560,7552,1,0,0,4,6,910,650,1948,1948,98155,47.755,122.33,1200,8152,66,0,4,2760,9712
2.511e+05,2014,339,4,2.5,1790,5257,2,0,0,3,7,1790,0,1996,1996,98030,47.385,122.2,1680,5320,18,0,6.5,3470,7110
3.8e+05,2014,250,3,1.5,1540,8400,1,0,0,5,7,1540,0,1968,1968,98056,47.524,122.2,1690,7689,46,0,4.5,3230,9229
2.8e+05,2014,150,2,1,1880,7560,1,0,0,3,6,940,940,1919,1919,98126,47.526,122.37,1280,7560,95,0,3,3160,9440
2.35e+05,2014,353,3,1,1240,18000,1,0,0,2,7,1240,0,1943,1943,98198,47.351,122.31,1240,18000,71,0,4,2480,19240
5.65e+05,2014,155,3,2.75,2390,9966,1,0,0,5,8,1360,1030,1977,1977,98006,47.543,122.19,2140,10713,37,0,5.75,4530,13103
5.2e+05,2014,348,3,1.75,2080,6609,1,0,0,3,7,1280,800,1950,1950,98115,47.688,122.3,1680,6270,64,0,4.75,3760,8350
5.49e+05,2014,198,3,2.25,1920,10961,2,0,0,3,8,1920,0,1981,1981,98074,47.643,122.06,2000,10706,33,0,5.25,3920,12626
5.575e+05,2014,278,3,3.5,3350,5025,2,0,2,3,8,2670,680,2014,2014,98144,47.57,122.3,2030,5117,0,0,6.5,5380,8467
2.8745e+05,2015,401,3,2.5,1440,2500,2,0,0,3,7,1440,0,2008,2008,98146,47.512,122.36,1440,5000,7,0,5.5,2880,6440
8.08e+05,2014,181,4,2.25,2500,8866,2,0,0,4,9,2500,0,1987,1987,98007,47.66,122.15,2630,8847,27,0,6.25,5130,11347
9.89e+05,2014,182,6,4.5,3830,4800,3,0,0,3,9,3050,780,1919,2004,98119,47.64,122.36,1990,4800,95,1,10.5,5820,8630
1.33e+06,2014,175,3,1.5,1940,2885,1,0,2,3,8,1940,0,1900,1900,98119,47.631,122.37,2550,3600,114,0,4.5,4490,5540
2.65e+05,2015,465,3,1,1360,5967,1,0,0,3,6,1360,0,1954,1954,98178,47.497,122.26,1360,6052,61,0,4,2720,7412
3.5e+05,2015,450,4,1.75,2310,9002,1,0,0,3,7,1780,530,1970,1970,98034,47.731,122.17,2090,8814,45,0,5.75,4400,11124
3.65e+05,2014,305,4,1,1590,7085,1,0,0,3,6,1590,0,1944,1944,98125,47.731,122.31,1320,7085,70,0,5,2910,8675
5.3995e+05,2014,159,3,2.25,2190,7149,1,0,1,4,8,1240,950,1963,1963,98056,47.524,122.2,3500,7149,51,0,5.25,5690,9339
7.32e+05,2014,138,3,2,1940,55756,1,0,0,5,9,1940,0,1954,1954,98007,47.591,122.15,2330,10018,60,0,5,4270,11958
6.999e+05,2014,346,4,2.75,2810,7302,2,0,0,3,9,2810,0,2002,2002,98075,47.599,121.98,2820,7302,12,0,6.75,5630,10112
4.26e+05,2014,140,4,2.5,2800,8494,2,0,0,3,8,2800,0,2004,2004,98038,47.352,122.01,3740,8494,10,0,6.5,6540,11294
3e+05,2014,293,3,2.25,1730,10030,1,0,0,4,8,1730,0,1985,1985,98023,47.311,122.34,2090,8823,29,0,5.25,3820,10553
5.985e+05,2014,266,3,2.25,2520,12000,1,0,0,3,10,2520,0,1978,1978,98074,47.638,122.06,2510,12000,36,0,5.25,5030,14520
5.05e+05,2014,132,4,1.75,1940,4800,1,0,0,5,7,1030,910,1922,1922,98122,47.605,122.31,1450,4800,92,0,5.75,3390,6740
1.27e+06,2014,136,4,3,5520,8313,2,0,3,3,9,3570,1950,2008,2008,98006,47.566,122.13,3770,8278,6,0,7,9290,13798
4.565e+05,2014,304,4,2.5,2400,6811,2,0,0,3,8,2400,0,2007,2007,98059,47.496,122.15,2710,5314,7,0,6.5,5110,7714
4.32e+05,2014,259,3,2.5,1660,15000,1,0,0,4,7,1660,0,1970,1970,98075,47.58,122.05,2060,15015,44,0,5.5,3720,16675
7.5e+05,2014,173,3,2,1820,5000,1,0,0,4,8,1720,100,1941,1941,98116,47.584,122.39,2220,7200,73,0,5,4040,9020
5.55e+05,2014,216,3,2.5,2480,8676,2,0,0,4,8,2480,0,1989,1989,98056,47.53,122.17,2540,9496,25,0,5.5,5020,11976
6.55e+05,2014,216,4,2.75,3160,8197,1,0,0,3,8,1580,1580,1962,1962,98115,47.7,122.29,2050,8197,52,0,6.75,5210,11357
4.1225e+05,2015,446,2,2,1300,2983,1,0,0,3,8,1300,0,2006,2006,98053,47.703,122.02,1510,3876,9,0,4,2810,5176
6.3998e+05,2014,284,5,3,2800,5700,2,0,0,3,8,2800,0,2014,2014,98059,47.497,122.14,2910,5349,0,0,8,5710,8149
2e+05,2014,352,2,1,920,5250,1,0,0,4,6,920,0,1906,1906,98118,47.518,122.27,1210,5250,108,0,3,2130,6170
4.05e+05,2014,222,2,1,1090,10481,1,0,0,2,7,780,310,1981,1981,98074,47.632,122.03,1160,10533,33,0,3,2250,11623
1.55e+06,2015,416,5,2.5,2450,20805,2,0,0,4,9,2450,0,1963,1963,98004,47.627,122.23,3020,20324,52,0,7.5,5470,22774
2.95e+05,2014,303,2,1,1300,39639,1,0,0,4,6,1300,0,1960,1960,98070,47.466,122.45,1880,98881,54,0,3,3180,1.0018e+05
4.25e+05,2015,432,3,2.5,1950,4345,2,0,0,3,7,1950,0,2007,2007,98065,47.52,121.87,2260,4345,8,0,5.5,4210,6295
1e+06,2014,345,3,1,1880,5450,1,0,0,4,8,1880,0,1924,1924,98112,47.645,122.3,2580,5450,90,0,4,4460,7330
9.82e+05,2014,177,4,2.75,3610,8580,2,0,0,3,9,3610,0,2014,2014,98033,47.671,122.17,2360,8580,0,0,6.75,5970,12190
1.5e+06,2015,478,6,3.5,3670,3959,2,0,0,3,10,2410,1260,2008,2008,98119,47.636,122.37,2060,3625,7,0,9.5,5730,7295
9.75e+05,2015,433,4,2.25,2240,9990,2,0,0,4,10,2240,0,1967,1967,98040,47.552,122.22,2600,11480,48,0,6.25,4840,13720
2.95e+05,2015,485,3,2.5,1690,8564,2,0,0,4,7,1690,0,1992,1992,98038,47.352,122.06,1690,7532,23,0,5.5,3380,9222
2.86e+05,2014,293,3,2.5,1680,5000,2,0,0,3,8,1680,0,1987,1987,98023,47.32,122.39,1720,5000,27,0,5.5,3400,6680
5.8e+05,2014,181,3,2.5,2200,11000,2,0,2,3,9,2200,0,1978,1978,98008,47.592,122.11,2200,12851,36,0,5.5,4400,15051
2.525e+05,2015,486,2,1.5,1110,986,2,0,0,3,7,950,160,2009,2009,98118,47.543,122.27,1110,3515,6,0,3.5,2220,4625
4.97e+05,2014,173,3,2.25,1630,3817,2,0,0,3,7,1630,0,2005,2005,98029,47.548,122,1630,3348,9,0,5.25,3260,4978
4.79e+05,2014,144,3,1,1370,3000,1,0,0,3,7,1370,0,1924,1924,98103,47.662,122.35,1510,2151,90,0,4,2880,3521
