7.25e+05,2015,445,4,2.25,3180,9600,2,0,0,3,10,3180,0,1984,1984,98074,47.631,122.05,2840,10739,31,0,6.25,6020,13919
1.5989e+06,2015,394,4,4.5,3780,6000,2,0,4,4,11,2770,1010,1910,1977,98116,47.592,122.39,2660,6000,105,1,8.5,6440,9780
7.1e+05,2015,403,3,2.5,2330,9160,2,0,0,3,9,2330,0,1997,1997,98006,47.547,122.18,2460,9160,18,0,5.5,4790,11490
5.507e+05,2015,406,2,2.25,1190,1499,2,0,0,3,9,1100,90,2004,2004,98105,47.667,122.28,1430,1332,11,0,4.25,2620,2522
7.2e+05,2014,237,4,1.75,2530,5000,1,0,2,5,8,2070,460,1917,1917,98103,47.662,122.35,1950,3600,97,0,5.75,4480,6130
3.15e+05,2014,359,3,2,1900,9513,1,0,0,3,8,1900,0,1995,1995,98023,47.284,122.36,1790,8028,19,0,5,3690,9928
2.5995e+05,2015,431,4,1.75,1400,7920,1,0,0,3,7,1400,0,1963,1963,98058,47.466,122.18,1910,7700,52,0,5.75,3310,9100
7.19e+05,2014,128,3,2.5,1690,4500,1,0,1,4,8,1690,0,1928,1928,98116,47.584,122.38,2140,7200,86,0,5.5,3830,8890
1.185e+06,2015,434,7,3.5,3890,8342,2,0,4,3,9,2840,1050,1968,1968,98117,47.701,122.39,2870,8342,47,0,10.5,6760,12232
2.1475e+06,2014,182,3,3.5,4660,5500,2,0,4,5,10,3040,1620,1909,1909,98102,47.647,122.32,2980,5500,105,0,6.5,7640,10160
6.63e+05,2014,312,3,2.5,1910,5125,2,0,0,3,9,1910,0,2006,2006,98029,47.548,122,1910,3215,8,0,5.5,3820,5125
3.6e+05,2014,297,4,2.25,2620,8100,1,0,0,4,7,1550,1070,1964,1964,98166,47.456,122.35,1650,8100,50,0,6.25,4270,10720
6.195e+05,2015,436,6,1.5,1680,5202,1,0,0,2,7,1680,0,1911,1911,98033,47.68,122.21,1890,5500,104,0,7.5,3570,7180
2.15e+05,2015,479,3,1,980,5600,1,0,0,2,6,980,0,1949,1949,98106,47.531,122.36,1840,5302,66,0,4,2820,6282
6.8e+05,2014,209,3,1.75,1620,5500,1,0,0,3,7,1110,510,1950,1950,98112,47.639,122.31,2100,6500,64,0,4.75,3720,8120
3.02e+05,2014,255,4,2.5,1740,7895,2,0,0,3,7,1740,0,1999,1999,98001,47.34,122.28,1720,6813,15,0,6.5,3460,8553
5.4e+05,2014,158,5,3,2870,4369,2,0,0,3,8,2090,780,2007,2007,98011,47.745,122.19,2640,4610,7,0,8,5510,7480
3.3e+05,2015,486,3,1,1060,20040,1,0,0,3,6,1060,0,1943,1943,98034,47.728,122.23,1768,10800,72,0,4,2828,11860
1.388e+06,2015,478,4,2.25,2940,20384,2,0,0,4,9,2940,0,1970,1970,98004,47.621,122.23,3410,19910,45,0,6.25,6350,22850
5.65e+05,2014,136,3,2.25,1520,1221,3,0,0,3,8,1520,0,2013,2013,98107,47.674,122.38,1550,4750,1,0,5.25,3070,6270
5.77e+05,2014,173,3,2.5,2060,5750,1,0,0,3,7,1330,730,1976,1976,98116,47.567,122.39,1920,5750,38,0,5.5,3980,7810
3.13e+05,2014,284,4,1.75,1630,3000,1,0,0,3,7,930,700,1978,1978,98144,47.596,122.31,1630,3000,36,0,5.75,3260,4630
5.6e+05,2015,409,4,2.5,3270,24750,1,0,0,4,8,1690,1580,1979,1979,98056,47.522,122.18,1520,13480,36,0,6.5,4790,16750
6.45e+05,2014,242,4,2.25,2720,18295,1,0,0,4,8,2000,720,1979,1979,98075,47.585,122.07,2720,18295,35,0,6.25,5440,21015
3.2e+05,2014,209,3,1.75,2300,12000,1,0,0,3,8,1770,530,1942,1942,98133,47.76,122.34,2030,6000,72,0,4.75,4330,8300
2.3e+05,2014,263,3,1,1640,7187,1,0,0,3,7,1640,0,1966,1966,98058,47.455,122.18,1340,8346,48,0,4,2980,9986
5.15e+05,2014,196,3,2.5,2360,11254,1,0,2,3,9,2360,0,1990,1990,98003,47.336,122.33,2390,11254,24,0,5.5,4750,13614
7.3e+05,2014,152,4,2,2360,6000,1,0,0,5,7,1260,1100,1939,1939,98199,47.653,122.41,1720,6000,75,0,6,4080,8360
6.49e+05,2015,429,2,2.75,2090,23962,2,0,3,4,8,2090,0,1988,1988,98070,47.414,122.44,1820,32340,27,0,4.75,3910,34430
7.15e+05,2014,304,5,1.75,1920,6500,1,0,0,3,7,1260,660,1951,1951,98112,47.639,122.31,1970,5500,63,0,6.75,3890,7420
4.75e+05,2015,466,3,2.25,1190,1200,3,0,0,3,8,1190,0,2008,2008,98103,47.654,122.35,1180,1224,7,0,5.25,2370,2414
5.275e+05,2014,291,3,2.5,1380,1389,3,0,0,3,8,1380,0,2008,2008,98102,47.643,122.33,1380,1249,6,0,5.5,2760,2629
5.645e+05,2015,443,4,2.25,1950,6000,1,0,0,3,7,1350,600,1961,1961,98115,47.691,122.3,1980,6000,54,0,6.25,3930,7950
3.375e+05,2014,134,5,2,1700,7314,1,0,0,3,7,1000,700,1956,1956,98108,47.549,122.31,2000,7176,58,0,7,3700,8876
6.5e+05,2015,410,4,1.75,1900,10454,1,0,0,4,7,1180,720,1954,1954,98004,47.593,122.19,2060,11325,61,0,5.75,3960,13225
2.7e+05,2014,248,3,2.25,1750,8400,1,0,0,3,7,1350,400,1965,1965,98188,47.457,122.27,2020,9110,49,0,5.25,3770,10860
4.965e+05,2015,368,3,2.5,2260,3640,2,0,0,3,8,2260,0,1994,1994,98072,47.736,122.16,2350,3710,21,0,5.5,4610,5970
1.62e+05,2015,367,4,1,1460,16638,1,0,0,4,6,1460,0,1975,1975,98010,47.343,122.05,1460,16638,40,0,5,2920,18098
6.4e+05,2014,232,4,2.5,2320,11259,2,0,0,3,9,2320,0,1982,1982,98004,47.644,122.19,2820,11770,32,0,6.5,5140,14090
6.15e+05,2015,383,3,1.75,2110,56192,1,0,0,3,7,1480,630,1978,1978,98072,47.77,122.14,2570,46609,37,0,4.75,4680,48719
3.15e+05,2014,338,3,3.25,1480,983,2,0,0,3,8,1180,300,2013,2013,98106,47.556,122.36,1330,1062,1,0,6.25,2810,2542
3.55e+05,2014,177,2,2.25,1330,10838,2,0,0,3,8,1330,0,1985,1985,98028,47.769,122.24,1390,10310,29,0,4.25,2720,11640
1.038e+06,2014,182,4,1.75,1440,13296,1,0,0,4,8,1440,0,1967,1967,98004,47.634,122.2,3520,10802,47,0,5.75,4960,12242
2.1877e+06,2014,222,4,4.5,4240,13162,2,0,0,3,10,4240,0,2004,2004,98039,47.619,122.23,3010,12163,10,0,8.5,7250,16403
2.72e+05,2014,286,4,2.25,2040,7600,1,0,0,4,8,1580,460,1978,1978,98023,47.317,122.36,2130,7200,36,0,6.25,4170,9240
4.752e+05,2014,221,3,2.5,1670,3980,2,0,0,3,8,1670,0,2000,2000,98027,47.532,122.05,1670,2897,14,0,5.5,3340,4567
3.342e+05,2015,443,3,1.75,1410,45302,1,0,0,3,7,1410,0,1980,1980,98019,47.708,121.91,2240,49222,35,0,4.75,3650,50632
2e+05,2014,161,2,1,700,4700,1,0,0,5,5,700,0,1953,1953,98056,47.495,122.17,960,5200,61,0,3,1660,5900
8.031e+05,2014,135,4,2.5,3310,5404,2,0,0,3,9,3310,0,2004,2004,98052,47.663,122.08,2600,4730,10,0,6.5,5910,8040
3.65e+05,2014,283,4,2.25,1990,21312,1,0,0,4,8,1990,0,1968,1968,98058,47.439,122.14,2400,19210,46,0,6.25,4390,21200
5.2e+05,2015,388,4,2.5,2410,6440,1,0,0,3,8,1550,860,1974,1974,98034,47.715,122.19,2330,6938,41,0,6.5,4740,9348
4.9e+05,2015,478,3,2.25,2330,3600,1,0,0,3,8,2330,0,1971,1971,98074,47.631,122.06,2050,4275,44,0,5.25,4380,6605
2.99e+05,2014,297,3,1.5,1190,9135,1,0,0,4,7,1190,0,1959,1959,98056,47.516,122.19,1520,9146,55,0,4.5,2710,10336
3.99e+05,2014,312,2,1,790,4000,1,0,0,3,6,790,0,1948,1948,98115,47.684,122.29,990,5000,66,0,3,1780,5790
5.4213e+05,2014,196,4,2.5,2360,43088,2,0,0,3,8,2360,0,1977,1977,98077,47.766,122.07,2850,39216,37,0,6.5,5210,41576
3.35e+05,2014,293,4,2.5,1980,4745,2,0,0,3,7,1980,0,2004,2004,98038,47.349,122.04,1980,4878,10,0,6.5,3960,6858
3.6128e+05,2014,127,2,1,820,6400,1,0,0,4,7,820,0,1944,1944,98126,47.55,122.38,1490,6400,70,0,3,2310,7220
2.72e+05,2014,361,4,2.75,1810,7350,1,0,0,4,7,1200,610,1980,1980,98030,47.37,122.17,1750,7350,34,0,6.75,3560,9160
3.25e+05,2015,401,3,1.5,1320,7560,1,0,0,3,6,840,480,1983,1983,98019,47.745,121.98,1210,7560,32,0,4.5,2530,8880
2.99e+05,2014,215,1,1,740,5000,1,0,0,3,7,740,0,1923,1923,98118,47.552,122.29,1400,4400,91,0,2,2140,5140
4.6e+05,2014,320,4,2,2090,40419,1,0,0,4,7,2090,0,1984,1984,98027,47.469,121.99,2380,63162,30,0,6,4470,65252
3.75e+05,2014,217,3,2.5,2320,5760,1,0,0,3,7,1480,840,1987,1987,98178,47.504,122.25,1660,5762,27,0,5.5,3980,8082
5.835e+05,2015,392,4,1,1530,3900,1,0,0,4,7,1530,0,1908,1908,98107,47.675,122.38,1300,3900,107,0,5,2830,5430
2.485e+05,2015,366,3,2.5,1360,7293,2,0,0,3,8,1360,0,1988,1988,98003,47.33,122.3,1540,7353,27,0,5.5,2900,8713
9e+05,2015,401,6,3,2620,4350,1,0,0,3,7,1760,860,1957,1957,98117,47.678,122.37,1760,4300,58,0,9,4380,6920
3.4e+05,2015,403,4,2.5,2181,5521,2,0,0,3,8,2181,0,2006,2006,98001,47.35,122.29,2333,5143,9,0,6.5,4514,7324
3.623e+05,2014,173,3,2.5,2430,15264,2,0,0,3,8,2430,0,1997,1997,98030,47.38,122.21,2260,10416,17,0,5.5,4690,12846
4.03e+05,2015,470,2,1,894,1552,2,0,0,3,7,894,0,2011,2011,98115,47.691,122.31,1131,1992,4,0,3,2025,2886
7.2495e+05,2015,452,4,2.5,2860,3638,1,0,2,5,7,1720,1140,1924,1924,98107,47.663,122.36,1760,3880,91,0,6.5,4620,6740
5.5e+05,2015,401,4,2.5,2090,6926,2,0,0,3,8,2090,0,1990,1990,98074,47.634,122.02,2000,7151,25,0,6.5,4090,9241
5.45e+05,2014,203,4,2.75,3410,35040,2,0,0,3,9,3410,0,1984,1984,98038,47.405,122.03,2580,37263,30,0,6.75,5990,40673
6.325e+05,2014,170,4,2.5,2090,10306,2,0,0,3,10,2090,0,1986,1986,98074,47.63,122.05,2660,11481,28,0,6.5,4750,13571
9.75e+05,2014,314,5,3.5,5470,35071,2,0,0,3,11,4590,880,1976,1976,98005,47.637,122.16,3600,35074,38,0,8.5,9070,40544
4.4995e+05,2015,472,4,3,3290,10783,2,0,0,3,9,3290,0,1990,1990,98031,47.39,122.18,2810,10783,25,0,7,6100,14073
5.35e+05,2014,147,4,2.5,2340,5600,2,0,0,3,7,2340,0,1921,2013,98146,47.512,122.38,1310,5600,93,1,6.5,3650,7940
4.7e+05,2014,290,3,3.5,1280,1257,2,0,0,3,8,1040,240,2000,2000,98107,47.672,122.37,1280,1249,14,0,6.5,2560,2529
5e+05,2014,325,4,2,2760,27631,2,0,0,4,8,1800,960,1978,1978,98155,47.748,122.29,2490,13158,36,0,6,5250,15918
6.5245e+05,2014,333,3,2.25,2230,11835,1,0,0,5,8,1630,600,1974,1974,98006,47.563,122.18,2190,10384,40,0,5.25,4420,12614
4.55e+05,2014,221,3,2.75,2720,31314,3,0,2,3,8,2720,0,1986,1986,98042,47.369,122.16,2290,15188,28,0,5.75,5010,17908
6.0145e+05,2014,278,2,3.25,1840,1500,3,0,0,3,8,1840,0,2001,2001,98103,47.66,122.35,1910,2500,13,0,5.25,3750,4340
8.05e+05,2014,320,4,3,3350,23781,1,0,0,4,9,2020,1330,1979,1979,98006,47.56,122.13,2870,12036,35,0,7,6220,15386
6.25e+05,2014,208,4,2.5,1750,9000,1,0,0,3,8,1410,340,1977,2003,98052,47.64,122.11,2120,9600,37,1,6.5,3870,11350
3.165e+05,2015,458,3,1.75,1460,6360,1,0,2,3,7,1010,450,1979,1979,98106,47.531,122.35,1400,4240,36,0,4.75,2860,5700
5.0305e+05,2014,202,3,3,1560,2250,2,0,0,3,9,1560,0,2009,2009,98103,47.693,122.33,1610,4500,5,0,6,3170,6060
2.62e+05,2014,266,3,2.5,1700,6200,2,0,0,3,8,1700,0,1997,1997,98092,47.262,122.22,1720,6205,17,0,5.5,3420,7905
3.96e+05,2015,463,2,1.5,950,865,3,0,0,3,8,950,0,2006,2006,98107,47.671,122.38,1290,1189,9,0,3.5,2240,2139
7.25e+05,2014,147,4,2.5,2740,12899,2,0,0,4,10,2740,0,1990,1990,98075,47.581,122.03,2830,9453,24,0,6.5,5570,12193
4.29e+05,2014,231,4,2.5,1840,4593,2,0,0,3,7,1840,0,2010,2010,98053,47.687,122.01,1740,3600,4,0,6.5,3580,5440
3.4615e+05,2014,169,3,2,2140,7200,1,0,0,4,8,1480,660,1966,1966,98056,47.508,122.19,2070,7220,48,0,5,4210,9360
2.55e+05,2014,359,3,2.25,1320,963,2,0,0,3,7,1040,280,2007,2007,98106,47.52,122.36,1300,1285,7,0,5.25,2620,2605
2.7e+05,2015,445,3,2.25,2390,7000,1,0,0,4,7,1990,400,1970,1970,98058,47.457,122.17,1610,7000,45,0,5.25,4000,9390
2.08e+05,2014,194,2,1,820,5700,1,0,0,5,5,820,0,1942,1942,98056,47.492,122.18,1000,5700,72,0,3,1820,6520
3.6795e+05,2014,223,3,1.75,2290,8234,1,0,0,4,7,1250,1040,1950,1950,98133,47.761,122.35,1660,7200,64,0,4.75,3950,9490
3.355e+05,2014,229,3,1.75,1260,8487,1,0,0,3,7,1260,0,1970,1970,98011,47.766,122.2,1890,13051,44,0,4.75,3150,14311
4.325e+05,2014,249,3,2.5,1340,8867,2,0,0,3,8,1340,0,1984,1984,98125,47.724,122.33,1630,7287,30,0,5.5,2970,8627
6.25e+05,2014,271,3,1.75,1660,4800,2,0,0,3,7,1660,0,1906,2014,98112,47.63,122.31,1660,4800,108,1,4.75,3320,6460
4.13e+05,2015,438,5,2.5,2900,8711,1,0,0,3,8,1650,1250,1977,1977,98011,47.775,122.2,2340,8869,38,0,7.5,5240,11769
7.125e+05,2015,475,3,1.75,1770,2800,1,0,0,3,7,1770,0,1914,1914,98103,47.663,122.36,1630,3254,101,0,4.75,3400,5024
2.51e+05,2015,416,3,2,1200,10212,1,0,0,5,6,1200,0,1949,1949,98022,47.206,122,1280,10212,66,0,5,2480,11412
3.99e+05,2014,312,3,1,990,4250,1,0,0,4,7,840,150,1924,1924,98136,47.539,122.39,990,4500,90,0,4,1980,5490
3e+05,2014,152,4,2.5,2070,7476,2,0,0,3,8,2070,0,2003,2003,98092,47.335,122.19,2430,5500,11,0,6.5,4500,7570
2.2995e+05,2014,264,5,2.75,2000,5885,1,0,0,3,7,1260,740,1994,1994,98023,47.316,122.35,1960,6514,20,0,7.75,3960,8514
3.6e+05,2014,202,3,1.75,1300,7770,1,0,0,3,7,1300,0,1967,1967,98034,47.735,122.19,1520,7600,47,0,4.75,2820,8900
6.55e+05,2015,447,3,2.5,2320,4721,2,0,0,3,8,2320,0,2004,2004,98075,47.591,122.02,2250,4356,11,0,5.5,4570,6676
3.3495e+05,2015,403,4,2.5,2230,5500,2,0,0,3,7,2230,0,1999,1999,98038,47.353,122.02,1910,5500,16,0,6.5,4140,7730
2.65e+05,2015,466,3,1.75,1330,12618,1,0,3,3,7,1330,0,1983,1983,98188,47.44,122.27,1870,8429,32,0,4.75,3200,9759
3.03e+05,2015,440,3,2.25,1340,873,3,0,0,3,8,1340,0,2009,2009,98133,47.733,122.34,1340,1186,6,0,5.25,2680,2526
3.5e+05,2015,480,5,1.75,1380,7620,1,0,0,3,7,1180,200,1955,1955,98106,47.528,122.34,1990,7620,60,0,6.75,3370,9000
2.4e+05,2014,333,3,1.5,1890,9000,1,0,0,3,7,1190,700,1959,1959,98188,47.443,122.27,2060,9000,55,0,4.5,3950,10890
2.89e+05,2014,264,3,2,1850,9550,1,0,0,3,8,1850,0,1988,1988,98001,47.322,122.27,2250,9550,26,0,5,4100,11400
5.655e+05,2015,453,3,1.75,1780,5850,1,0,0,5,7,980,800,1944,1944,98116,47.559,122.39,1550,5850,71,0,4.75,3330,7630
2.38e+05,2014,239,1,1,530,6350,1,0,0,5,5,530,0,1941,1941,98103,47.695,122.36,1200,6350,73,0,2,1730,6880
2.35e+05,2014,236,2,1,910,7617,1,0,0,3,6,910,0,1936,1936,98125,47.733,122.31,1310,6624,78,0,3,2220,7534
3.3e+05,2014,214,3,1.75,1460,9261,1,0,0,3,7,1460,0,1985,1985,98056,47.516,122.19,1550,8800,29,0,4.75,3010,10260
6.12e+05,2015,467,3,2.5,2120,7401,2,0,0,3,8,2120,0,1989,1989,98029,47.578,122.02,2010,7972,26,0,5.5,4130,10092
4.2e+05,2014,342,3,1.5,1780,5000,1,0,4,4,7,1030,750,1958,1958,98118,47.517,122.26,1780,7500,56,0,4.5,3560,9280
2.5e+05,2014,155,3,2.5,1510,10384,1,0,0,2,7,1030,480,1976,1976,98077,47.758,122.07,1490,10000,38,0,5.5,3000,11510
5.8e+05,2015,439,3,1.75,1950,10633,1,0,0,3,7,1250,700,1978,1978,98125,47.702,122.31,1290,6380,37,0,4.75,3240,8330
3.852e+05,2014,299,1,1,710,6000,1,0,0,3,6,710,0,2015,2015,98144,47.576,122.32,1440,4800,-1,0,2,2150,5510
2.4e+05,2015,488,3,1,1310,7125,1,0,0,4,7,1310,0,1978,1978,98042,47.374,122.15,1650,7290,37,0,4,2960,8600
7.79e+05,2014,236,3,1.75,2320,6400,1,0,2,4,8,1420,900,1957,1957,98199,47.645,122.39,2540,7680,57,0,4.75,4860,10000
8.12e+05,2014,170,3,3.25,3240,8338,2,0,0,3,9,3240,0,2001,2001,98074,47.632,122.06,3420,8405,13,0,6.25,6660,11645
6.525e+05,2015,486,4,1.75,3130,18253,2,0,0,3,7,3130,0,1978,1978,98133,47.74,122.35,1850,12220,37,0,5.75,4980,15350
2.99e+05,2014,208,3,2.5,1590,3121,2,0,0,3,7,1590,0,1994,1994,98118,47.551,122.28,1090,4900,20,0,5.5,2680,6490
8.11e+05,2014,284,3,1.75,1870,9897,1,0,0,4,8,1870,0,1960,1960,98040,47.55,122.22,1900,10005,54,0,4.75,3770,11875
5e+05,2014,325,4,4.5,2690,7350,1,0,0,5,7,2690,0,1949,1949,98125,47.706,122.31,1660,9000,65,0,8.5,4350,11690
3.085e+05,2014,122,2,1,850,6174,1,0,0,4,7,850,0,1950,1950,98155,47.735,122.33,1100,6174,64,0,3,1950,7024
4.1e+05,2014,204,3,2.5,1740,4948,2,0,0,3,7,1740,0,2008,2008,98053,47.697,122.03,1290,3383,6,0,5.5,3030,5123
5.25e+05,2014,182,2,1.75,1530,3503,1,0,1,4,7,830,700,1916,1916,98119,47.637,122.37,1280,1531,98,0,3.75,2810,3061
1.75e+05,2014,287,2,1,960,5508,1,0,0,3,6,770,190,1951,1951,98118,47.531,122.28,1280,5304,63,0,3,2240,6264
3.9995e+05,2014,333,4,3,2150,64694,1,0,0,3,8,1450,700,1969,1969,98023,47.327,122.39,2430,59612,45,0,7,4580,61762
9.75e+05,2014,339,4,2.25,2420,15482,2,0,0,4,8,2420,0,1925,1997,98004,47.591,122.2,2870,13905,89,1,6.25,5290,16325
2.48e+05,2015,452,3,1.75,1840,19501,1,0,0,4,8,1270,570,1972,1972,98003,47.336,122.32,1910,12000,43,0,4.75,3750,13840
2.899e+05,2014,345,3,1.75,1899,11325,2,0,0,3,7,1899,0,1943,2005,98198,47.399,122.3,2000,10454,71,1,4.75,3899,12353
7.43e+05,2014,162,3,1.75,2110,11250,1,0,0,4,8,2110,0,1961,1961,98040,47.54,122.22,2560,10992,53,0,4.75,4670,13102
5.75e+05,2014,305,5,2.25,3550,7992,2,0,0,3,8,3550,0,1968,1968,98034,47.728,122.18,2110,7992,46,0,7.25,5660,11542
5.185e+05,2014,231,4,3,2120,5520,1,0,0,3,8,1420,700,1985,1985,98125,47.709,122.29,2020,8700,29,0,7,4140,10820
3.33e+05,2014,256,4,1.75,1880,9880,1,0,0,4,8,1880,0,1967,1967,98058,47.455,122.15,1880,9600,47,0,5.75,3760,11480
3.7995e+05,2014,125,4,1.75,1970,9389,1,0,0,5,7,1140,830,1960,1960,98133,47.777,122.34,1820,8135,54,0,5.75,3790,10105
5.205e+05,2015,465,6,2.5,1880,14350,1,0,0,5,7,1640,240,1955,1955,98133,47.756,122.35,1510,9840,60,0,8.5,3390,11720
6.49e+05,2014,228,4,2,2240,11040,1,0,0,5,8,1120,1120,1961,1961,98033,47.693,122.17,1790,11040,53,0,6,4030,13280
3.22e+05,2014,342,4,1,1750,68841,1,0,0,3,7,1750,0,1942,1942,98058,47.444,122.08,1550,32799,72,0,5,3300,34549
7.16e+05,2015,447,3,1.5,1140,4800,1,0,0,3,7,1140,0,1915,1915,98109,47.637,122.35,1260,4800,100,0,4.5,2400,5940
3.0895e+05,2014,188,4,2.5,1920,8562,2,0,2,4,7,1920,0,1994,1994,98022,47.193,122.01,1820,8628,20,0,6.5,3740,10548
6.725e+05,2014,291,4,2.5,3470,6651,2,0,0,3,9,3470,0,2005,2005,98065,47.543,121.88,2730,6179,9,0,6.5,6200,9649
3.8495e+05,2014,242,3,1,1540,7740,1,0,0,4,7,1540,0,1909,1909,98126,47.522,122.38,1220,7740,105,0,4,2760,9280
4.495e+05,2014,153,5,2.75,2040,7488,1,0,0,4,7,1200,840,1969,1969,98034,47.729,122.17,1530,7488,45,0,7.75,3570,9528
1.65e+05,2015,380,2,1,780,6380,1,0,0,3,6,780,0,1947,1947,98106,47.542,122.35,1270,6960,68,0,3,2050,7740
1.8e+05,2015,368,3,1,1020,5500,1,0,0,3,7,1020,0,1961,1961,98118,47.55,122.29,1160,5500,54,0,4,2180,6520
3.09e+05,2015,470,4,2,2240,9240,1,0,0,3,7,1120,1120,1968,1968,98032,47.367,122.29,2040,8250,47,0,6,4280,10490
2.85e+05,2015,487,3,1.75,1600,7500,1,0,0,3,7,1600,0,1998,1998,98002,47.283,122.2,1620,7461,17,0,4.75,3220,9061
5.44e+05,2015,390,3,2.5,1760,1755,3,0,0,3,8,1760,0,1998,1998,98105,47.669,122.28,1700,1721,17,0,5.5,3460,3481
6.35e+05,2014,205,4,2.5,2490,40608,2,0,0,3,9,2490,0,1997,1997,98053,47.651,122,3170,45441,17,0,6.5,5660,47931
4.5e+05,2014,132,3,1.5,1770,17208,1,0,0,3,8,1160,610,1959,1959,98006,47.566,122.12,2450,17118,55,0,4.5,4220,18888
3.65e+05,2014,237,3,2.5,2200,9696,2,0,0,3,8,2200,0,1987,1987,98031,47.42,122.2,2200,9915,27,0,5.5,4400,12115
6.85e+05,2014,341,4,2.5,2770,10051,2,0,0,3,10,2770,0,1987,1987,98074,47.629,122.04,2730,10675,27,0,6.5,5500,13445
7.45e+05,2015,467,5,3,2400,10126,2,0,3,3,8,2400,0,1981,1981,98126,47.573,122.37,2250,3946,34,0,8,4650,6346
2.15e+05,2015,436,2,2,1180,2521,2,0,0,3,6,1180,0,2005,2005,98038,47.349,122.02,1310,3003,10,0,4,2490,4183
6.5e+05,2015,470,4,2.5,3160,8530,2,0,0,3,9,3160,0,2006,2006,98059,47.508,122.15,3160,6460,9,0,6.5,6320,9620
3e+05,2014,305,3,1,970,12300,1,0,0,3,7,970,0,1982,1982,98028,47.733,122.23,2040,9994,32,0,4,3010,10964
7.8e+05,2015,417,3,3.5,3310,5558,2,0,0,3,9,3310,0,2005,2005,98029,47.555,122,3310,5270,10,0,6.5,6620,8580
6.59e+05,2014,338,4,2,2350,9329,2,0,0,3,8,2350,0,1977,1977,98005,47.583,122.17,1640,9403,37,0,6,3990,11753
9.8e+05,2015,460,5,4,3460,5400,2,0,0,3,10,2830,630,2012,2012,98056,47.52,122.2,1890,5400,3,0,9,5350,8860
7.35e+05,2015,376,4,3.5,3100,5600,2,0,0,3,9,3100,0,2005,2005,98075,47.597,121.98,3080,5600,10,0,7.5,6180,8700
1.75e+05,2014,201,3,1,1030,6600,1,0,0,3,7,1030,0,1954,1954,98146,47.494,122.34,1220,9040,60,0,4,2250,10070
8.02e+05,2014,244,4,2.25,2130,8734,2,0,2,4,8,2130,0,1961,1961,98006,47.567,122.16,2550,8800,53,0,6.25,4680,10930
5.05e+05,2015,375,2,1.75,1310,3816,1,0,0,2,7,1110,200,1929,1929,98117,47.679,122.37,1510,3816,86,0,3.75,2820,5126
5.395e+05,2014,354,4,2.25,2280,8550,1,0,0,3,8,1660,620,1977,1977,98034,47.701,122.23,2590,9500,37,0,6.25,4870,11780
6.25e+05,2015,381,4,2.5,2740,9599,1,0,2,3,8,1820,920,1961,1961,98177,47.773,122.39,2660,8280,54,0,6.5,5400,11020
4.855e+05,2015,458,4,2.5,2320,3974,2,0,0,3,7,2320,0,1999,1999,98065,47.532,121.88,2620,4539,16,0,6.5,4940,6859
7.07e+05,2015,474,5,2.5,3050,13212,1,0,0,4,8,1590,1460,1975,1975,98006,47.56,122.14,2550,10826,40,0,7.5,5600,13876
6.39e+05,2014,222,4,1.75,1830,6000,1,0,0,4,7,930,900,1939,1939,98199,47.654,122.41,1540,6000,75,0,5.75,3370,7830
5.5e+05,2015,394,2,1,1270,43560,1,0,0,4,5,1270,0,1908,1908,98042,47.365,122.17,1870,6960,107,0,3,3140,8230
7.05e+05,2015,413,5,3.5,3250,4800,2,0,0,3,9,2410,840,2010,2010,98106,47.562,122.36,1330,4920,5,0,8.5,4580,8170
5.578e+05,2015,459,4,1.75,1550,6000,1,0,0,5,7,1550,0,1944,1944,98199,47.657,122.4,1550,6000,71,0,5.75,3100,7550
3.6e+05,2014,196,4,1.75,2140,49658,1,0,0,5,7,2140,0,1959,1959,98010,47.358,121.92,1720,99316,55,0,5.75,3860,1.0146e+05
4.1e+05,2014,354,3,1.75,1340,9975,1,0,0,4,7,1340,0,1961,1961,98033,47.701,122.17,1340,10050,53,0,4.75,2680,11390
2.5e+05,2014,278,3,1.75,1360,16000,1,0,0,3,7,1360,0,1978,1978,98155,47.758,122.31,1360,12939,36,0,4.75,2720,14299
8e+05,2015,470,4,2.75,3010,7427,2,0,0,3,8,3010,0,2010,2010,98052,47.707,122.11,3000,4929,5,0,6.75,6010,7939
2.75e+05,2015,450,3,1.5,1400,9750,1,0,0,4,6,1400,0,1964,1964,98030,47.377,122.17,1160,9750,51,0,4.5,2560,11150
4.56e+05,2014,238,3,2,1870,8442,1,0,0,5,7,1060,810,1927,1927,98117,47.696,122.36,1640,6174,87,0,5,3510,8044
1.415e+06,2014,221,4,3,3110,4408,2,0,3,4,10,2510,600,1931,1931,98105,47.658,122.27,3250,5669,83,0,7,6360,8779
8.4e+05,2014,201,4,2.25,2720,8712,2,0,0,4,9,2720,0,1976,1976,98006,47.562,122.15,2470,8714,38,0,6.25,5190,11434
4.449e+05,2015,438,4,2.5,3120,7448,2,0,0,3,9,3120,0,1998,1998,98042,47.364,122.13,2980,8102,17,0,6.5,6100,11222
6.44e+05,2015,459,4,2.5,3310,4839,2,0,0,3,9,3310,0,2007,2007,98072,47.773,122.16,3240,5280,8,0,6.5,6550,8590
4.12e+05,2015,470,4,3,2430,7242,2,0,0,3,8,2430,0,2003,2003,98038,47.353,122.02,2430,7242,12,0,7,4860,9672
7.8e+05,2015,445,5,1.75,2330,3800,1,0,0,3,7,1360,970,1927,1927,98115,47.684,122.31,2100,3800,88,0,6.75,4430,6130
2.65e+05,2015,402,4,1.75,1860,9112,1,0,0,4,7,1110,750,1963,1963,98032,47.379,122.28,1570,9112,52,0,5.75,3430,10972
4.39e+05,2015,492,3,2.25,1430,2343,2,0,0,3,8,1430,0,2012,2012,98108,47.565,122.29,1270,1916,3,0,5.25,2700,3346
7e+05,2015,492,4,1.75,1980,10800,1,0,0,4,8,1320,660,1953,1953,98005,47.59,122.17,2310,10800,62,0,5.75,4290,12780
6.65e+05,2015,487,5,2.75,2670,4000,2,0,0,4,7,1800,870,1914,1914,98105,47.671,122.31,2460,4000,101,0,7.75,5130,6670
4.3999e+05,2014,183,3,2.5,1930,1348,2,0,0,3,8,1300,630,2005,2005,98199,47.651,122.38,1630,6000,9,0,5.5,3560,7930
5.77e+05,2015,395,4,2.25,2360,7490,2,0,0,3,8,2360,0,1979,1979,98033,47.699,122.17,2360,7490,36,0,6.25,4720,9850
2.67e+05,2014,230,3,2.5,1580,12250,2,0,0,3,8,1580,0,1993,1993,98198,47.377,122.31,1560,9900,21,0,5.5,3140,11480
2.475e+05,2015,422,3,2.25,1620,6000,1,0,0,3,7,1280,340,1998,1998,98002,47.283,122.2,1710,6318,17,0,5.25,3330,7938
9.84e+05,2015,372,4,2.25,2390,12292,1,0,0,5,9,2390,0,1962,1962,98040,47.553,122.22,2870,12337,53,0,6.25,5260,14727
4.45e+05,2014,291,3,3.25,1710,1960,2,0,0,3,8,1360,350,2004,2004,98029,47.548,122,1420,955,10,0,6.25,3130,2665
2.06e+05,2015,467,3,1,1320,9239,1,0,0,4,7,1320,0,1968,1968,98092,47.312,122.18,1320,8415,47,0,4,2640,9735
8.56e+05,2015,407,3,1.5,1480,2700,1,0,0,3,7,1480,0,1928,1928,98112,47.623,122.3,1970,4200,87,0,4.5,3450,5680
3.3e+05,2014,283,2,1,700,4000,1,0,0,3,6,700,0,1943,1943,98136,47.549,122.39,1060,6000,71,0,3,1760,6700
2.695e+05,2014,167,2,1.5,1480,7276,1,0,0,4,6,940,540,1978,1978,98056,47.494,122.17,1090,6710,36,0,3.5,2570,8190
3.14e+05,2014,297,2,1,720,4920,1,0,0,3,6,720,0,1941,1941,98126,47.535,122.37,670,4920,73,0,3,1390,5640
4.3e+05,2015,414,3,2.5,2670,12806,2,0,0,3,9,2670,0,2010,2010,98038,47.369,122.06,3010,7231,5,0,5.5,5680,9901
4.8e+05,2015,470,2,1.5,1008,26487,1,1,4,4,6,1008,0,1943,2002,98070,47.385,122.48,1132,24079,72,1,3.5,2140,25087
5.95e+05,2014,314,3,2.5,2030,5100,2,0,0,3,7,2030,0,2008,2008,98199,47.659,122.4,1790,4380,6,0,5.5,3820,6410
5.065e+05,2014,250,4,2.5,1890,7200,1,0,0,4,7,1500,390,1978,1978,98034,47.728,122.22,2070,7200,36,0,6.5,3960,9090
3.505e+05,2014,278,2,2.5,1770,4950,1,0,0,3,7,1770,0,2003,2003,98038,47.35,122.03,1770,4500,11,0,4.5,3540,6270
4.35e+05,2015,432,3,2,2660,16677,1,0,0,3,9,2210,450,1990,1990,98038,47.369,122.06,2660,11355,25,0,5,5320,14015
9.24e+05,2014,139,3,1.5,2200,5000,1,0,0,3,9,2200,0,1932,1932,98199,47.64,122.41,2860,5000,82,0,4.5,5060,7200
2.21e+05,2014,299,4,1.75,1540,7200,1,0,0,3,7,1260,280,1966,1966,98003,47.342,122.31,1540,8416,48,0,5.75,3080,9956
2.72e+05,2014,266,4,2.5,2070,6175,2,0,0,3,8,2070,0,1993,1993,98092,47.326,122.17,1940,6175,21,0,6.5,4010,8245
5.95e+05,2015,447,4,1.75,1880,4080,1,0,0,3,7,940,940,1924,1924,98115,47.675,122.33,1410,4080,91,0,5.75,3290,5960
4.75e+05,2014,332,4,2.5,2240,7245,1,0,0,4,7,1140,1100,1972,1972,98034,47.716,122.17,1740,7350,42,0,6.5,3980,9590
7.7e+05,2015,409,4,3.25,4270,6384,2,0,0,3,9,3060,1210,2001,2001,98065,47.536,121.87,2850,6285,14,0,7.25,7120,10555
4.85e+05,2014,307,3,2.25,2900,35273,2,0,0,3,9,2900,0,1986,1986,98038,47.401,122.03,2510,38487,28,0,5.25,5410,41387
3.1e+05,2014,210,3,2,2010,12950,1,0,0,3,8,2010,0,1953,1953,98034,47.722,122.23,1490,10181,61,0,5,3500,12191
3.075e+06,2014,174,4,5,4550,18641,1,1,4,3,10,2600,1950,2002,2002,98074,47.605,122.08,4550,19508,12,0,9,9100,24058
3.01e+05,2015,492,2,1,910,9000,1,0,0,3,5,910,0,1923,1923,98065,47.526,121.81,1290,9000,92,0,3,2200,9910
1.3e+05,2014,291,2,1,840,6654,1,0,0,3,7,840,0,1951,1951,98133,47.732,122.33,1350,5831,63,0,3,2190,6671
3.6e+05,2014,256,5,2.5,2130,7111,1,0,0,3,7,1330,800,1968,1968,98059,47.507,122.16,1840,7592,46,0,7.5,3970,9722
8.55e+05,2014,216,5,3.25,3420,5669,2,0,0,3,9,2620,800,2003,2003,98027,47.537,122.07,3310,6006,11,0,8.25,6730,9426
7.4e+05,2014,245,4,2,2050,4400,1,0,0,4,9,2050,0,1922,1922,98102,47.644,122.32,2320,5500,92,0,6,4370,7550
4.3e+05,2014,203,6,3,2630,8800,1,0,0,3,7,1610,1020,1959,1959,98125,47.717,122.29,1220,1173,55,0,9,3850,3803
4e+05,2014,170,3,1,1430,10005,1,0,0,4,7,1430,0,1950,1950,98133,47.718,122.34,1720,8822,64,0,4,3150,10252
7.725e+05,2015,423,4,1,1720,4410,1,0,2,3,7,1720,0,1928,1928,98117,47.679,122.4,2140,4500,87,0,5,3860,6220
3.9e+05,2014,287,3,1,1040,8075,1,0,0,4,7,1040,0,1961,1961,98033,47.67,122.18,1450,8075,53,0,4,2490,9115
1.15e+06,2014,181,4,2.5,3340,10422,2,0,0,3,10,3340,0,1996,1996,98033,47.651,122.2,1770,9490,18,0,6.5,5110,12830
3.795e+05,2014,163,3,2.25,1410,1287,2,0,0,3,7,1290,120,2005,2005,98027,47.534,122.07,1490,1435,9,0,5.25,2900,2845
4.06e+05,2015,451,2,2,1110,1095,3,0,0,3,7,980,130,2008,2008,98136,47.549,122.39,1110,1083,7,0,4,2220,2193
5.5e+05,2015,415,3,1,1260,6000,1,0,3,3,7,1260,0,1951,1951,98146,47.506,122.38,2020,6600,64,0,4,3280,7860
4.8e+05,2014,140,4,2.75,2050,3960,1,0,0,4,7,1180,870,1986,1986,98116,47.581,122.39,1440,5040,28,0,6.75,3490,7090
6.1429e+05,2014,361,5,2.75,2730,6401,2,0,0,3,8,2730,0,2015,2015,98072,47.769,122.16,2520,6126,-1,0,7.75,5250,8856
3.65e+05,2014,318,3,1.75,1290,7205,1,0,0,3,7,1290,0,1971,1971,98034,47.733,122.24,1340,7214,43,0,4.75,2630,8504
3.2e+05,2015,436,3,1.5,1490,10132,1,0,0,4,6,1490,0,1969,1969,98059,47.478,122.14,1720,9915,46,0,4.5,3210,11405
3.9799e+05,2014,162,3,1,1180,11862,1,0,0,4,7,1180,0,1948,1948,98177,47.715,122.36,1540,8100,66,0,4,2720,9280
2.975e+05,2014,155,4,2.5,1910,5000,2,0,0,3,7,1910,0,2005,2005,98038,47.361,122.04,2020,5000,9,0,6.5,3930,6910
2.45e+05,2015,409,3,1.5,1330,7125,2,0,0,3,7,1330,0,1968,1968,98034,47.731,122.19,1570,7350,47,0,4.5,2900,8680
1.95e+06,2015,425,4,3.75,4150,17424,1,0,0,3,9,3130,1020,1963,2000,98039,47.639,122.24,3930,21420,52,1,7.75,8080,25570
2.22e+05,2015,444,3,1,1220,7695,1,0,0,3,7,1220,0,1954,1954,98106,47.519,122.34,1210,7412,61,0,4,2430,8632
8.75e+05,2015,451,3,1.5,2440,5750,1,0,0,3,8,1320,1120,1939,1939,98115,47.699,122.3,2160,6820,76,0,4.5,4600,9260
8.7e+05,2014,257,4,3,2940,7108,2,0,1,3,9,2220,720,2011,2011,98136,47.544,122.39,2240,7950,3,0,7,5180,10890
6.55e+05,2014,136,5,3.25,3690,12353,2,0,0,5,9,3690,0,1977,1977,98155,47.767,122.29,2290,9082,37,0,8.25,5980,12772
7.6745e+05,2014,154,3,2,1630,7599,1,0,0,3,10,1630,0,2006,2006,98117,47.698,122.38,2030,7599,8,0,5,3660,9229
3.38e+05,2015,446,5,2.5,2400,4496,2,0,0,3,7,2400,0,2004,2004,98042,47.369,122.13,1880,4319,11,0,7.5,4280,6719
3.6495e+05,2015,477,4,2.5,1930,6957,2,0,0,3,8,1930,0,1995,1995,98055,47.431,122.19,2090,6996,20,0,6.5,4020,8926
2.55e+05,2015,450,3,2.5,1720,6200,2,0,0,3,7,1720,0,2014,2014,98022,47.214,121.99,1710,9520,1,0,5.5,3430,11240
7.1e+05,2015,456,4,2.5,2720,8000,1,0,0,4,7,1360,1360,1955,1955,98136,47.524,122.39,1790,8000,60,0,6.5,4510,10720
5.5482e+05,2014,143,4,2,3510,12905,1,0,2,3,8,2210,1300,1965,1982,98166,47.447,122.36,2530,16143,49,1,6,6040,19653
4.9e+05,2014,225,3,1.75,1490,11360,1,0,0,3,8,1490,0,1975,1975,98008,47.59,122.12,2350,10320,39,0,4.75,3840,11810
4.4e+05,2015,380,5,3.25,2610,3642,2,0,0,3,8,2080,530,2005,2005,98118,47.535,122.28,1750,3118,10,0,8.25,4360,5728
4.25e+05,2014,201,2,1,1150,6835,1,0,1,3,7,1010,140,1922,1922,98118,47.557,122.27,1150,6561,92,0,3,2300,7711
6.45e+05,2014,182,3,1.75,2270,11472,1,0,0,4,7,1370,900,1956,1956,98177,47.706,122.37,2270,8340,58,0,4.75,4540,10610
3.851e+05,2014,214,3,1,1060,8040,1,0,0,4,6,1060,0,1949,1949,98125,47.712,122.29,1300,7620,65,0,4,2360,8680
5.675e+05,2015,444,3,1.75,2570,14033,1,0,2,4,8,2570,0,1953,1953,98166,47.434,122.34,2550,16100,62,0,4.75,5120,18670
9e+05,2015,424,3,2.5,3400,16603,2,0,0,3,10,3400,0,2000,2000,98075,47.601,122.02,3400,12601,15,0,5.5,6800,16001
7.25e+05,2014,170,4,3.25,3940,27591,2,0,3,3,9,3440,500,2000,2000,98059,47.516,122.12,3420,29170,14,0,7.25,7360,33110
2.6845e+05,2014,334,5,2.25,2200,9600,1,0,0,4,7,1100,1100,1963,1963,98023,47.326,122.36,1780,9680,51,0,7.25,3980,11880
4.7e+05,2014,310,4,2,2410,4680,2,0,0,3,9,2410,0,1974,1974,98008,47.623,122.11,1910,4611,40,0,6,4320,7021
4.25e+05,2014,189,2,1,1320,8830,1,0,0,3,7,1020,300,1939,1939,98199,47.643,122.4,1620,8531,75,0,3,2940,9851
3.35e+05,2015,425,3,2,1210,9926,1,0,0,4,7,1210,0,1954,2015,98006,47.573,122.14,1690,9737,61,1,5,2900,10947
5.4e+05,2014,182,3,2.25,1320,1800,2,0,0,3,7,1320,0,1994,1994,98122,47.608,122.29,2010,4500,20,0,5.25,3330,5820
1.24e+06,2014,169,4,3.5,3820,13224,2,0,0,3,10,3280,540,1990,1990,98004,47.6,122.2,3340,9700,24,0,7.5,7160,13520
3.86e+05,2014,155,3,2,1330,8100,1,0,0,4,7,1330,0,1969,1969,98034,47.725,122.17,1590,8100,45,0,5,2920,9430
5.25e+05,2015,467,3,1.75,1720,7200,1,0,0,3,7,1140,580,1977,1977,98052,47.698,122.13,1700,8400,38,0,4.75,3420,10120
5.65e+05,2015,433,4,1.75,2030,7350,1,0,0,3,8,2030,0,1966,1966,98008,47.627,122.09,2000,7998,49,0,5.75,4030,10028
3.54e+05,2014,310,2,1,850,5225,1,0,0,3,7,850,0,1949,1949,98126,47.531,122.38,1230,5225,65,0,3,2080,6075
8.51e+05,2015,471,4,2.5,3130,13202,2,0,0,3,10,3130,0,1996,1996,98075,47.588,121.98,2840,10470,19,0,6.5,5970,13600
5.95e+05,2014,340,3,2.25,2400,16301,1,0,0,3,8,1400,1000,1962,1962,98115,47.69,122.28,1720,9828,52,0,5.25,4120,12228
2.7395e+05,2015,424,3,2.25,1570,3109,2,0,0,3,8,1570,0,2002,2002,98092,47.326,122.19,1680,3590,13,0,5.25,3250,5160
3.99e+05,2014,356,3,1.75,1620,10000,1,0,0,5,6,1620,0,1918,1918,98178,47.509,122.26,1880,10000,96,0,4.75,3500,11620
6.75e+05,2014,122,5,2.5,2820,67518,2,0,0,3,8,2820,0,1979,1979,98029,47.579,122.03,2820,48351,35,0,7.5,5640,51171
6.35e+05,2014,248,3,1.75,1530,5000,1,0,2,3,7,1020,510,1948,1948,98117,47.681,122.36,1530,5000,66,0,4.75,3060,6530
2.8e+05,2014,266,4,2.5,2400,4596,2,0,0,3,8,2400,0,2004,2004,98001,47.336,122.27,2230,4763,10,0,6.5,4630,7163
2.53e+05,2014,153,2,1.75,1220,5000,1,0,0,5,7,860,360,1921,1921,98055,47.491,122.2,1120,5000,93,0,3.75,2340,6220
6.357e+05,2014,142,4,2.5,3240,13978,1,0,0,3,9,1860,1380,1977,1977,98074,47.63,122.06,3150,12767,37,0,6.5,6390,16007
4.4e+05,2015,386,4,1.75,2180,10200,1,0,2,3,8,2000,180,1966,1966,98028,47.764,122.27,2590,10445,49,0,5.75,4770,12625
2.499e+05,2014,197,3,1.75,2080,12522,1,0,0,5,6,2080,0,1950,1950,98001,47.267,122.25,1690,11200,64,0,4.75,3770,13280
4.15e+05,2014,224,2,1,1070,4500,1,0,0,3,7,1070,0,1937,1937,98115,47.68,122.29,1320,4465,77,0,3,2390,5535
4.475e+05,2014,245,4,2.5,2425,9017,2,0,0,3,9,2425,0,2013,2013,98001,47.3,122.26,2725,7019,1,0,6.5,5150,9444
2.75e+05,2014,208,4,2.5,2060,5742,2,0,0,3,7,2060,0,1999,1999,98030,47.361,122.19,1610,7298,15,0,6.5,3670,9358
8e+05,2014,173,4,3,3520,4895,1,0,0,3,8,1980,1540,1954,1954,98107,47.668,122.36,1570,2153,60,0,7,5090,5673
5.1e+05,2015,450,2,1,1070,5280,1,0,0,3,6,1070,0,1900,1900,98122,47.617,122.3,1380,2370,115,0,3,2450,3440
3.39e+05,2015,430,3,2,2350,8459,1,0,0,3,9,2350,0,1989,1989,98023,47.304,122.35,2430,8459,26,0,5,4780,10809
4.1e+05,2014,198,4,2.25,2510,4090,2,0,0,3,8,1840,670,2012,2012,98019,47.734,121.97,2070,4090,2,0,6.25,4580,6600
7.1e+05,2014,280,4,2.75,2780,6978,2,0,0,3,8,2780,0,2001,2001,98053,47.688,122.04,2760,5460,13,0,6.75,5540,8240
4.8e+05,2014,272,4,1.75,1920,9380,1,0,0,3,7,1920,0,1964,1964,98008,47.634,122.12,1580,8580,50,0,5.75,3500,10500
3.75e+05,2014,257,3,2,1450,7300,1,0,0,5,7,1450,0,1955,1955,98133,47.752,122.34,1660,9069,59,0,5,3110,10519
3.8e+05,2014,304,2,1,980,3400,1,0,0,3,7,980,0,1923,1923,98105,47.669,122.32,1200,3420,91,0,3,2180,4400
4.07e+05,2014,243,3,2.25,1430,1448,3,0,0,3,8,1430,0,2005,2005,98103,47.692,122.34,1430,1383,9,0,5.25,2860,2813
1.55e+05,2014,134,2,1,700,5200,1,0,0,5,6,700,0,1952,1952,98056,47.492,122.17,1030,5200,62,0,3,1730,5900
6.4995e+05,2015,413,4,3.5,2440,3012,3,0,1,3,8,2440,0,2005,2005,98117,47.692,122.39,1860,4650,10,0,7.5,4300,7090
4.55e+05,2015,422,5,2,2500,7860,1,0,0,3,7,1040,1460,1963,1963,98034,47.721,122.23,2060,9684,52,0,7,4560,12184
3e+05,2015,380,3,2,1470,16500,1,0,0,3,7,1470,0,1961,1961,98042,47.362,122.06,1720,14406,54,0,5,3190,15876
7.5389e+05,2014,128,4,2.5,2660,5500,2,0,2,3,9,2660,0,2003,2003,98029,47.544,122,3620,5500,11,0,6.5,6280,8160
3.1e+05,2014,148,3,1,1430,19901,1,0,0,4,7,1430,0,1927,1927,98028,47.756,122.23,1780,12697,87,0,4,3210,14127
3.1e+05,2014,287,4,2.5,3140,22100,1,0,0,4,8,1820,1320,1960,1960,98023,47.319,122.36,2700,25500,54,0,6.5,5840,28640
4.09e+05,2014,209,2,1.75,1480,4000,1,0,0,4,6,740,740,1925,1925,98117,47.692,122.38,1060,4000,89,0,3.75,2540,5480
2.45e+05,2014,188,3,2.5,1600,2788,2,0,0,4,7,1600,0,1992,1992,98031,47.403,122.19,1720,3605,22,0,5.5,3320,5205
4e+05,2015,413,3,1,1100,5100,2,0,0,4,7,1100,0,1900,1900,98117,47.679,122.39,1540,5100,115,0,4,2640,6200
3.9e+05,2015,430,3,2.5,1640,6991,1,0,0,3,7,1110,530,1967,1967,98125,47.725,122.33,1860,7342,48,0,5.5,3500,8982
2.5e+05,2015,424,2,1,1400,19570,1,0,0,3,6,1100,300,1929,1929,98168,47.472,122.27,2250,6500,86,0,3,3650,7900
4.765e+05,2014,221,3,1,1060,8625,2,0,0,4,7,1060,0,1962,1997,98033,47.661,122.18,2010,8901,52,1,4,3070,9961
9.9e+05,2014,210,3,4,2550,3900,2,0,2,3,8,2050,500,1940,2003,98199,47.642,122.39,2340,6400,74,1,7,4890,8950
3.2e+05,2015,478,2,1,850,8400,1,0,0,4,6,850,0,1941,1941,98166,47.47,122.36,1280,8400,74,0,3,2130,9250
4.4e+05,2014,338,5,1.75,3690,36036,1,0,0,3,9,1890,1800,1985,1985,98042,47.347,122.08,2680,44131,29,0,6.75,6370,47821
7.895e+05,2014,162,4,2.5,3010,6100,2,0,0,3,9,3010,0,2005,2005,98052,47.665,122.08,2890,5176,9,0,6.5,5900,8186
4.43e+05,2015,443,2,1,1220,10170,1,0,0,3,7,980,240,1948,1948,98125,47.73,122.33,1990,9064,67,0,3,3210,10284
2.7e+05,2014,352,3,1.75,1370,10866,1,0,0,4,6,1370,0,1945,1945,98052,47.677,122.16,1580,14250,69,0,4.75,2950,15620
3.83e+05,2014,292,3,1.75,1410,7215,1,0,0,3,7,1410,0,1967,1967,98034,47.734,122.19,1550,7600,47,0,4.75,2960,9010
3.71e+05,2014,232,2,1.5,1110,1189,3,0,0,3,8,1110,0,2000,2000,98107,47.671,122.38,1420,1311,14,0,3.5,2530,2421
5.4e+05,2015,367,4,2.5,2050,3784,2,0,0,3,8,2050,0,2001,2001,98034,47.719,122.18,2050,3366,14,0,6.5,4100,5416
1.185e+06,2014,167,3,2.75,2500,5568,2,0,0,5,9,2500,0,1905,1905,98112,47.626,122.31,2810,5568,109,0,5.75,5310,8068
2.6e+05,2014,248,3,1.5,1750,7000,2,0,0,3,8,1750,0,1983,1983,98023,47.311,122.35,1840,9305,31,0,4.5,3590,11055
6.27e+05,2014,236,3,2,1940,3800,1,0,0,4,7,1050,890,1927,1927,98115,47.684,122.31,1700,3800,87,0,5,3640,5740
1.02e+06,2014,177,3,2.25,1670,4800,1,0,3,3,8,1670,0,1903,1903,98119,47.636,122.37,2300,4800,111,0,5.25,3970,6470
6.6e+05,2015,402,3,3,2470,11900,2,0,0,3,9,2290,180,1976,1976,98074,47.641,122.06,2590,11900,39,0,6,5060,14370
6.0995e+05,2015,432,3,2.25,1760,10350,1,0,0,4,7,1330,430,1979,1979,98033,47.66,122.19,2210,11337,36,0,5.25,3970,13097
3.35e+05,2014,255,3,1.75,1270,4800,1,0,0,3,7,1270,0,1953,1953,98117,47.693,122.36,1490,4800,61,0,4.75,2760,6070
2.3575e+05,2014,142,2,1,740,11250,1,0,0,2,6,740,0,1938,1938,98146,47.504,122.36,1390,11250,76,0,3,2130,11990
3.4e+05,2015,425,4,2.5,2665,5868,2,0,0,3,9,2665,0,2006,2006,98030,47.383,122.19,2665,6092,9,0,6.5,5330,8757
4.82e+05,2014,229,4,2.75,3010,15750,1,0,0,4,8,1560,1450,1973,1973,98034,47.734,122.18,2110,9450,41,0,6.75,5120,12460
4.15e+05,2014,248,4,2.25,2520,8000,1,0,2,3,8,1680,840,1970,1970,98023,47.32,122.38,2300,8000,44,0,6.25,4820,10520
5.79e+05,2014,361,3,2.5,2300,18540,1,0,0,3,8,1800,500,1961,1961,98177,47.777,122.37,2460,18540,53,0,5.5,4760,20840
6.8e+05,2014,242,4,3,3150,6175,2,0,0,3,9,3150,0,2001,2001,98075,47.597,122.02,3150,6986,13,0,7,6300,10136
2.5e+05,2015,400,4,2,2170,5404,1,0,0,5,6,1470,700,1920,1920,98002,47.305,122.22,1030,5477,95,0,6,3200,7647
8.9e+05,2014,320,4,2.5,3370,7200,2,0,0,3,8,3370,0,2014,2014,98177,47.77,122.38,1880,7200,0,0,6.5,5250,10570
6.45e+05,2015,484,4,2.75,2340,6350,1,0,0,4,7,1310,1030,1974,1974,98126,47.556,122.38,2020,6350,41,0,6.75,4360,8690
3.959e+05,2015,440,3,1.75,1880,8706,1,0,0,3,7,940,940,1927,1927,98155,47.736,122.29,1880,7200,88,0,4.75,3760,9080
7.35e+05,2014,321,4,2,1640,6000,1,0,0,4,9,1640,0,1911,1911,98119,47.651,122.38,1900,6000,103,0,6,3540,7640
6.9e+05,2015,424,3,1,1090,4000,1,0,0,4,7,1090,0,1945,1945,98117,47.685,122.39,1520,4000,70,0,4,2610,5090
7.5645e+05,2014,353,4,2,3210,8400,1,0,0,5,7,2040,1170,1914,1914,98136,47.532,122.39,2540,6458,100,0,6,5750,9668
3.3e+05,2014,177,4,1.75,2440,7350,1,0,0,3,8,1610,830,1978,1978,98032,47.374,122.28,2180,7680,36,0,5.75,4620,10120
5.6e+05,2014,180,3,2.25,2070,15002,1,0,0,3,8,2070,0,1955,2013,98155,47.764,122.27,2070,15002,59,1,5.25,4140,17072
5.25e+05,2014,156,5,2.75,2440,8000,1,0,0,4,7,1240,1200,1972,1972,98034,47.728,122.17,1780,8391,42,0,7.75,4220,10831
6.05e+05,2014,280,4,1.5,1880,3500,1,0,0,4,7,1080,800,1926,1926,98103,47.684,122.35,1690,3500,88,0,5.5,3570,5380
2.5e+05,2014,149,2,1,1110,26051,1,0,0,3,6,1110,0,1951,1951,98168,47.471,122.29,2240,12255,63,0,3,3350,13365
2.8665e+05,2015,480,3,2.5,1830,4997,2,0,0,3,7,1830,0,2004,2004,98001,47.303,122.28,2488,4998,11,0,5.5,4318,6828
3.6e+05,2014,306,4,2.5,2390,7115,2,0,0,3,9,2390,0,1999,1999,98092,47.259,122.22,2600,7916,15,0,6.5,4990,10306
4e+05,2014,298,3,1,1690,6658,1,0,0,3,7,1690,0,1942,1982,98133,47.71,122.35,1080,5925,72,1,4,2770,7615
6.72e+05,2014,331,3,1,1220,8573,1,0,0,4,7,1220,0,1954,1954,98004,47.609,122.19,1390,8573,60,0,4,2610,9793
2.445e+05,2015,481,3,1.75,1210,8864,1,0,0,3,7,1210,0,1985,1985,98042,47.364,122.08,1510,8062,30,0,4.75,2720,9272
4.25e+05,2015,444,4,2.5,1940,4517,1,0,0,3,8,1190,750,2010,2010,98028,47.776,122.26,1910,10410,5,0,6.5,3850,12350
6.05e+05,2015,367,5,3,3670,9600,1,0,1,3,8,1980,1690,1955,1955,98108,47.565,122.32,1730,4933,60,0,8,5400,8603
3.5e+05,2014,287,4,2.75,2500,5995,2,0,0,3,8,2500,0,2008,2008,98042,47.375,122.11,2530,5988,6,0,6.75,5030,8488
4.8e+05,2014,348,3,2.5,2980,7338,2,0,0,3,8,2980,0,2006,2006,98055,47.437,122.21,3010,5267,8,0,5.5,5990,8247
3.18e+05,2014,211,5,2.5,2820,9956,1,0,0,4,7,1410,1410,1967,1967,98168,47.471,122.33,2700,9956,47,0,7.5,5520,12776
1.57e+06,2014,147,4,3.75,3070,5850,2,0,0,5,9,2400,670,1927,1927,98112,47.633,122.28,2940,5573,87,0,7.75,6010,8643
4.02e+05,2014,235,3,1.75,1580,6127,1,0,0,5,7,1580,0,1947,1947,98125,47.719,122.32,1500,6128,67,0,4.75,3080,7708
2.5925e+05,2015,436,3,1,940,5904,1,0,0,3,6,940,0,1947,1947,98103,47.699,122.35,870,5728,68,0,4,1810,6668
6e+05,2014,153,4,2.5,2620,9873,2,0,0,3,8,2620,0,1987,1987,98075,47.582,122.05,2520,9935,27,0,6.5,5140,12555
3.98e+05,2014,320,3,1,1480,6550,1,0,0,4,6,1480,0,1925,1925,98126,47.55,122.38,1200,6550,89,0,4,2680,8030
4.57e+05,2014,180,3,2.5,1220,1330,2,0,0,3,8,1010,210,2008,2008,98117,47.69,122.37,1360,3750,6,0,5.5,2580,4970
2.49e+05,2014,127,3,1,1110,8423,1,0,0,3,7,1110,0,1952,1952,98166,47.472,122.34,1140,9083,62,0,4,2250,10193
7.29e+05,2015,367,4,3.5,3065,5440,3,0,0,3,9,3065,0,2014,2014,98056,47.524,122.2,2210,8400,1,0,7.5,5275,11465
8.089e+05,2014,191,5,2.5,2900,5901,2,0,0,3,9,2900,0,2006,2006,98027,47.54,122,3200,5775,8,0,7.5,6100,8675
4.72e+05,2015,477,5,2.5,2570,7412,2,0,0,3,8,2570,0,2006,2006,98019,47.727,121.96,2890,8056,9,0,7.5,5460,10626
3.55e+05,2014,195,3,1,1600,5001,1,0,0,5,6,1080,520,1930,1930,98125,47.723,122.29,1340,5001,84,0,4,2940,6601
6.3e+05,2014,182,4,2.5,2190,9880,1,0,0,4,8,1410,780,1979,1979,98033,47.693,122.19,2190,9198,35,0,6.5,4380,11388
4.95e+05,2015,456,4,2.5,2480,91911,1,0,2,4,7,1470,1010,1973,1973,98027,47.458,121.98,2540,91911,42,0,6.5,5020,94391
3.61e+05,2014,265,3,1.75,1650,11220,1,0,0,4,7,1650,0,1969,1969,98077,47.757,122.07,1340,10129,45,0,4.75,2990,11779
6.135e+05,2015,481,3,3.25,1876,1531,3,0,0,3,9,1876,0,2009,2009,98115,47.686,122.27,1876,1533,6,0,6.25,3752,3409
3.3895e+05,2014,310,3,1.75,1610,22496,1,0,0,4,7,1610,0,1974,1974,98042,47.344,122.07,2050,35772,40,0,4.75,3660,37382
3.5e+05,2014,266,4,2.5,2500,5831,2,0,0,3,8,2500,0,2007,2007,98038,47.345,122.04,2500,5188,7,0,6.5,5000,7688
2.9e+05,2015,478,3,2.25,1610,3764,2,0,0,3,7,1610,0,2012,2012,98042,47.359,122.08,1610,3825,3,0,5.25,3220,5435
7e+05,2014,155,3,1.75,1910,4800,1,0,0,3,7,1080,830,1959,1959,98103,47.684,122.33,1750,4800,55,0,4.75,3660,6710
2.999e+05,2014,175,3,1,1110,8593,1,0,0,3,7,1110,0,1979,1979,98155,47.76,122.31,1780,8593,35,0,4,2890,9703
3.6e+05,2014,324,4,2.5,1950,5451,2,0,0,3,7,1950,0,2004,2004,98058,47.434,122.14,2240,6221,10,0,6.5,4190,8171
3.55e+05,2014,147,4,2.25,1810,4970,2,0,0,3,7,1810,0,2003,2003,98059,47.5,122.16,1810,4858,11,0,6.25,3620,6668
6.29e+05,2014,270,3,2.5,2160,1912,2,0,0,3,9,1970,190,2014,2014,98118,47.564,122.29,1810,2653,0,0,5.5,3970,4813
4.33e+05,2014,136,4,2.5,2280,7568,2,0,0,4,7,2280,0,2001,2001,98056,47.511,122.19,2280,5312,13,0,6.5,4560,7592
7.5e+05,2014,209,4,1.75,2520,21834,1,1,4,3,8,1420,1100,1960,1960,98146,47.5,122.38,1700,8100,54,0,5.75,4220,10620
5.9938e+05,2015,399,3,1.75,1270,7350,1,0,0,4,7,1270,0,1967,1967,98005,47.605,122.17,1880,7350,48,0,4.75,3150,8620
2.265e+05,2014,214,3,1.5,1300,7370,1,0,0,4,7,900,400,1976,1976,98023,47.303,122.37,1430,7500,38,0,4.5,2730,8800
3.42e+05,2014,237,4,2,1570,11200,1,0,0,3,7,1120,450,1959,1959,98011,47.757,122.22,1570,11200,55,0,6,3140,12770
5.25e+05,2014,341,2,1.5,1480,43645,1,0,0,3,8,1480,0,1974,2006,98027,47.548,122.05,1600,34326,40,1,3.5,3080,35806
3.48e+05,2015,425,3,2.25,2570,8491,2,0,0,4,8,2570,0,1989,1989,98042,47.376,122.13,2400,8049,26,0,5.25,4970,10619
4.5e+05,2014,255,3,1.5,1440,9711,1,0,0,3,7,1140,300,1956,1956,98028,47.739,122.25,1590,9711,58,0,4.5,3030,11151
4.7495e+05,2014,333,3,2.25,1850,2575,2,0,0,3,9,1850,0,2013,2013,98118,47.553,122.27,1080,4120,1,0,5.25,2930,5970
1.008e+06,2014,167,4,3.5,2650,3060,2,0,0,3,9,2060,590,2001,2001,98103,47.673,122.33,1470,3060,13,0,7.5,4120,5710
4.35e+05,2014,320,2,2.5,1560,1222,2,0,0,3,8,1080,480,2008,2008,98122,47.604,122.31,1560,2081,6,0,4.5,3120,3641
3.95e+05,2015,417,2,1,980,5100,1,0,0,4,6,980,0,1907,1907,98117,47.682,122.38,1190,5100,108,0,3,2170,6080
8.25e+05,2014,347,4,3.25,3200,4477,2,0,0,3,9,2390,810,2006,2006,98199,47.664,122.4,1830,4920,8,0,7.25,5030,8120
5.25e+05,2015,460,3,2.5,2190,34528,2,0,0,3,8,2190,0,1994,1994,98027,47.459,121.99,2460,37901,21,0,5.5,4650,40091
3.99e+05,2015,413,4,2.5,2480,4334,2,0,0,3,8,2480,0,2012,2012,98038,47.383,122.04,2480,5632,3,0,6.5,4960,8112
3.34e+05,2015,446,2,1,900,1818,2,0,0,4,7,900,0,1945,1945,98199,47.648,122.4,1570,1830,70,0,3,2470,2730
7.5e+05,2015,477,6,1.75,2750,9563,2,0,0,4,8,2750,0,1973,1973,98052,47.637,122.1,2040,9563,42,0,7.75,4790,12313
2.65e+05,2014,197,2,1,1600,7936,1,0,0,3,7,1600,0,1947,1947,98155,47.741,122.32,1580,7440,67,0,3,3180,9040
7.225e+05,2014,352,5,2.25,3700,7207,1,0,1,5,8,1850,1850,1970,1970,98177,47.774,122.37,2340,7900,44,0,7.25,6040,11600
1.9085e+05,2015,439,4,1.5,1370,7904,1,0,0,3,7,900,470,1970,1970,98001,47.334,122.28,1370,7900,45,0,5.5,2740,9270
2.32e+05,2014,257,4,2,1440,5911,1,0,0,5,5,1440,0,1943,1943,98056,47.507,122.18,1500,11089,71,0,6,2940,12529
5.3995e+05,2015,443,3,2.5,1330,2183,3,0,0,3,8,1330,0,2014,2014,98117,47.699,122.36,1310,5000,1,0,5.5,2640,6330
5.15e+05,2015,486,3,2.5,3000,8250,1,0,0,4,8,1760,1240,1963,1963,98008,47.619,122.11,2040,8250,52,0,5.5,5040,11250
6.095e+05,2015,414,3,1.75,1590,1113,3,0,0,3,8,1590,0,2014,2014,98107,47.669,122.4,1520,1357,1,0,4.75,3110,2947
2.9995e+05,2015,439,2,1,890,5200,1,0,0,4,6,890,0,1941,1941,98126,47.531,122.37,950,5200,74,0,3,1840,6090
7.3e+05,2015,460,6,4.5,3600,6110,2,0,0,3,9,2510,1090,2012,2012,98118,47.569,122.29,1360,5800,3,0,10.5,4960,9400
8.15e+05,2014,176,4,2.75,2620,4743,1,0,2,4,8,1310,1310,1949,1949,98117,47.683,122.4,1900,4764,65,0,6.75,4520,7384
8.2e+05,2014,152,3,1.75,2160,6272,1,0,0,4,8,1390,770,1960,1960,98115,47.678,122.31,1290,5376,54,0,4.75,3450,7536
5.88e+05,2014,232,4,1.75,1930,7245,1,0,0,4,8,1510,420,1972,1972,98008,47.64,122.11,1880,7245,42,0,5.75,3810,9175
3.84e+05,2014,197,6,3,2320,4502,1,0,0,4,7,1200,1120,1987,1987,98108,47.555,122.3,1160,5628,27,0,9,3480,7948
2.7e+05,2014,129,3,2,1690,9583,1,0,0,4,7,1690,0,1969,1969,98059,47.483,122.16,1690,9583,45,0,5,3380,11273
3e+06,2015,457,4,3.75,5090,14823,1,0,0,3,11,4180,910,2013,2013,98004,47.62,122.21,3030,12752,2,0,7.75,8120,17842
5.49e+05,2014,209,4,2.25,2420,59800,1,0,0,4,8,1350,1070,1985,1985,98074,47.621,122.06,2160,17598,29,0,6.25,4580,20018
1.73e+05,2014,272,2,1,1740,8100,1,0,0,3,6,1050,690,1947,1947,98168,47.494,122.3,960,8100,67,0,3,2700,9840
5.9495e+05,2014,296,4,3.25,2557,9480,2,0,2,3,7,2557,0,1948,1993,98118,47.545,122.26,2220,8340,66,1,7.25,4777,10897
2.9e+05,2015,408,3,2.5,2200,4240,2,0,0,3,7,2200,0,2003,2003,98042,47.371,122.13,2200,4311,12,0,5.5,4400,6511
5.3995e+05,2014,277,4,2.75,2910,9000,1,0,0,4,8,2130,780,1966,1966,98006,47.544,122.18,1970,9000,48,0,6.75,4880,11910
3.525e+05,2015,470,3,1.75,1500,10269,1,0,0,3,7,1030,470,1958,1958,98133,47.767,122.35,2090,10269,57,0,4.75,3590,11769
4.35e+05,2014,167,2,1,1230,3800,1,0,0,3,7,1230,0,1928,1928,98115,47.68,122.29,1610,3800,86,0,3,2840,5030
3e+05,2014,208,3,2,720,7598,1,0,0,5,6,720,0,1947,1947,98106,47.548,122.36,1080,7209,67,0,5,1800,7929
3.131e+05,2015,445,4,2.5,2660,9030,1,0,0,4,7,1450,1210,1977,1977,98055,47.456,122.21,1870,9030,38,0,6.5,4530,11690
4.215e+05,2014,271,3,1.5,990,4500,1,0,0,5,7,990,0,1948,1948,98122,47.605,122.3,1490,4000,66,0,4.5,2480,4990
2.25e+05,2015,383,3,1,1120,8407,1,0,0,5,6,1120,0,1987,1987,98022,47.205,122.01,1250,8658,28,0,4,2370,9778
3.68e+05,2014,131,3,2.5,1370,1350,2,0,0,3,7,1010,360,2007,2007,98136,47.553,122.38,1450,6000,7,0,5.5,2820,7370
2.75e+05,2014,205,3,2.5,2497,4400,2,0,0,3,8,2497,0,2007,2007,98001,47.287,122.28,2434,4400,7,0,5.5,4931,6897
5.25e+05,2014,255,3,2.5,1740,2350,2,0,0,3,8,1120,620,1996,1996,98112,47.621,122.3,1750,3802,18,0,5.5,3490,5542
3.95e+05,2014,189,4,2.75,1970,37026,1,0,0,4,8,1970,0,1961,1961,98070,47.438,122.45,1970,51836,53,0,6.75,3940,53806
5.25e+05,2014,147,5,3,2750,3800,1,0,0,5,7,1750,1000,1926,1926,98115,47.684,122.31,1900,3800,88,0,8,4650,6550
2.64e+05,2014,173,3,1.75,1760,7482,1,0,0,4,8,1760,0,1966,1966,98023,47.313,122.37,2000,7500,48,0,4.75,3760,9260
3.885e+05,2014,237,3,2.25,1350,944,2,0,0,3,8,1050,300,2007,2007,98144,47.6,122.31,1350,1245,7,0,5.25,2700,2595
3.68e+05,2014,132,3,1,1280,9898,1,0,0,3,7,1280,0,1968,1968,98072,47.768,122.16,1290,9625,46,0,4,2570,10905
2.63e+05,2014,291,3,1.75,1660,7210,1,0,0,4,7,1660,0,1977,1977,98032,47.361,122.27,2150,7350,37,0,4.75,3810,9010
8.3e+05,2014,292,3,2.5,2760,11287,2,0,3,3,10,2000,760,1991,1991,98028,47.739,122.26,2760,13719,23,0,5.5,5520,16479
2.49e+05,2014,209,3,2,1260,1125,2,0,0,3,7,810,450,2011,2011,98106,47.526,122.36,1260,1172,3,0,5,2520,2432
4.1e+05,2015,440,4,1.75,2320,7500,1,0,0,3,7,1220,1100,1955,1955,98133,47.757,122.34,2230,7500,60,0,5.75,4550,9820
6.6e+05,2015,432,3,3.5,2740,3785,2,0,0,3,9,2190,550,2001,2001,98034,47.719,122.18,2060,3457,14,0,6.5,4800,6197
2.65e+05,2015,439,4,1.5,1240,8158,1,0,0,4,7,1110,130,1961,1961,98198,47.372,122.31,1520,8147,54,0,5.5,2760,9387
2.11e+05,2014,132,3,1.5,1350,7620,1,0,0,5,6,1350,0,1941,1941,98166,47.456,122.35,1350,7620,73,0,4.5,2700,8970
5.2145e+05,2014,287,3,2,1290,5700,1,0,0,5,7,1290,0,1950,1950,98116,47.571,122.4,1160,5700,64,0,5,2450,6990
1.98e+06,2015,415,4,3.5,4500,44384,1,0,0,3,12,3340,1160,1990,1990,98004,47.632,122.19,2540,26287,25,0,7.5,7040,30787
1.47e+05,2015,423,3,1.5,1480,9606,1,0,0,4,7,1100,380,1964,1964,98023,47.298,122.36,1600,9619,51,0,4.5,3080,11099
1.749e+06,2014,205,4,2.5,3910,22710,1,0,0,3,8,3910,0,1908,2003,98004,47.63,122.22,2920,16544,106,1,6.5,6830,20454
1.325e+06,2014,218,4,2.5,4010,37076,2,0,0,4,12,4010,0,1990,1990,98052,47.714,122.11,4280,35326,24,0,6.5,8290,39336
4.749e+05,2014,153,3,2.25,1800,43647,1,0,0,4,8,1800,0,1976,1976,98072,47.776,122.13,2480,25608,38,0,5.25,4280,27408
3.98e+05,2014,142,2,1,590,10945,1,0,0,3,5,590,0,1983,1983,98010,47.336,122.03,2020,15180,31,0,3,2610,15770
2.975e+05,2015,478,4,2.5,2190,8100,1,0,0,4,8,1250,940,1978,1978,98023,47.313,122.39,2100,8840,37,0,6.5,4290,11030
3.55e+05,2015,467,3,1.5,1370,4790,2,0,0,4,7,1370,0,1982,1982,98034,47.725,122.16,1370,3799,33,0,4.5,2740,5169
3.775e+05,2015,483,2,1,840,4500,1,0,0,3,6,840,0,1939,1939,98136,47.544,122.39,1300,5000,76,0,3,2140,5840
4.55e+05,2014,356,3,2.5,1980,7309,2,0,0,3,7,1980,0,1993,1993,98034,47.726,122.17,2060,9681,21,0,5.5,4040,11661
3.74e+05,2014,195,4,1.75,2220,15600,1,0,0,5,7,1140,1080,1963,1963,98056,47.492,122.17,1670,4800,51,0,5.75,3890,7020
5.975e+05,2014,339,3,1.75,2030,32565,1,0,0,3,8,1600,430,1981,1981,98052,47.711,122.1,2910,34190,33,0,4.75,4940,36220
6.39e+05,2014,221,3,2.5,2010,3300,2,0,0,3,9,1610,400,2014,2014,98118,47.557,122.29,1660,4950,0,0,5.5,3670,6960
5.15e+05,2014,244,4,2.5,2030,39049,1,0,0,4,7,1530,500,1953,1953,98166,47.441,122.34,2400,14605,61,0,6.5,4430,16635
4.25e+05,2015,417,2,1,1300,11080,1,0,0,4,7,1300,0,1955,1955,98034,47.728,122.23,1600,9259,60,0,3,2900,10559
4.79e+05,2015,461,4,2.5,2050,6705,1,0,0,4,7,1230,820,1973,1973,98034,47.724,122.22,1610,7292,42,0,6.5,3660,9342
6.6e+05,2014,142,3,2.5,2450,4332,2,0,0,3,8,2450,0,2010,2010,98053,47.694,122.02,2450,4154,4,0,5.5,4900,6604
5.7e+05,2014,140,2,1.75,1540,4025,1,0,0,4,7,1190,350,1908,1908,98116,47.588,122.39,1950,4420,106,0,3.75,3490,5960
1.0345e+06,2014,162,4,2.5,2370,10858,2,0,0,3,9,2370,0,2003,2003,98004,47.634,122.19,2510,21673,11,0,6.5,4880,24043
2.3e+05,2014,290,2,1,870,7020,1,0,0,4,6,570,300,1942,1942,98106,47.54,122.35,1730,7020,72,0,3,2600,7890
4.425e+05,2014,159,4,2.5,2170,14024,2,0,0,3,8,2170,0,1992,1992,98019,47.735,121.97,2240,14029,22,0,6.5,4410,16199
2.84e+05,2015,436,3,1.75,1560,21000,1,0,0,3,7,1560,0,1954,1954,98166,47.478,122.34,1070,7920,61,0,4.75,2630,9480
5.41e+05,2014,266,3,2.5,1790,4038,2,0,0,3,8,1790,0,2005,2005,98029,47.55,122,1700,3365,9,0,5.5,3490,5155
3.07e+05,2014,160,4,1,1150,8184,1,0,0,3,6,1150,0,1947,1947,98155,47.743,122.32,990,8184,67,0,5,2140,9334
2.85e+05,2014,286,4,2.5,2434,4400,2,0,0,3,8,2434,0,2007,2007,98001,47.287,122.28,2434,4400,7,0,6.5,4868,6834
3.8e+05,2014,142,2,2.5,1230,987,2,0,0,3,7,1060,170,2011,2011,98144,47.601,122.31,1290,1328,3,0,4.5,2520,2558
1.775e+06,2015,367,4,3.25,3730,7071,3,0,2,3,11,3730,0,1985,1985,98109,47.629,122.36,3730,7680,30,0,7.25,7460,11410
7.5e+05,2014,274,4,1.75,2100,6613,2,0,0,3,8,2100,0,1909,2004,98116,47.567,122.39,1630,5750,105,1,5.75,3730,7850
3.8952e+05,2014,258,4,2.5,2640,4725,2,0,0,3,8,2640,0,2014,2014,98038,47.371,122.02,2370,4725,0,0,6.5,5010,7365
6.55e+05,2015,409,3,1.75,1800,5102,1,0,0,3,7,1170,630,1952,1952,98199,47.651,122.41,1720,5102,63,0,4.75,3520,6902
4.988e+05,2014,189,2,1.75,1350,4614,1,0,0,3,8,1350,0,2008,2008,98053,47.709,122.02,1680,4775,6,0,3.75,3030,6125
3.7e+05,2014,245,4,2.5,2720,8666,2,0,0,3,9,2720,0,1992,1992,98030,47.385,122.17,2410,8100,22,0,6.5,5130,10820
2.12e+05,2015,374,3,2.25,1900,18000,1,0,0,4,7,1280,620,1968,1968,98023,47.325,122.35,1920,15000,47,0,5.25,3820,16900
5.62e+05,2014,325,4,1.75,2060,4080,1,0,0,3,7,1460,600,1922,1996,98105,47.67,122.33,1620,4080,92,1,5.75,3680,6140
4.65e+05,2014,271,4,1.75,1730,11700,1,0,0,3,7,880,850,1956,1956,98008,47.603,122.13,1570,7820,58,0,5.75,3300,9550
1.506e+06,2014,141,4,3.25,3660,5800,2,0,0,3,10,3360,300,1909,1995,98112,47.628,122.31,3240,5800,105,1,7.25,6900,9460
5.15e+05,2014,333,3,2.25,1300,1180,3,0,0,3,8,1300,0,2008,2008,98103,47.687,122.34,1300,1174,6,0,5.25,2600,2474
6.1e+05,2015,369,4,2.25,2090,35040,1,0,0,3,8,1490,600,1980,1980,98075,47.574,122.03,2910,21132,35,0,6.25,5000,23222
1.43e+06,2014,251,4,2.5,3380,27589,2,0,0,3,10,3380,0,1966,1966,98004,47.629,122.22,3390,20075,48,0,6.5,6770,23455
4.65e+05,2014,303,4,2,2000,6250,1,0,0,3,7,1480,520,1930,1930,98136,47.553,122.39,1110,6250,84,0,6,3110,8250
3.54e+05,2015,367,3,1.75,1340,6300,1,0,0,3,7,1340,0,1972,1972,98034,47.719,122.22,1780,7200,43,0,4.75,3120,8540
2.7e+05,2015,492,3,2.25,2080,26574,1,0,2,3,7,1380,700,1993,1993,98002,47.285,122.19,1770,8140,22,0,5.25,3850,10220
2.6495e+05,2015,474,2,1,1000,6000,1,0,0,3,6,1000,0,1951,1951,98126,47.521,122.37,1250,6000,64,0,3,2250,7000
3.27e+05,2014,293,4,1,1620,6000,1,0,0,5,7,1620,0,1905,1905,98055,47.476,122.21,1310,6000,109,0,5,2930,7620
9.2e+05,2014,248,4,2.75,3140,9085,1,0,2,5,8,1570,1570,1961,1961,98006,47.568,122.16,2430,9350,53,0,6.75,5570,12490
4.665e+05,2014,155,3,1,1430,3840,1,0,0,3,7,950,480,1945,1945,98117,47.685,122.38,1430,3840,69,0,4,2860,5270
2.1995e+05,2014,140,3,1.5,1650,9936,1,0,0,3,7,1090,560,1967,1967,98003,47.328,122.33,1560,9890,47,0,4.5,3210,11540
1.68e+05,2014,150,2,1.5,1220,3568,1,0,0,4,8,1220,0,1976,1976,98198,47.38,122.32,1180,3678,38,0,3.5,2400,4898
3.05e+05,2015,410,4,2.5,2430,9103,2,0,0,3,8,2430,0,1990,1990,98023,47.294,122.37,2260,8090,25,0,6.5,4690,10520
4.28e+05,2014,272,3,2.5,2340,3466,2,0,0,3,7,2340,0,2004,2004,98065,47.532,121.85,1970,3739,10,0,5.5,4310,6079
3.4e+05,2014,217,4,2,1740,6369,1,0,0,5,6,870,870,1954,1954,98133,47.746,122.33,1560,7200,60,0,6,3300,8940
2.25e+05,2014,318,3,1.5,1390,12500,1,0,0,4,6,1390,0,1976,1976,98014,47.65,121.91,1390,9000,38,0,4.5,2780,10390
4.5e+05,2014,324,3,1,2020,8100,1,0,0,3,7,1170,850,1956,1956,98125,47.714,122.29,1480,7620,58,0,4,3500,9640
3.2995e+05,2014,285,2,2.25,1260,1032,2,0,0,3,7,1170,90,2008,2008,98027,47.532,122.07,1240,809,6,0,4.25,2500,2069
4.65e+05,2015,447,5,1.75,2000,10246,1,0,2,3,7,1200,800,1953,1953,98178,47.508,122.25,2340,9030,62,0,6.75,4340,11030
2.65e+05,2014,287,3,2.5,1340,10290,1,0,0,4,7,1140,200,1981,1981,98042,47.355,122.15,1760,7903,33,0,5.5,3100,9243
2.2e+05,2015,422,3,1,820,5200,1,0,0,4,6,820,0,1977,1977,98042,47.363,122.09,1120,5200,38,0,4,1940,6020
4.558e+05,2014,208,3,2.5,1690,4584,2,0,0,3,7,1690,0,2002,2002,98053,47.687,122.04,1600,3164,12,0,5.5,3290,4854
3.17e+05,2014,215,3,1.75,1530,7650,1,0,0,4,8,1530,0,1977,1977,98058,47.444,122.13,1850,6804,37,0,4.75,3380,8334
4.3498e+05,2015,458,3,2.25,1590,9960,1,0,0,3,7,1060,530,1976,1976,98155,47.774,122.29,1860,9760,39,0,5.25,3450,11350
2.895e+05,2015,475,3,1,1200,5525,1,0,0,2,7,1200,0,1947,1947,98115,47.698,122.33,1580,7200,68,0,4,2780,8400
4.72e+05,2015,430,2,2.25,1800,2748,2,0,0,4,9,1800,0,1979,1979,98008,47.61,122.11,1800,2755,36,0,4.25,3600,4555
4.55e+05,2015,485,4,2.5,2210,49375,1,0,0,3,8,2210,0,1997,1997,98038,47.383,122.07,2670,49385,18,0,6.5,4880,51595
4.7495e+05,2014,236,5,2.5,2080,8347,1,0,0,4,7,1460,620,1975,1975,98034,47.733,122.17,1840,7713,39,0,7.5,3920,9793
8e+05,2014,239,3,2.5,2760,9471,1,0,2,3,8,1760,1000,1956,1956,98115,47.676,122.27,3040,6765,58,0,5.5,5800,9525
2.9995e+05,2014,175,3,2.5,1870,7942,2,0,0,3,7,1870,0,1990,1990,98001,47.342,122.28,1870,7392,24,0,5.5,3740,9262
4.25e+05,2015,451,3,1.5,1120,6653,1,0,0,4,7,1120,0,1937,1937,98133,47.732,122.33,1580,7355,78,0,4.5,2700,8475
2.81e+05,2015,437,3,1.75,1690,9826,1,0,0,4,7,1690,0,1988,1988,98023,47.314,122.36,1980,9826,27,0,4.75,3670,11516
4.85e+05,2014,250,5,2,1910,5508,1,0,0,3,7,1020,890,1968,1968,98133,47.707,122.35,1030,7440,46,0,7,2940,9350
7.075e+05,2014,307,4,4,1550,6596,1,0,0,5,7,1550,0,1907,1907,98107,47.671,122.4,1830,4850,107,0,8,3380,6400
4.45e+05,2014,320,3,2.25,1850,4050,2,0,0,4,7,1850,0,1985,1985,98029,47.567,122.02,1650,4468,29,0,5.25,3500,6318
7.51e+05,2015,493,5,2.75,2860,5280,2,0,0,3,9,2860,0,2006,2006,98052,47.707,122.1,3150,6442,9,0,7.75,6010,9302
3.31e+05,2014,324,3,1.75,1080,1306,1,0,0,3,7,580,500,1954,2003,98199,47.66,122.4,1440,2225,60,1,4.75,2520,3305
2.99e+05,2014,257,3,1,1550,8778,1,0,0,3,7,1250,300,1952,1952,98118,47.541,122.28,2120,7268,62,0,4,3670,8818
6.95e+05,2015,451,3,2,2632,18743,2,0,3,3,10,2632,0,2000,2000,98070,47.374,122.42,1970,14171,15,0,5,4602,16803
3.25e+05,2014,229,2,1,1050,4800,1,0,0,4,7,1050,0,1969,1969,98146,47.513,122.39,1230,4800,45,0,3,2280,5850
6.77e+05,2014,348,4,2.5,2820,4174,2,0,0,3,9,2820,0,2004,2004,98034,47.711,122.23,2560,4853,10,0,6.5,5380,7673
5.94e+05,2014,318,3,1,1320,5000,1,0,0,4,7,1090,230,1920,1920,98107,47.667,122.36,1700,5000,94,0,4,3020,6320
6.1e+05,2014,280,3,1,1000,4959,1,0,0,3,8,1000,0,1945,1945,98105,47.663,122.28,2240,4959,69,0,4,3240,5959
4.4e+05,2014,162,3,2.75,1560,7392,1,0,0,5,7,1030,530,1972,1972,98011,47.738,122.18,1870,7520,42,0,5.75,3430,9080
2e+05,2014,210,4,1,1070,7467,1,0,0,3,7,1070,0,1944,1944,98178,47.494,122.23,1160,7467,70,0,5,2230,8537
5.68e+05,2014,299,3,2.5,2320,57063,1,0,0,4,9,1790,530,1979,1979,98074,47.616,122.06,3290,7314,35,0,5.5,5610,9634
7.05e+05,2014,228,6,2,2570,4240,1,0,0,4,7,1970,600,1911,1911,98115,47.675,122.31,2030,4240,103,0,8,4600,6810
2.2e+05,2014,317,3,1.5,1600,10548,1,0,0,4,7,1600,0,1962,1962,98001,47.292,122.28,2880,13609,52,0,4.5,4480,15209
3.03e+05,2015,475,3,2.5,1850,4957,2,0,0,3,8,1850,0,1999,1999,98092,47.331,122.17,2400,6367,16,0,5.5,4250,8217
3.85e+05,2014,223,3,1.75,1800,18000,1,0,0,3,8,1200,600,1968,1968,98058,47.441,122.15,1800,18000,46,0,4.75,3600,19800
3.5e+05,2015,436,2,1.75,1430,7921,1,0,0,3,7,1430,0,1983,1983,98146,47.509,122.37,1290,8040,32,0,3.75,2720,9470
1.58e+05,2015,486,3,2,1090,6090,1,0,0,3,7,940,150,1940,1940,98118,47.512,122.26,1840,6090,75,0,5,2930,7180
3.05e+05,2015,477,3,2.5,1610,3516,2,0,0,3,8,1610,0,2006,2006,98055,47.449,122.19,1610,3056,9,0,5.5,3220,4666
4.43e+05,2014,189,3,2.25,1920,8223,2,0,0,4,7,1920,0,1989,1989,98011,47.735,122.2,1940,7274,25,0,5.25,3860,9194
3.15e+05,2015,445,4,2.5,3130,5999,2,0,0,3,7,3130,0,2006,2006,98042,47.384,122.1,3020,5997,9,0,6.5,6150,9127
1.95e+05,2014,307,2,1,1280,7861,1,0,0,4,6,1280,0,1913,1913,98002,47.301,122.23,1020,6480,101,0,3,2300,7760
4.35e+05,2015,490,3,2.5,1930,5790,2,0,0,4,7,1930,0,1988,1988,98011,47.773,122.17,1790,4901,27,0,5.5,3720,6831
2.155e+05,2014,306,3,2,1380,9000,2,0,0,2,7,1380,0,1946,1982,98001,47.261,122.25,1460,9732,68,1,5,2840,11112
1.05e+06,2014,312,2,2.5,2350,2390,3,0,2,3,10,2000,350,2007,2007,98144,47.6,122.29,1950,2390,7,0,4.5,4300,4740
9.37e+05,2014,176,3,1.75,2450,2691,2,0,0,3,8,1750,700,1915,1915,98119,47.639,122.36,1760,3573,99,0,4.75,4210,6023
1.175e+06,2014,335,4,3.25,4060,20822,2,0,0,3,10,4060,0,1991,1991,98077,47.721,122.06,4170,23958,23,0,7.25,8230,28018
7.1e+05,2015,453,4,1.75,2120,5400,1,0,0,4,8,1060,1060,1941,1941,98199,47.65,122.39,2052,6000,74,0,5.75,4172,8120
3.5e+05,2014,127,3,1,1010,9360,1,0,0,3,6,1010,0,1981,1981,98033,47.687,122.17,1470,9360,33,0,4,2480,10370
5e+05,2014,267,2,1,1760,27332,1,1,4,4,7,1300,460,1951,1951,98198,47.38,122.33,2590,16630,63,0,3,4350,18390
4.35e+05,2014,161,3,2.5,1420,2581,3,0,0,3,7,1420,0,2004,2004,98133,47.703,122.36,1420,2509,10,0,5.5,2840,3929
4.15e+05,2015,372,4,2.75,2390,9968,1,0,0,4,9,1390,1000,1989,1989,98038,47.371,122.06,2560,12385,26,0,6.75,4950,14775
5.15e+05,2015,437,2,2.5,1330,1249,3,0,0,3,8,1330,0,2004,2004,98105,47.667,122.28,1430,1328,11,0,4.5,2760,2658
3.9e+05,2015,399,3,1,1200,10800,1,0,0,4,7,1200,0,1955,1955,98006,47.577,122.14,1370,9950,60,0,4,2570,11150
4.68e+05,2014,205,3,2.25,1630,2490,2,0,0,3,7,1630,0,2004,2004,98053,47.681,122.03,1630,2680,10,0,5.25,3260,4310
2.1525e+06,2015,438,4,3.25,3840,6214,1,0,3,4,10,2590,1250,1939,1939,98199,47.639,122.41,3280,5915,76,0,7.25,7120,9755
3.145e+05,2014,178,3,1.75,1700,17355,1,0,0,3,7,1200,500,1978,1978,98038,47.364,122.06,1900,9528,36,0,4.75,3600,11228
2.7495e+05,2014,147,3,1.75,1670,7415,1,0,0,3,7,1320,350,1987,1987,98042,47.378,122.12,1650,8585,27,0,4.75,3320,10255
5.295e+05,2015,438,3,2.25,1410,905,3,0,0,3,9,1410,0,2014,2014,98116,47.582,122.4,1510,1352,1,0,5.25,2920,2762
3.09e+05,2014,209,3,1,1280,9656,1,0,0,4,6,920,360,1959,1959,98058,47.449,122.17,1340,8808,55,0,4,2620,10088
4.52e+05,2014,303,4,2.5,2190,6896,2,0,0,3,7,2190,0,2007,2007,98065,47.519,121.87,2190,5900,7,0,6.5,4380,8090
5.36e+05,2014,280,3,1.75,1580,3764,1,0,0,3,7,1280,300,1945,1945,98107,47.672,122.4,1560,3764,69,0,4.75,3140,5344
3.3195e+05,2014,124,4,2.5,2530,9933,2,0,2,3,8,2010,520,1990,1990,98092,47.265,122.22,2140,9933,24,0,6.5,4670,12463
2.3e+05,2014,294,3,1,680,2400,1,0,0,4,6,680,0,1903,1903,98144,47.598,122.3,1470,3600,111,0,4,2150,4280
8.566e+05,2015,392,4,2.25,2400,13430,1,0,0,4,9,2400,0,1964,1964,98005,47.599,122.18,2580,10077,51,0,6.25,4980,12477
3.66e+05,2014,272,3,2.5,1790,4065,2,0,0,3,8,1790,0,2009,2009,98019,47.734,121.97,2480,4252,5,0,5.5,4270,6042
7.49e+05,2014,190,4,1.5,2130,5000,2,0,0,4,8,2130,0,1920,1920,98144,47.583,122.29,2560,5000,94,0,5.5,4690,7130
3.9245e+05,2014,312,4,2,2195,2681,1,0,0,3,7,1060,1135,1912,1912,98103,47.697,122.34,1710,1280,102,0,6,3905,3475
2.8e+05,2014,334,3,2.25,1430,7222,2,0,0,3,7,1430,0,1993,1993,98056,47.511,122.19,1430,7220,21,0,5.25,2860,8650
2.55e+05,2015,425,3,2,1490,7599,1,0,0,3,7,1490,0,1990,1990,98042,47.369,122.09,1560,7710,25,0,5,3050,9200
2.2495e+05,2014,341,3,1.5,1630,9282,1,0,0,4,7,1630,0,1963,1963,98022,47.202,122,1420,9282,51,0,4.5,3050,10912
3.69e+05,2014,286,3,1.5,2110,5195,1,0,0,3,7,1210,900,1959,1959,98118,47.528,122.29,1950,5195,55,0,4.5,4060,7305
7.8e+05,2015,476,4,2.5,3180,9603,2,0,2,3,9,3180,0,2002,2002,98155,47.772,122.28,2440,15261,13,0,6.5,5620,18441
1.517e+06,2014,221,3,2.25,2610,9409,1,1,4,4,8,2610,0,1963,1963,98075,47.579,122.08,2970,9156,51,0,5.25,5580,11766
3.4995e+05,2015,432,4,2,1764,15600,1,0,0,5,7,1764,0,1942,1942,98058,47.432,122.18,1490,22387,73,0,6,3254,24151
5.3595e+05,2015,429,3,2.5,2370,5344,2,0,0,3,9,2370,0,2003,2003,98065,47.54,121.86,2990,5418,12,0,5.5,5360,7788
2.499e+05,2014,197,3,2,1220,6404,1,0,0,3,7,1220,0,1994,1994,98038,47.352,122.06,1570,7000,20,0,5,2790,8220
5.75e+05,2014,292,3,2,1800,5000,2,0,0,5,7,1600,200,1925,1925,98136,47.545,122.39,1640,5000,89,0,5,3440,6800
4.765e+05,2014,341,4,1.75,1670,10200,1,0,0,3,7,1390,280,1953,1953,98118,47.552,122.27,1720,6860,61,0,5.75,3390,8530
4.7e+05,2014,301,3,1.75,1310,8600,1,0,0,4,7,1310,0,1987,1987,98033,47.686,122.19,2510,8515,27,0,4.75,3820,9825
2.2995e+05,2014,292,4,2.5,2150,7670,1,0,0,5,7,1240,910,1976,1976,98031,47.394,122.19,1610,7350,38,0,6.5,3760,9500
4.3e+05,2014,198,5,2.5,3860,42733,1,0,3,4,8,2300,1560,1955,1955,98001,47.312,122.25,2520,19353,59,0,7.5,6380,23213
5.15e+05,2015,474,2,1.75,950,15219,1,0,0,3,8,950,0,2009,2009,98028,47.772,122.26,1560,12416,6,0,3.75,2510,13366
6.85e+05,2015,431,3,2,2500,6733,1,0,0,3,8,1770,730,1979,1979,98107,47.669,122.36,1770,6343,36,0,5,4270,8843
4.24e+05,2015,443,3,1.5,1230,7200,1,0,0,3,7,1230,0,1953,1953,98125,47.728,122.31,1400,6240,62,0,4.5,2630,7470
3.45e+05,2014,133,3,1.75,1090,7200,1,0,0,3,7,1090,0,1968,1968,98034,47.723,122.18,1240,7200,46,0,4.75,2330,8290
2.45e+06,2014,133,4,4.5,5030,11023,2,0,2,3,11,3250,1780,2008,2008,98040,47.572,122.24,3640,11490,6,0,8.5,8670,16520
3.42e+05,2014,270,3,3,1260,1251,2,0,0,3,7,1040,220,2003,2003,98144,47.594,122.3,1780,7715,11,0,6,3040,8975
2.44e+05,2014,143,4,1,1450,8960,1,0,0,3,6,1450,0,1943,1943,98146,47.497,122.35,1160,7680,71,0,5,2610,9130
2.75e+05,2014,142,1,0.75,1170,14149,1,0,0,5,7,880,290,1962,1962,98022,47.265,121.91,1130,24513,52,0,1.75,2300,25683
5.2995e+05,2014,276,2,2.5,1500,1174,2,0,0,3,8,1140,360,2014,2014,98107,47.669,122.36,1550,1519,0,0,4.5,3050,3019
2.73e+05,2014,133,4,1.5,2180,22870,1,0,0,4,6,1280,900,1954,1975,98042,47.319,122.08,2420,22614,60,1,5.5,4600,24794
7.899e+05,2014,188,3,2.5,3420,25150,1,0,0,4,10,1750,1670,1987,1987,98006,47.571,122.15,2900,19604,27,0,5.5,6320,23024
3.9e+05,2015,396,3,2,1010,14183,1,0,0,3,8,1010,0,1982,1982,98074,47.623,122.04,1750,11700,33,0,5,2760,12710
2.295e+05,2015,484,2,1.75,1870,6625,1,0,0,3,7,960,910,1948,1948,98178,47.507,122.25,1680,6000,67,0,3.75,3550,7870
6.32e+05,2015,437,3,2.25,2730,7521,2,0,2,3,9,2730,0,1992,1992,98011,47.77,122.2,2700,8204,23,0,5.25,5430,10934
8.8e+05,2014,347,3,2.5,2870,5163,2,0,0,3,9,2870,0,2014,2014,98103,47.694,122.35,1630,7995,0,0,5.5,4500,10865
2.415e+05,2015,413,3,2,1310,7349,1,0,0,3,7,870,440,1995,1995,98030,47.364,122.19,1690,6580,20,0,5,3000,7890
6.75e+05,2015,415,4,3.5,2550,3600,2,0,2,3,8,1880,670,1997,1997,98177,47.771,122.39,2090,6000,18,0,7.5,4640,8550
3.451e+05,2014,173,3,3.75,1950,8625,1,0,0,3,8,1360,590,1959,1959,98178,47.505,122.26,1950,6670,55,0,6.75,3900,8620
8.7e+05,2014,250,4,2,3090,41147,1,0,0,3,7,3090,0,1990,1990,98052,47.675,122.05,3300,34280,24,0,6,6390,37370
1.1e+06,2014,148,2,1.75,2050,11900,1,0,0,4,8,2050,0,1950,1950,98004,47.621,122.22,2980,11900,64,0,3.75,5030,13950
4.495e+05,2015,480,4,2.5,2410,55931,2,0,0,3,9,2410,0,1989,1989,98092,47.311,122.1,2780,55931,26,0,6.5,5190,58341
6.2e+05,2015,432,2,2.25,2910,6110,2,0,2,4,9,2910,0,1985,1985,98136,47.528,122.39,2090,5763,30,0,4.25,5000,8673
2.35e+05,2015,467,3,1,1460,8400,1,0,0,3,7,1460,0,1958,1958,98055,47.424,122.2,1460,9600,57,0,4,2920,11060
5.29e+05,2015,424,3,2.5,1880,4499,2,0,0,3,8,1880,0,1993,1993,98029,47.566,122,2130,5114,22,0,5.5,4010,6994
6.3815e+05,2014,198,4,2.5,2170,7275,1,0,0,3,8,1820,350,1978,1978,98027,47.567,122.09,2390,7275,36,0,6.5,4560,9445
3.23e+05,2015,369,2,1,880,1712,2,0,0,4,7,880,0,1945,1945,98199,47.648,122.4,1360,1748,70,0,3,2240,2628
6.45e+05,2015,431,4,1.5,1600,6180,1,0,0,3,6,1600,0,1946,1946,98118,47.568,122.28,1410,6180,69,0,5.5,3010,7780
2.75e+05,2014,286,3,1.5,1170,1174,2,0,0,3,7,840,330,2007,2007,98126,47.546,122.38,1170,2537,7,0,4.5,2340,3707
9.7e+05,2014,311,4,1.75,4060,4000,2,0,3,3,10,2890,1170,1953,1995,98199,47.638,122.39,1860,4000,61,1,5.75,5920,8060
1.95e+05,2014,190,2,1,860,10400,1,0,0,4,6,860,0,1983,1983,98042,47.368,122.1,1390,9086,31,0,3,2250,9946
6.99e+05,2014,211,5,2.5,3340,24755,2,0,0,3,10,3340,0,2002,2002,98038,47.456,122.07,3420,23274,12,0,7.5,6760,26614
3.415e+05,2015,408,5,2.25,3120,10400,2,0,0,3,8,3120,0,1980,1980,98023,47.31,122.34,2160,8267,35,0,7.25,5280,11387
7.494e+05,2014,135,4,2.5,3240,20301,2,0,0,3,10,3240,0,1985,1985,98052,47.719,122.11,3010,23650,29,0,6.5,6250,26890
4.5e+05,2015,484,3,1,1430,5960,1,0,0,4,7,1430,0,1917,1917,98118,47.562,122.29,1140,3960,98,0,4,2570,5390
3.92e+05,2015,366,3,1,1230,9600,1,0,0,3,7,1230,0,1952,1952,98118,47.555,122.29,1510,6600,63,0,4,2740,7830
4.15e+05,2014,174,3,2.5,2280,6031,2,0,0,3,8,2280,0,2011,2011,98019,47.732,121.97,2430,7200,3,0,5.5,4710,9480
5.06e+05,2014,165,5,3,2430,8000,1,0,0,4,7,1370,1060,1957,1957,98008,47.603,122.12,1770,8000,57,0,8,4200,10430
3.2495e+05,2014,276,3,1,1040,7288,1,0,0,3,7,1040,0,1959,1959,98125,47.729,122.31,1160,7287,55,0,4,2200,8327
6e+05,2015,485,3,1.75,2040,5000,1,0,0,3,7,1780,260,1924,1924,98115,47.676,122.3,1690,5000,91,0,4.75,3730,7040
3.749e+05,2015,479,3,2.5,2480,4950,2,0,0,3,7,2480,0,2004,2004,98058,47.439,122.12,2230,5298,11,0,5.5,4710,7778
1.8e+05,2014,142,2,1,1400,4500,1,0,0,3,7,900,500,1922,1922,98055,47.487,122.22,1400,5500,92,0,3,2800,6900
3.94e+05,2014,177,4,2.5,3000,9793,2,0,0,3,7,3000,0,2002,2002,98038,47.365,122.03,1890,7557,12,0,6.5,4890,10557
2.2745e+05,2015,472,2,1,660,6509,1,0,0,4,5,660,0,1952,1952,98056,47.494,122.17,970,5713,63,0,3,1630,6373
5.39e+05,2015,432,3,2,1800,43995,2,0,0,3,8,1800,0,1988,1988,98077,47.758,122.02,2290,51400,27,0,5,4090,53200
2.7995e+05,2014,168,5,1.75,2150,7171,1,0,0,4,7,1460,690,1970,1970,98031,47.395,122.18,1710,7300,44,0,6.75,3860,9450
6.4e+05,2015,458,2,1,1070,5000,1,0,0,3,7,1070,0,1924,1924,98103,47.667,122.33,1710,5000,91,0,3,2780,6070
2.5e+05,2014,258,3,1.75,1350,8548,1,0,0,3,7,1350,0,1985,1985,98003,47.318,122.33,1660,8538,29,0,4.75,3010,9888
4.22e+05,2014,339,2,1.75,1320,2609,1,0,0,4,7,920,400,1938,1938,98117,47.688,122.37,1200,4220,76,0,3.75,2520,5540
4.52e+05,2014,271,3,2.5,1530,5032,2,0,0,3,7,1530,0,1998,1998,98103,47.699,122.35,1450,2136,16,0,5.5,2980,3666
5.3217e+05,2014,230,3,2,1360,3090,2,0,0,3,8,1360,0,1990,1990,98103,47.684,122.35,1500,3090,24,0,5,2860,4450
5.46e+05,2014,159,3,2.5,1530,3464,2,0,0,3,8,1530,0,1998,1998,98007,47.618,122.14,1530,3446,16,0,5.5,3060,4976
7.399e+05,2014,175,5,2.5,2980,5377,2,0,0,3,9,2980,0,2006,2006,98052,47.707,122.1,3150,6593,8,0,7.5,6130,9573
1.76e+05,2014,270,2,1,920,2332,1,0,0,4,8,920,0,1980,1980,98198,47.378,122.32,1310,2853,34,0,3,2230,3773
6.998e+05,2014,238,2,2.5,2380,6600,1,0,0,3,8,2380,0,2010,2010,98053,47.717,122.02,1870,6600,4,0,4.5,4250,8980
5.1838e+05,2014,202,4,2.5,2810,4500,2,0,0,3,9,2810,0,2014,2014,98038,47.355,122.02,2980,5046,0,0,6.5,5790,7856
3.14e+05,2014,313,5,2.75,2210,13500,1,0,0,5,7,1460,750,1963,1963,98188,47.447,122.28,1590,10850,51,0,7.75,3800,13060
3.19e+05,2015,407,3,2.25,1220,2980,2,0,0,3,7,1220,0,1986,1986,98034,47.715,122.2,1220,2140,29,0,5.25,2440,3360
7.475e+05,2014,187,4,2.25,2350,18600,2,0,0,4,9,2350,0,1977,1977,98028,47.747,122.26,2880,14400,37,0,6.25,5230,16750
2.92e+05,2014,221,3,2.5,1560,2740,2,0,0,3,8,1560,0,1999,1999,98059,47.491,122.15,1310,2698,15,0,5.5,2870,4258
5e+05,2014,304,4,2.5,3010,5040,2,0,0,3,8,3010,0,2006,2006,98133,47.709,122.35,1090,5040,8,0,6.5,4100,8050
6.25e+05,2014,205,3,1.5,1990,5978,1,1,4,4,7,1990,0,1926,1926,98198,47.345,122.33,2100,6221,88,0,4.5,4090,8211
4.2e+05,2014,290,3,1.5,1050,6615,1,0,0,4,6,800,250,1950,1950,98199,47.658,122.39,1530,5250,64,0,4.5,2580,6300
4.1e+05,2015,402,5,2.75,2910,16410,1,0,0,4,8,2910,0,1967,1967,98058,47.44,122.14,1980,18000,48,0,7.75,4890,20910
3.26e+05,2014,140,6,3,1880,7200,1,0,0,4,7,1880,0,1966,1966,98056,47.503,122.19,1540,13022,48,0,9,3420,14902
6.82e+05,2014,239,5,2.25,2120,4000,1,0,0,4,7,1720,400,1910,1910,98109,47.644,122.35,1960,4000,104,0,7.25,4080,6120
8.5e+05,2014,279,3,3,1910,4800,1,0,0,3,9,1910,0,1900,1991,98103,47.657,122.35,1280,1310,114,1,6,3190,3220
2.375e+05,2014,209,3,1,980,7560,1,0,0,3,7,980,0,1951,1951,98126,47.526,122.38,1300,7560,63,0,4,2280,8540
5.1625e+05,2014,263,6,2,2390,8660,1,0,0,4,7,2390,0,1925,1925,98011,47.759,122.22,2250,12942,89,0,8,4640,15332
2.42e+05,2015,458,3,1.75,1500,7560,1,0,0,3,7,1500,0,1979,1979,98003,47.347,122.3,1500,7560,36,0,4.75,3000,9060
6.75e+05,2015,473,4,3.5,3090,1.0084e+05,2,0,0,3,9,3090,0,1999,1999,98092,47.309,122.09,2400,50543,16,0,7.5,5490,53633
4.35e+05,2014,216,3,2,1610,6911,1,0,0,3,7,1260,350,1988,1988,98034,47.719,122.18,1630,6911,26,0,5,3240,8521
7.8e+05,2014,210,4,2.5,3140,14421,2,0,0,3,10,3140,0,1994,1994,98075,47.594,122.02,3140,17417,20,0,6.5,6280,20557
2.998e+05,2015,415,4,2.5,2410,4708,2,0,0,3,8,2410,0,2002,2002,98092,47.323,122.18,2517,5290,13,0,6.5,4927,7700
3.796e+05,2015,471,3,1.75,1270,12420,1,0,0,4,7,1270,0,1962,1962,98056,47.539,122.18,1560,9910,53,0,4.75,2830,11180
3.8e+05,2014,152,2,1,1210,4800,1,0,0,3,8,1060,150,1950,1950,98108,47.563,122.32,1380,4800,64,0,3,2590,6010
2.375e+06,2014,319,4,2.5,3220,20251,1,0,0,3,10,3220,0,1969,1969,98006,47.569,122.19,4200,22114,45,0,6.5,7420,25334
4.72e+05,2014,167,3,2.5,1180,1262,3,0,0,3,8,1180,0,2010,2010,98119,47.638,122.38,1180,2632,4,0,5.5,2360,3812
6.06e+05,2015,424,3,2,1980,7680,1,0,0,4,6,1070,910,1911,1911,98033,47.684,122.19,1330,8704,104,0,5,3310,10684
3.7e+05,2015,437,2,1,1250,4960,1,0,0,3,7,940,310,1938,1938,98115,47.689,122.33,2030,7440,77,0,3,3280,8690
3.4e+05,2014,301,4,2.5,2020,32710,1,0,0,3,7,1070,950,1941,1941,98168,47.497,122.33,1340,17700,73,0,6.5,3360,19720
5.899e+05,2014,160,4,4.5,3870,35889,2,0,0,3,10,2530,1340,2001,2001,98027,47.468,122.01,3020,35366,13,0,8.5,6890,39236
3.15e+05,2014,176,4,2.5,1940,10200,1,0,0,4,8,1140,800,1977,1977,98042,47.416,122.16,1920,12600,37,0,6.5,3860,14540
1.2e+06,2014,278,5,3.5,3900,4400,2,0,0,3,9,2650,1250,2014,2014,98107,47.661,122.36,1190,4400,0,0,8.5,5090,8300
5.69e+05,2014,211,4,1.75,2400,21196,1,0,0,5,8,1590,810,1956,1956,98166,47.428,122.35,2200,19134,58,0,5.75,4600,21534
4.949e+05,2015,479,3,2.5,2040,2500,2,0,0,3,7,1470,570,2008,2008,98126,47.573,122.37,1410,2500,7,0,5.5,3450,4540
5.44e+05,2014,180,3,2.5,1460,1613,2,0,0,3,8,1180,280,2007,2007,98117,47.678,122.38,1460,1403,7,0,5.5,2920,2863
2.45e+05,2015,481,3,1,1380,9875,1,0,0,3,7,1380,0,1959,1959,98168,47.513,122.33,1200,6250,56,0,4,2580,7630
5.45e+05,2014,277,3,2.5,2140,40173,2,0,0,4,8,2140,0,1990,1990,98027,47.479,122.07,2380,43016,24,0,5.5,4520,45156
3.7495e+05,2015,417,4,2.75,2730,4683,2,0,0,3,7,2730,0,2005,2005,98038,47.361,122.04,2230,4924,10,0,6.75,4960,7654
4.5e+05,2014,255,3,2.5,2790,48994,2,0,0,4,9,2790,0,1984,1984,98042,47.349,122.09,2550,37834,30,0,5.5,5340,40624
6.6e+05,2015,444,2,1,1670,8195,1,0,0,3,7,1670,0,1954,1975,98033,47.663,122.19,1980,7500,61,1,3,3650,9170
7.505e+05,2014,149,5,3,2170,2440,1,0,0,4,8,1450,720,1911,1911,98115,47.672,122.32,2070,4000,103,0,8,4240,6170
3.844e+05,2014,168,3,3.25,1689,1388,3,0,0,3,8,1689,0,2008,2008,98125,47.717,122.32,1459,1384,6,0,6.25,3148,3073
4.6e+05,2014,176,3,2.5,1730,8490,1,0,0,3,7,1210,520,1969,1969,98034,47.719,122.22,1870,7400,45,0,5.5,3600,9130
6.15e+05,2015,480,4,2.5,3010,6903,2,0,0,3,9,3010,0,2001,2001,98056,47.521,122.19,2860,6435,14,0,6.5,5870,9445
3.05e+05,2015,423,4,2.5,1714,3250,2,0,0,3,8,1714,0,2010,2010,98055,47.429,122.19,1714,3250,5,0,6.5,3428,4964
5.85e+05,2015,477,4,2.5,2250,4119,2,0,0,3,8,2250,0,2001,2001,98075,47.597,122.03,2290,3115,14,0,6.5,4540,5365
3.4e+05,2015,459,3,2.5,1720,4120,2,0,0,3,7,1720,0,1999,1999,98148,47.432,122.33,1720,5544,16,0,5.5,3440,7264
5.79e+05,2014,276,3,2.5,1710,1904,2,0,0,3,8,1140,570,2003,2003,98116,47.583,122.39,1260,1316,11,0,5.5,2970,3026
5.3e+05,2014,155,4,2.25,2210,7665,2,0,0,4,8,2210,0,1968,1968,98006,47.542,122.17,1960,7903,46,0,6.25,4170,10113
2.69e+05,2014,155,3,1,1690,4250,1,0,0,3,7,1020,670,1967,1967,98178,47.495,122.26,1820,8865,47,0,4,3510,10555
4.5e+05,2014,173,4,1.75,2160,4333,1,0,0,4,8,1260,900,1942,1942,98117,47.689,122.39,1670,4426,72,0,5.75,3830,6586
7.4e+05,2014,307,3,2,2100,72745,1,0,0,4,9,2100,0,1995,1995,98077,47.748,122.06,2290,54885,19,0,5,4390,56985
1.051e+06,2014,128,4,3,2920,33976,1,0,3,5,8,1460,1460,1964,1964,98008,47.616,122.1,2970,15210,50,0,7,5890,18130
1.1468e+06,2014,135,4,3.5,4210,10308,2,0,0,3,10,4210,0,2006,2006,98008,47.59,122.12,3860,10200,8,0,7.5,8070,14410
2.6995e+05,2014,223,3,1.5,1740,9547,1,0,0,4,7,1740,0,1962,1962,98055,47.447,122.21,1780,9936,52,0,4.5,3520,11676
1.388e+06,2014,176,4,3,4040,20001,1,0,0,3,9,2020,2020,1972,2001,98004,47.641,122.21,2990,20098,42,1,7,7030,24138
2.8995e+05,2014,293,3,2.5,2070,6145,2,0,0,3,7,2070,0,2003,2003,98092,47.336,122.17,2070,5297,11,0,5.5,4140,7367
5e+05,2015,478,5,2.5,2030,8400,1,0,0,3,7,1330,700,1968,1968,98052,47.671,122.15,1920,8400,47,0,7.5,3950,10430
4.36e+05,2014,299,3,2.25,2120,6710,1,0,0,5,7,1420,700,1959,1959,98155,47.746,122.32,1880,6960,55,0,5.25,4000,9080
7.135e+05,2014,310,3,2,1720,4200,2,0,0,3,8,1720,0,1908,1992,98112,47.629,122.3,1720,4200,106,1,5,3440,5920
9e+05,2014,262,4,2.5,3620,42580,2,0,0,3,10,3620,0,1984,1984,98052,47.72,122.11,2950,33167,30,0,6.5,6570,36787
9.328e+05,2015,452,5,3.25,2980,7095,2,0,0,3,9,2980,0,1998,2007,98115,47.692,122.29,1670,7140,17,1,8.25,4650,10120
2.9995e+05,2014,191,3,2.5,1600,9830,2,0,0,4,8,1600,0,1993,1993,98001,47.339,122.27,1890,8910,21,0,5.5,3490,10510
4.05e+05,2015,366,3,1,1250,7280,1,0,0,3,7,1250,0,1975,1975,98052,47.699,122.13,1690,7280,40,0,4,2940,8530
5e+05,2015,382,4,2,1980,4500,2,0,0,4,7,1980,0,1910,1910,98107,47.673,122.38,1550,2541,105,0,6,3530,4521
2.06e+05,2014,298,3,1,1050,5233,1,0,0,5,5,1050,0,1906,1906,98010,47.311,122,970,7500,108,0,4,2020,8550
3.1e+05,2015,443,3,1.5,1860,10379,1,0,0,3,7,1240,620,1963,1963,98198,47.396,122.31,2240,11328,52,0,4.5,4100,13188
5.88e+05,2014,161,4,2,1680,5000,1,0,0,3,7,980,700,1950,1950,98115,47.686,122.29,1680,6000,64,0,6,3360,7680
3.55e+05,2014,331,5,2.5,2540,5100,2,0,0,3,7,2540,0,2014,2014,98168,47.512,122.32,1400,9440,0,0,7.5,3940,11980
3.625e+05,2015,451,3,3.5,1710,2212,2,0,0,3,7,1400,310,2013,2013,98126,47.546,122.37,1580,2212,2,0,6.5,3290,3922
5.8e+05,2014,194,3,2,2040,4800,1,0,0,4,7,1020,1020,1925,1925,98126,47.556,122.38,1640,4800,89,0,5,3680,6840
3.84e+05,2014,140,3,2.5,1700,4000,2,0,0,3,7,1700,0,2003,2003,98065,47.533,121.87,1700,4417,11,0,5.5,3400,6117
4.68e+05,2014,310,2,1.75,1250,7029,1,0,0,4,7,1250,0,1986,1986,98033,47.694,122.19,1680,8470,28,0,3.75,2930,9720
3.255e+05,2014,325,3,1.5,1540,8110,1,0,0,4,7,1190,350,1959,1959,98125,47.733,122.29,1290,8110,55,0,4.5,2830,9650
4.9e+05,2014,136,3,2,1450,2400,1,0,0,3,8,1450,0,1900,2003,98107,47.673,122.38,1450,4275,114,1,5,2900,5725
2.08e+05,2014,209,3,1.75,1070,7200,1,0,0,3,7,1070,0,1994,1994,98010,47.313,122.02,1480,7200,20,0,4.75,2550,8270
1.1e+06,2014,194,4,3.5,2210,7597,1,0,0,4,9,1550,660,1977,2006,98004,47.582,122.2,2370,8811,37,1,7.5,4580,11021
4.025e+05,2015,460,3,1,1290,4000,1,0,0,3,7,1290,0,1926,1926,98118,47.546,122.28,1160,5040,89,0,4,2450,6330
4.79e+05,2014,173,3,2.25,2110,11319,2,0,0,4,8,2110,0,1978,1978,98072,47.742,122.11,1860,11319,36,0,5.25,3970,13429
5.75e+05,2014,331,4,2.75,1610,11201,1,0,0,5,7,1020,590,1982,1982,98033,47.702,122.2,1610,9000,32,0,6.75,3220,10610
6.97e+05,2014,249,4,2.5,3160,6961,2,0,0,3,8,3160,0,2005,2005,98074,47.612,122.01,3110,5058,9,0,6.5,6270,8218
7.945e+05,2015,416,5,3,3030,4120,1,0,0,4,7,1930,1100,1913,1913,98115,47.677,122.32,1280,3090,102,0,8,4310,6120
2.8e+05,2014,224,4,1.5,1940,6386,1,0,0,3,7,1140,800,1954,1954,98118,47.553,122.28,1340,6165,60,0,5.5,3280,8105
6.79e+05,2014,198,4,1.5,1420,4923,1,0,0,4,8,1420,0,1928,1928,98103,47.69,122.34,1470,4923,86,0,5.5,2890,6343
3.9995e+05,2014,303,3,2.5,1400,4400,1,0,0,3,7,1400,0,1930,2014,98106,47.553,122.36,1060,4400,84,1,5.5,2460,5800
5.25e+05,2015,416,3,1,1010,3520,1,0,0,3,7,1010,0,1902,1902,98102,47.621,122.32,1300,1233,113,0,4,2310,2243
5.2e+05,2014,140,4,3.5,2680,10000,2,0,0,3,8,2040,640,1942,2014,98125,47.726,122.3,1530,8000,72,1,7.5,4210,10680
5.35e+05,2014,223,3,2.75,1320,1125,3,0,0,3,8,1320,0,2008,2008,98103,47.66,122.35,1320,1266,6,0,5.75,2640,2586
4.45e+05,2015,471,3,1.75,1360,4998,1,0,0,3,8,1360,0,1968,2014,98108,47.547,122.3,1350,4998,47,1,4.75,2710,6358
1.705e+06,2014,333,5,3,4290,17100,1,0,3,3,9,2480,1810,1972,2007,98040,47.547,122.21,3550,16988,42,1,8,7840,21278
2.65e+05,2014,225,2,1,770,5160,1,0,0,3,6,770,0,1943,1943,98106,47.53,122.36,920,5160,71,0,3,1690,5930
8.02e+05,2014,223,2,1.75,2110,8700,1,0,4,4,9,1760,350,1960,1960,98146,47.491,122.36,2120,9500,54,0,3.75,4230,11610
1.075e+06,2014,178,4,4.25,3500,8750,1,0,4,5,9,2140,1360,1951,1951,98177,47.722,122.37,3110,8750,63,0,8.25,6610,12250
8.1e+05,2014,183,3,1.5,1520,9041,1,0,0,4,7,1520,0,1954,1954,98004,47.616,122.21,3260,10020,60,0,4.5,4780,11540
8.53e+05,2015,443,4,2.25,3440,35025,2,0,0,3,10,3440,0,1988,1988,98053,47.667,122.06,3210,35005,27,0,6.25,6650,38445
5.65e+05,2014,245,3,2.25,1700,8800,1,0,0,5,7,850,850,1969,1969,98033,47.686,122.19,2180,8960,45,0,5.25,3880,10660
6.715e+05,2014,205,4,2.25,2130,8410,2,0,0,4,8,2130,0,1977,1977,98006,47.559,122.13,2170,8400,37,0,6.25,4300,10530
1.05e+06,2014,147,4,2.5,2920,7200,1,0,3,3,8,1470,1450,1921,2006,98144,47.595,122.29,3210,6825,93,1,6.5,6130,9745
3.3e+05,2014,266,3,1.75,1590,9417,1,0,0,4,7,1590,0,1954,1954,98177,47.762,122.36,1600,9272,60,0,4.75,3190,10862
7.39e+05,2015,439,3,1.75,2050,5160,1,0,0,4,8,1300,750,1926,1926,98112,47.637,122.3,2220,5960,89,0,4.75,4270,8010
7.16e+05,2014,237,4,2.25,2480,9780,1,0,0,4,8,1900,580,1975,1975,98052,47.639,122.1,2640,9780,39,0,6.25,5120,12260
6.1e+05,2014,232,4,2.5,2100,8800,1,0,0,5,8,1250,850,1980,1980,98033,47.691,122.19,2100,9000,34,0,6.5,4200,11100
4.9e+05,2014,272,4,4.25,4480,5715,2,0,0,3,7,3680,800,2003,2003,98030,47.373,122.18,2190,6070,11,0,8.25,6670,10550
5.3e+05,2014,143,4,1.75,1814,5000,1,0,0,4,7,944,870,1951,1951,98115,47.684,122.28,1290,5000,63,0,5.75,3104,6814
9.1e+05,2015,451,4,2.5,2770,9798,2,0,0,4,9,2770,0,1986,1986,98027,47.562,122.08,3040,11100,29,0,6.5,5810,13870
2.79e+05,2015,446,4,2.25,2090,8941,2,0,0,3,7,2090,0,1975,1975,98058,47.433,122.17,1890,7946,40,0,6.25,3980,10036
5.45e+05,2014,262,3,1.75,1400,4000,1,0,0,4,7,1400,0,1925,1925,98117,47.69,122.39,1050,4330,89,0,4.75,2450,5730
4.1e+05,2015,373,3,2.5,2150,4332,2,0,0,3,8,2150,0,2013,2013,98019,47.737,121.97,2140,4332,2,0,5.5,4290,6482
2.96e+05,2014,243,3,1.75,1360,10742,1,0,0,5,7,960,400,1971,1971,98058,47.435,122.17,1830,9000,43,0,4.75,3190,10360
1.617e+05,2014,154,4,1.75,1720,7200,1,0,0,3,7,1220,500,1974,1974,98023,47.306,122.38,1790,7200,40,0,5.75,3510,8920
4.95e+05,2014,359,3,2.75,2430,14861,1,0,0,3,9,1530,900,1988,1988,98028,47.746,122.25,2230,10300,26,0,5.75,4660,12730
3.11e+05,2014,217,4,2.5,2690,6124,2,0,0,3,7,2690,0,2007,2007,98042,47.334,122.06,2300,6002,7,0,6.5,4990,8692
1.395e+06,2014,225,4,3.5,3560,16782,2,0,0,3,10,2560,1000,2014,2014,98040,47.557,122.22,3100,18047,0,0,7.5,6660,21607
2.5e+05,2015,479,3,2,1680,7900,2,0,0,4,7,1680,0,1953,1953,98003,47.325,122.31,1250,15600,62,0,5,2930,17280
9.94e+05,2014,147,3,2.25,2510,6339,1,0,2,5,8,1810,700,1932,1932,98199,47.65,122.39,1820,5741,82,0,5.25,4330,8251
4.27e+05,2014,271,2,1.5,1440,725,2,0,0,3,8,1100,340,2011,2011,98126,47.561,122.38,1440,4255,3,0,3.5,2880,5695
4.68e+05,2015,401,4,2.5,2150,8165,1,0,0,3,8,1430,720,1957,1957,98177,47.773,122.37,2360,7980,58,0,6.5,4510,10130
1.24e+06,2014,189,5,3.5,5430,10327,2,0,2,3,10,4010,1420,2007,2007,98006,47.548,122.12,4340,10324,7,0,8.5,9770,15754
2.8e+05,2015,472,3,1,1160,10881,1,0,0,2,7,920,240,1983,1983,98074,47.634,122.03,1280,10843,32,0,4,2440,12003
4.5e+05,2014,270,2,1,1030,4365,1,0,0,3,7,1030,0,1942,1942,98117,47.688,122.39,1420,4268,72,0,3,2450,5298
2.99e+05,2014,331,3,2.5,2450,7062,2,0,0,3,8,2450,0,1993,1993,98023,47.306,122.36,1960,7200,21,0,5.5,4410,9650
6.2005e+05,2015,417,4,1.75,1760,6000,1,0,0,3,7,880,880,1946,1946,98119,47.651,122.37,2040,6000,69,0,5.75,3800,7760
5.988e+05,2014,347,1,1,1090,32010,1,0,0,4,6,1090,0,1958,1958,98014,47.693,121.87,1870,25346,56,0,2,2960,26436
4.965e+05,2014,313,4,2.5,2250,14440,1,0,0,3,7,1550,700,1967,1967,98027,47.522,122.05,2090,11400,47,0,6.5,4340,13650
1.081e+06,2015,443,4,2.25,2100,12172,1,0,0,5,9,2100,0,1961,1961,98040,47.546,122.23,2400,10713,54,0,6.25,4500,12813
3e+05,2014,249,3,1.75,1830,51836,1,0,0,4,7,1430,400,1966,1966,98059,47.477,122.1,1320,51400,48,0,4.75,3150,53230
3.0962e+05,2014,175,3,2.5,1860,3730,2,0,0,3,8,1860,0,2012,2012,98019,47.744,121.98,2110,4509,2,0,5.5,3970,6369
3e+05,2014,262,3,1.5,1320,15053,1,0,0,3,7,1320,0,1979,1979,98072,47.74,122.09,1250,13368,35,0,4.5,2570,14688
6.5e+05,2014,236,3,2.5,2790,6720,2,0,0,3,8,2790,0,2002,2002,98075,47.596,122.04,2620,6720,12,0,5.5,5410,9510
2.53e+05,2014,182,2,1,1310,7128,1,0,0,4,7,940,370,1980,1980,98031,47.396,122.19,1400,7161,34,0,3,2710,8471
3.75e+05,2015,409,2,1,710,4618,1,0,1,3,5,710,0,1925,1925,98199,47.64,122.39,1810,4988,90,0,3,2520,5698
7.225e+05,2014,258,4,3.5,2600,5100,2,0,0,3,8,1820,780,2003,2003,98117,47.695,122.39,2000,6720,11,0,7.5,4600,9320
8e+05,2015,446,4,2.25,2350,10664,1,0,1,2,7,1510,840,1952,1952,98040,47.574,122.24,2350,10140,63,0,6.25,4700,12490
2.998e+05,2014,141,2,1,790,5240,1,0,0,4,6,790,0,1925,1925,98118,47.53,122.29,1430,5320,89,0,3,2220,6110
2e+05,2014,313,1,0.75,680,9600,1,0,0,3,5,680,0,1947,1947,98115,47.696,122.31,1580,6624,67,0,1.75,2260,7304
4.55e+05,2014,299,3,2.5,1180,932,3,0,0,3,8,1180,0,2010,2010,98119,47.638,122.38,1180,2632,4,0,5.5,2360,3812
4.31e+05,2015,392,3,2.25,1830,8831,1,0,0,3,7,1460,370,1979,1979,98034,47.729,122.22,2330,8064,36,0,5.25,4160,9894
4.21e+05,2014,167,3,2.5,2890,21780,2,0,0,3,8,2890,0,2000,2000,98188,47.433,122.29,2120,8117,14,0,5.5,5010,11007
3.59e+05,2015,429,3,2.5,1450,3850,2,0,0,3,7,1450,0,2004,2004,98065,47.532,121.85,1970,3748,11,0,5.5,3420,5198
3.3e+05,2015,447,3,2.5,1660,2890,2,0,0,3,7,1660,0,2001,2001,98108,47.543,122.29,1540,2890,14,0,5.5,3200,4550
7e+05,2015,486,4,2.5,2490,7694,2,0,0,3,8,2490,0,1987,1987,98029,47.567,122.02,2140,8126,28,0,6.5,4630,10616
3.299e+05,2014,256,3,1.75,1670,5209,1,0,0,5,7,1670,0,1908,1908,98118,47.536,122.27,1990,4960,106,0,4.75,3660,6630
4.16e+05,2015,459,3,2,2220,94300,1,0,0,5,7,1640,580,1976,1976,98010,47.346,121.95,2070,80100,39,0,5,4290,82320
2.19e+05,2015,416,3,2.25,1940,6500,1,0,0,3,8,1440,500,1979,1979,98042,47.356,122.15,1880,8991,36,0,5.25,3820,10931
4.465e+05,2015,408,4,2.5,3060,7920,1,0,0,3,8,1810,1250,1974,1974,98028,47.767,122.26,2690,7767,41,0,6.5,5750,10827
2.499e+05,2014,176,3,2.5,1630,7700,1,0,0,3,7,1120,510,1978,1978,98031,47.388,122.21,1640,8160,36,0,5.5,3270,9790
2.55e+05,2014,318,4,1.75,960,8863,1,0,0,5,6,580,380,1949,1949,98118,47.537,122.29,1720,8249,65,0,5.75,2680,9209
2.9e+05,2014,204,2,1.5,770,850,2,0,0,3,7,770,0,2006,2006,98116,47.564,122.39,1350,915,8,0,3.5,2120,1685
3.3e+05,2014,140,4,2.5,2303,3680,2,0,0,3,8,2303,0,2013,2013,98001,47.26,122.28,2303,3760,1,0,6.5,4606,6063
3.3e+05,2015,368,3,1,1160,7912,1,0,0,4,7,1160,0,1956,1956,98125,47.734,122.31,1190,7482,59,0,4,2350,8642
3.48e+05,2014,209,3,1.75,1720,8867,1,0,0,3,8,1320,400,1985,1985,98058,47.44,122.14,2200,9170,29,0,4.75,3920,10890
3.64e+05,2014,175,3,2.5,1800,2790,2,0,0,3,8,1800,0,2011,2011,98126,47.545,122.37,1580,2036,3,0,5.5,3380,3836
4.2995e+05,2014,160,3,1.5,2010,9480,1,0,0,3,8,1570,440,1951,1951,98125,47.71,122.28,1920,8791,63,0,4.5,3930,10801
4.695e+05,2014,222,5,2.5,2970,24759,1,0,0,4,8,1670,1300,1969,1969,98031,47.391,122.17,2100,21803,45,0,7.5,5070,24773
7.5e+05,2014,300,4,2.5,3210,8938,2,0,0,3,10,3210,0,2005,2005,98075,47.582,121.97,3740,8108,9,0,6.5,6950,11318
4.8e+05,2015,389,6,3.75,2940,5054,2,0,0,3,7,2940,0,1942,2003,98146,47.512,122.39,1530,5320,73,1,9.75,4470,8260
3.85e+05,2015,436,3,1,1070,4000,1,0,0,4,7,1070,0,1971,1971,98108,47.553,122.31,1090,4000,44,0,4,2160,5070
4.645e+05,2014,174,3,1.75,1150,10466,1,0,0,5,7,1150,0,1959,1959,98006,47.553,122.18,1350,10384,55,0,4.75,2500,11534
5.4694e+05,2015,486,3,1,1470,7680,1,0,0,3,7,1220,250,1946,1946,98106,47.528,122.36,1470,6784,69,0,4,2940,8254
3.1495e+05,2015,473,4,1.75,1890,9623,1,0,0,4,7,1290,600,1969,1969,98001,47.29,122.28,1510,9711,46,0,5.75,3400,11601
4.5e+05,2014,148,3,1,1100,4600,1,0,0,3,7,1100,0,1917,1917,98116,47.569,122.39,1200,5175,97,0,4,2300,6275
6.5e+05,2015,459,2,2.5,1470,690,3,0,3,3,8,1470,0,2008,2008,98103,47.652,122.35,1480,1284,7,0,4.5,2950,2754
2.33e+05,2014,303,3,2,1710,4697,1,0,0,5,6,1710,0,1941,1941,98002,47.305,122.22,1030,4705,73,0,5,2740,6415
5.5e+05,2014,189,3,2,1970,4166,2,0,3,5,8,1270,700,1929,1929,98126,47.572,122.38,2390,4166,85,0,5,4360,6136
6.249e+05,2015,408,4,2.5,2270,11500,1,0,0,3,8,1540,730,1967,1967,98034,47.709,122.24,2020,10918,48,0,6.5,4290,13188
8.8525e+05,2014,196,4,2.5,3670,49658,2,0,0,3,10,3670,0,1999,1999,98074,47.622,122.02,3040,49658,15,0,6.5,6710,53328
5e+05,2014,303,4,2.25,2730,35100,2,0,0,3,8,2730,0,1977,1977,98075,47.591,122.01,2730,36677,37,0,6.25,5460,39407
3.25e+05,2014,214,3,1.75,1780,11096,1,0,0,3,7,1210,570,1979,1979,98074,47.617,122.05,1780,10640,35,0,4.75,3560,12420
4.235e+05,2014,287,3,2,2000,10490,1,0,0,3,8,1430,570,1978,1978,98033,47.698,122.17,1530,7659,36,0,5,3530,9659
3.525e+05,2014,231,3,2,1920,33630,1,0,0,3,8,1920,0,1992,1992,98056,47.498,122.17,2080,7505,22,0,5,4000,9425
3.2619e+05,2014,231,3,1,1300,8800,1,0,0,3,7,1300,0,1977,1977,98053,47.64,121.97,1600,12210,37,0,4,2900,13510
2.61e+05,2014,285,3,1,1780,7800,1,0,0,3,7,1060,720,1957,1957,98178,47.493,122.26,1450,7800,57,0,4,3230,9580
2.53e+05,2015,392,3,2.25,1440,9806,1,0,0,3,7,1440,0,1965,1965,98030,47.386,122.21,1590,9782,50,0,5.25,3030,11222
3.25e+05,2014,347,3,1,1160,11799,1,0,0,3,7,1160,0,1966,1966,98034,47.726,122.23,1220,10500,48,0,4,2380,11660
3.15e+05,2014,346,3,2.25,1370,1533,3,0,0,3,8,1370,0,2009,2009,98133,47.733,122.34,1370,1125,5,0,5.25,2740,2495
5e+05,2014,325,4,2,2280,7200,1,0,0,4,7,2280,0,1956,1956,98133,47.713,122.36,1100,7620,58,0,6,3380,9900
1.34e+05,2014,300,3,1,1270,8508,1,0,0,4,6,650,620,1942,1942,98168,47.496,122.32,1200,9415,72,0,4,2470,10685
9.1e+05,2015,376,4,3.5,3570,27699,2,0,0,3,11,3570,0,1990,1990,98052,47.717,122.1,3800,35880,25,0,7.5,7370,39450
2.49e+05,2014,228,3,1.5,1070,5150,1,0,0,4,6,1070,0,1940,1940,98106,47.533,122.35,1020,4800,74,0,4.5,2090,5870
5.55e+05,2014,359,5,2.75,2810,13144,1,0,0,3,8,1440,1370,1964,1964,98007,47.62,122.14,2480,13144,50,0,7.75,5290,15954
7.3e+05,2014,338,4,2.75,3800,9606,2,0,0,3,9,3800,0,2008,2008,98011,47.737,122.21,3400,9677,6,0,6.75,7200,13477
5.83e+05,2014,129,4,2.5,2660,4000,2,0,0,3,8,2660,0,2001,2001,98053,47.688,122.04,2330,4517,13,0,6.5,4990,7177
2.86e+05,2015,374,4,1.75,2190,8400,2,0,0,2,8,2190,0,1978,1978,98023,47.3,122.37,2410,7700,37,0,5.75,4600,9890
4.5e+05,2014,149,4,2,2240,7725,1,0,0,5,7,1120,1120,1956,1956,98106,47.533,122.36,1340,6300,58,0,6,3580,8540
4.3e+05,2014,153,4,2.25,1790,7203,1,0,0,4,7,1110,680,1973,1973,98155,47.771,122.29,2270,9000,41,0,6.25,4060,10790
1.164e+06,2015,457,3,3.5,3620,8072,2,0,0,3,10,2920,700,1999,1999,98006,47.565,122.13,3680,9624,16,0,6.5,7300,13244
3.04e+05,2014,163,3,1,1280,8184,1,0,0,4,6,1280,0,1947,1947,98155,47.747,122.32,1120,8184,67,0,4,2400,9464
6.4e+05,2015,478,4,2,2310,31850,1,0,0,4,8,2310,0,1984,1984,98072,47.771,122.12,2710,36042,31,0,6,5020,38352
5.4e+05,2014,181,3,1.75,2050,9580,1,0,0,3,8,1400,650,1984,1984,98074,47.621,122.04,1740,11952,30,0,4.75,3790,14002
6.05e+05,2015,485,5,1.75,3240,34510,2,0,0,4,7,2690,550,1963,1963,98029,47.553,122.03,2650,28250,52,0,6.75,5890,31490
4.69e+05,2014,360,3,1.75,1480,800,2,0,0,3,8,1000,480,2014,2014,98136,47.549,122.39,1480,1143,0,0,4.75,2960,2623
3.225e+05,2014,333,4,2.75,2060,6659,1,0,0,3,7,1280,780,1981,1981,98058,47.428,122.16,2020,8720,33,0,6.75,4080,10780
1.46e+05,2014,361,3,1,900,4770,1,0,0,3,6,900,0,1969,2009,98023,47.304,122.36,900,3480,45,1,4,1800,4380
4.75e+05,2015,445,3,1,1250,1.5012e+05,1,0,0,3,7,1250,0,1975,1975,98075,47.596,122.01,3060,50055,40,0,4,4310,51305
9.575e+05,2015,459,4,2.25,2360,11523,2,0,0,4,10,2360,0,1968,1968,98040,47.532,122.22,2850,11362,47,0,6.25,5210,13722
3.495e+05,2014,266,4,2.5,2030,4596,2,0,0,3,8,2030,0,2014,2014,98001,47.352,122.28,2040,4705,0,0,6.5,4070,6735
5.4e+05,2014,284,2,2,1640,3021,1,0,2,3,7,840,800,1959,1959,98107,47.666,122.36,1780,4500,55,0,4,3420,6140
6.5e+05,2014,251,4,2.25,1910,5120,1,0,0,3,8,1300,610,1954,1954,98199,47.653,122.41,1810,5153,60,0,6.25,3720,7063
7.675e+05,2015,458,4,2,2350,4815,1,0,0,4,7,1450,900,1914,1914,98103,47.668,122.34,1640,4013,101,0,6,3990,6363
1.1e+06,2014,154,5,2.75,2660,8737,1,0,4,5,8,1470,1190,1969,1969,98006,47.567,122.16,3280,8783,45,0,7.75,5940,11443
5.77e+05,2014,311,3,1.5,1560,20251,1,0,0,5,7,1200,360,1989,1989,98074,47.619,122.05,1560,19119,25,0,4.5,3120,20679
2.6e+05,2014,190,3,2.5,1490,8102,2,0,0,4,7,1490,0,1990,1990,98042,47.371,122.09,1640,7943,24,0,5.5,3130,9433
6.85e+05,2015,439,3,1.75,2210,8955,1,0,1,3,8,1560,650,1974,1974,98033,47.662,122.19,2210,8976,41,0,4.75,4420,11186
7.75e+05,2014,283,4,2.5,3180,15358,2,0,0,3,9,3180,0,1988,1988,98027,47.517,122.05,3020,15522,26,0,6.5,6200,18702
4.35e+05,2014,176,4,2.75,2110,8751,1,0,0,3,7,1510,600,1962,1962,98011,47.762,122.22,1660,10295,52,0,6.75,3770,12405
1.313e+06,2015,410,6,3,2980,7200,1,0,2,3,8,2980,0,1911,1911,98119,47.637,122.36,1720,3600,104,0,9,4700,6580
5.14e+05,2014,243,3,2.25,2260,54014,1,0,0,3,7,1450,810,1962,1962,98072,47.766,122.13,2140,44431,52,0,5.25,4400,46691
5.09e+05,2015,374,3,2.25,1780,9315,2,0,0,3,7,1780,0,1996,1996,98133,47.748,122.35,1780,8545,19,0,5.25,3560,10325
3.15e+05,2014,345,3,1,970,6828,1,0,0,3,6,970,0,1928,1928,98106,47.548,122.36,1160,11666,86,0,4,2130,12636
2.49e+05,2014,219,3,1.75,1300,8500,1,0,0,4,7,1300,0,1964,1964,98022,47.209,122,1410,7800,50,0,4.75,2710,9100
4.45e+05,2014,197,3,1.75,1490,10844,1,0,0,3,7,1210,280,1974,1974,98008,47.621,122.11,2090,9944,40,0,4.75,3580,11434
3.05e+05,2014,320,3,2.5,2100,6825,2,0,0,3,8,2100,0,1994,1994,98055,47.431,122.19,2180,7614,20,0,5.5,4280,9714
6.5e+05,2015,466,3,2,1840,3075,1,0,0,5,7,920,920,1928,1928,98103,47.689,122.35,1480,3774,87,0,5,3320,5614
4.65e+05,2014,306,3,2,1430,14250,1,0,0,3,7,1430,0,1953,1953,98033,47.701,122.2,1530,11475,61,0,5,2960,12905
4.6046e+05,2014,269,4,2.5,3284,6516,2,0,0,3,8,3284,0,2014,2014,98092,47.339,122.18,2555,5008,0,0,6.5,5839,8292
4.5e+05,2015,478,3,1.75,1250,5963,1,0,0,4,7,1250,0,1953,1953,98115,47.68,122.3,970,5100,62,0,4.75,2220,6350
2.999e+05,2014,231,3,1.75,1470,27000,1,0,0,3,7,1470,0,1958,1958,98198,47.394,122.31,2230,14186,56,0,4.75,3700,15656
2.9e+05,2015,367,4,2.75,2240,8162,2,0,0,5,7,1380,860,1946,1946,98133,47.743,122.34,1550,8163,69,0,6.75,3790,10403
5.219e+05,2014,333,3,2.5,2100,12338,2,0,0,3,9,2100,0,1997,1997,98072,47.741,122.17,2320,6257,17,0,5.5,4420,8357
5.175e+05,2014,314,3,2.5,1810,4332,2,0,0,3,8,1810,0,1992,1992,98029,47.578,122,1740,4332,22,0,5.5,3550,6142
3.97e+05,2014,230,4,2.5,3000,8584,2,0,0,3,7,3000,0,2003,2003,98038,47.369,122.03,2610,7570,11,0,6.5,5610,10570
4.92e+05,2014,192,2,1,1290,6272,1,0,0,4,6,890,400,1922,1922,98115,47.678,122.31,1260,5376,92,0,3,2550,6666
3.25e+05,2015,367,3,2.5,1830,7585,2,0,0,4,8,1830,0,1995,1995,98042,47.389,122.15,2070,7585,20,0,5.5,3900,9415
4.6e+05,2014,298,4,3,2230,1.089e+05,1,0,0,3,7,1410,820,1978,1978,98065,47.52,121.84,1960,65340,36,0,7,4190,67570
6.22e+05,2015,429,3,2.25,1550,1919,3,0,0,3,8,1550,0,2003,2003,98107,47.673,122.38,1550,2918,12,0,5.25,3100,4468
1.4e+05,2015,394,3,1,1090,10620,1,0,0,3,7,1090,0,1959,1959,98032,47.375,122.29,1380,10620,56,0,4,2470,11710
3.75e+05,2014,204,3,1,1870,7671,1,0,0,4,8,1720,150,1937,1937,98177,47.716,122.36,1460,7679,77,0,4,3330,9549
4.5e+05,2015,447,2,1,1010,3627,1,0,2,4,6,1010,0,1924,1924,98144,47.587,122.29,1630,4040,91,0,3,2640,5050
3.19e+05,2014,208,2,1,960,4400,1,0,0,4,7,960,0,1951,1951,98118,47.527,122.26,1520,5000,63,0,3,2480,5960
6.98e+05,2014,269,6,2.5,2680,11250,1,0,0,5,7,1340,1340,1967,1967,98033,47.655,122.19,2200,9875,47,0,8.5,4880,12555
4.675e+05,2015,365,3,1,1830,6453,1,0,0,4,7,1830,0,1956,1956,98125,47.714,122.29,1670,8012,59,0,4,3500,9842
5.45e+05,2014,154,5,2.5,2730,17240,1,0,0,5,7,1660,1070,1958,1958,98028,47.765,122.27,2250,13200,56,0,7.5,4980,15930
8.7495e+05,2015,457,2,1,1080,4000,1,0,0,3,7,1080,0,1940,1940,98117,47.69,122.39,1530,4240,75,0,3,2610,5320
6.67e+05,2015,390,5,2.25,2560,10360,1,0,0,4,8,1870,690,1966,1966,98008,47.582,122.13,2070,7875,49,0,7.25,4630,10435
6.25e+05,2015,479,3,2.5,2120,10021,1,0,0,4,8,1230,890,1976,1976,98006,47.562,122.14,2690,10183,39,0,5.5,4810,12303
4.2e+05,2014,208,3,1.75,1720,8102,1,0,0,5,6,860,860,1940,1940,98125,47.734,122.29,1440,8106,74,0,4.75,3160,9826
3.6635e+05,2015,444,4,1,1680,5043,1,0,0,4,6,1680,0,1911,1911,98118,47.535,122.27,1560,5765,104,0,5,3240,7445
5.85e+05,2014,135,5,1.75,2000,3750,2,0,0,4,7,2000,0,1921,1921,98103,47.662,122.36,1520,3750,93,0,6.75,3520,5750
5.82e+05,2014,191,5,2.5,2780,12335,1,0,0,4,8,1590,1190,1968,1968,98006,47.568,122.13,2750,9930,46,0,7.5,5530,12710
3.85e+05,2014,278,2,1,770,7554,1,0,0,3,6,770,0,1946,1946,98177,47.706,122.36,1390,7500,68,0,3,2160,8270
4.07e+05,2015,407,3,1,1140,7785,1,0,0,3,8,1140,0,1954,1954,98177,47.709,122.36,2080,10620,61,0,4,3220,11760
4.3995e+05,2014,203,3,2.5,1540,7773,2,0,0,4,8,1540,0,1982,1982,98034,47.722,122.19,1630,7340,32,0,5.5,3170,8880
3.65e+05,2015,477,3,1.75,1450,61419,1,0,0,4,8,1450,0,1976,1976,98092,47.334,122.16,2256,82328,39,0,4.75,3706,83778
6.835e+05,2014,174,3,1.5,1820,5756,1,0,0,3,7,1640,180,1946,1946,98119,47.648,122.37,1760,6169,68,0,4.5,3580,7989
2.27e+05,2014,271,2,1,860,6800,1,0,0,3,6,860,0,1943,1943,98133,47.727,122.34,1220,6800,71,0,3,2080,7660
5.6e+05,2015,433,4,1.75,2120,6250,1,0,0,5,7,1060,1060,1917,1917,98136,47.551,122.39,1410,6250,98,0,5.75,3530,8370
4.3e+05,2014,347,2,1.5,1320,1194,3,0,0,3,7,1320,0,2001,2001,98107,47.67,122.39,1320,1250,13,0,3.5,2640,2570
2.222e+05,2015,467,2,1,1210,10000,1,0,0,3,7,1210,0,1953,1953,98148,47.44,122.33,1620,10959,62,0,3,2830,12169
3.52e+05,2015,431,5,2.75,2980,9838,1,0,0,3,7,1710,1270,1968,1968,98030,47.381,122.22,2240,9838,47,0,7.75,5220,12818
3.49e+05,2014,161,3,2.5,1430,1002,3,0,0,3,8,1430,0,2002,2002,98103,47.698,122.35,1430,1530,12,0,5.5,2860,2960
2.35e+05,2015,375,3,1,1430,15246,1,0,0,4,7,980,450,1961,1961,98031,47.407,122.21,1960,13068,54,0,4,3390,14498
8.15e+05,2015,414,5,2.25,3410,35536,2,0,0,3,10,2530,880,1974,1974,98005,47.65,122.16,3140,43453,41,0,7.25,6550,46863
6.627e+05,2015,452,2,1.5,2440,6900,2,0,0,3,7,1590,850,1910,1910,98118,47.557,122.27,1770,6900,105,0,3.5,4210,9340
8.95e+05,2014,223,4,2,1710,4178,1,0,0,4,8,1710,0,1926,1926,98112,47.637,122.3,1760,4178,88,0,6,3470,5888
4.25e+05,2015,432,5,1.75,1400,5071,1,0,0,3,5,1400,0,1916,1916,98014,47.65,121.91,1200,7500,99,0,6.75,2600,8900
7.1e+05,2014,298,4,2.5,2880,12349,2,0,0,3,10,2880,0,1996,1996,98075,47.588,121.97,3490,11539,18,0,6.5,6370,14419
5.175e+05,2015,459,4,2.5,1520,3370,2,0,0,3,8,1520,0,1994,1994,98029,47.57,122,1860,4486,21,0,6.5,3380,6006
4.8995e+05,2014,169,3,2.25,1820,7326,2,0,0,3,8,1820,0,1983,1983,98034,47.713,122.22,2430,7696,31,0,5.25,4250,9516
7.1e+05,2014,153,3,2,2140,4923,1,0,0,4,8,1070,1070,1928,1928,98103,47.69,122.34,1470,4923,86,0,5,3610,7063
2.9e+05,2014,303,2,1.75,1560,7575,1,0,0,3,8,1560,0,2002,2002,98030,47.378,122.23,2050,9000,12,0,3.75,3610,10560
3.7995e+05,2015,415,4,2.5,2612,5850,2,0,0,3,8,2612,0,2014,2014,98030,47.375,122.19,2419,8984,1,0,6.5,5031,11596
5e+05,2015,460,3,2,2050,11454,1,0,0,3,8,2050,0,1987,1987,98052,47.639,122.11,1980,11424,28,0,5,4030,13474
9.45e+05,2014,169,2,2.5,2540,7089,2,0,0,3,9,2540,0,2004,2004,98116,47.575,122.41,1330,7089,10,0,4.5,3870,9629
2.25e+05,2014,222,3,1.5,1660,7221,1,0,0,3,7,980,680,1962,1962,98168,47.496,122.32,1770,8083,52,0,4.5,3430,9743
3.425e+05,2014,174,2,1.75,1210,7507,1,0,0,3,7,1210,0,1982,1982,98034,47.708,122.23,1840,7500,32,0,3.75,3050,8710
4.59e+05,2014,202,2,2,1480,804,3,0,0,3,8,1480,0,2008,2008,98122,47.602,122.31,1380,1751,6,0,4,2860,3231
5.75e+05,2014,166,4,2.5,2120,9603,2,0,0,3,8,2120,0,1985,1985,98027,47.535,122.05,1990,9611,29,0,6.5,4110,11731
2.5e+05,2014,196,2,1,990,10556,2,0,0,3,7,990,0,1981,1981,98056,47.512,122.19,1350,7295,33,0,3,2340,8285
3.8785e+05,2014,345,4,1.75,2520,15205,1,0,0,4,7,2040,480,1954,1954,98028,47.764,122.26,1680,10000,60,0,5.75,4200,12520
3.184e+05,2014,204,4,2.5,1820,6916,2,0,0,3,7,1820,0,1994,1994,98038,47.386,122.03,1680,6995,20,0,6.5,3500,8815
6.09e+05,2014,258,3,2.5,2630,10131,2,0,0,3,9,2630,0,1989,1989,98028,47.77,122.26,2800,10123,25,0,5.5,5430,12753
8.65e+05,2014,298,4,4,2790,16117,2,0,0,4,9,2790,0,1999,1999,98005,47.603,122.16,2740,25369,15,0,8,5530,28159
4.23e+05,2015,465,3,1.75,1100,10005,1,0,0,5,7,1100,0,1964,1964,98056,47.537,122.17,1340,9709,51,0,4.75,2440,10809
3.75e+05,2014,346,3,2.5,1530,1131,3,0,0,3,8,1530,0,2009,2009,98103,47.699,122.35,1530,1445,5,0,5.5,3060,2975
2.372e+05,2015,471,3,1.5,1220,9000,1,0,0,4,7,1220,0,1968,1968,98042,47.364,122.11,1220,9472,47,0,4.5,2440,10692
4.55e+05,2015,445,2,1.5,1260,5100,1,0,0,3,7,1260,0,1941,1941,98115,47.691,122.29,1640,5100,74,0,3.5,2900,6360
4.05e+05,2014,312,5,2.5,3370,5092,2,0,0,3,7,3370,0,2006,2006,98038,47.359,122.04,2910,5092,8,0,7.5,6280,8462
4.45e+05,2014,250,4,2.5,2360,81892,1,0,0,3,8,2360,0,2000,2000,98042,47.369,122.16,1730,18096,14,0,6.5,4090,20456
8.51e+05,2014,182,5,3.25,3760,9792,2,0,0,3,9,2550,1210,1984,1984,98006,47.565,122.11,2960,16500,30,0,8.25,6720,20260
3.49e+05,2015,432,3,2.5,2550,7709,2,0,0,3,9,2550,0,1989,1989,98023,47.308,122.39,2410,9250,26,0,5.5,4960,11800
5.55e+05,2014,269,3,2,2240,11250,1,0,0,3,8,2240,0,1968,1968,98008,47.637,122.12,2200,12500,46,0,5,4440,14740
5.09e+05,2014,304,4,2,1960,2166,1,0,0,4,7,1260,700,1926,1926,98103,47.654,122.34,1670,4000,88,0,6,3630,5960
3.5275e+05,2015,470,4,2.75,2270,24237,1,0,0,4,7,1360,910,1977,1977,98058,47.467,122.17,2050,8016,38,0,6.75,4320,10286
3.79e+05,2015,487,5,2.5,2803,8550,1,0,0,3,8,2803,0,1963,2011,98003,47.303,122.31,1810,8550,52,1,7.5,4613,11353
2.49e+05,2014,319,4,1,1200,7552,1,0,0,3,6,1060,140,1919,1919,98126,47.532,122.37,1580,7680,95,0,5,2780,8880
3.25e+05,2014,129,3,2.25,1352,1694,3,0,0,3,8,1352,0,2007,2007,98125,47.727,122.31,1439,1387,7,0,5.25,2791,2739
1.05e+06,2015,410,4,3,3080,10757,2,0,3,5,8,3080,0,1961,1961,98006,47.567,122.16,2810,10757,54,0,7,5890,13837
3.1e+05,2015,416,5,2,2900,11970,2,0,0,4,7,2900,0,1969,1969,98072,47.741,122.09,1260,12398,46,0,7,4160,15298
5.275e+05,2014,334,4,2.25,2270,8480,1,0,0,5,8,1310,960,1973,1973,98006,47.545,122.17,1910,9050,41,0,6.25,4180,11320
7.5e+05,2015,443,3,2.5,2790,21043,2,0,0,3,9,2790,0,1993,1993,98053,47.673,122.03,2900,34589,22,0,5.5,5690,37379
4e+05,2015,477,3,1,1240,4000,1,0,0,3,8,1240,0,1928,2000,98106,47.547,122.36,1200,17707,87,1,4,2440,18947
3.6e+05,2014,194,3,2.25,2130,8466,1,0,0,3,7,1290,840,1983,1983,98055,47.454,122.21,2250,9682,31,0,5.25,4380,11812
4.3e+05,2014,142,4,3,3220,8936,2,0,0,3,9,2450,770,1990,1990,98031,47.421,122.21,2810,10500,24,0,7,6030,13720
3.65e+05,2014,276,4,2.25,2070,8893,2,0,0,4,8,2070,0,1986,1986,98058,47.439,122.16,2390,7700,28,0,6.25,4460,9770
3.4e+05,2015,415,3,2.75,1720,28000,1,0,0,4,7,1720,0,1958,1958,98058,47.438,122.18,2000,41817,57,0,5.75,3720,43537
6.125e+05,2015,417,4,2.5,2550,10623,2,0,0,3,9,2550,0,1992,1992,98029,47.569,121.99,2750,8100,23,0,6.5,5300,10650
3.65e+05,2014,345,2,1.5,1200,6380,1,0,0,3,7,1200,0,1929,1929,98115,47.697,122.32,1290,6598,85,0,3.5,2490,7798
3.505e+05,2015,457,3,1.75,2080,5200,1,0,0,3,7,1040,1040,1974,1974,98166,47.474,122.35,1410,6550,41,0,4.75,3490,8630
4.36e+05,2014,332,4,2.5,2495,5751,2,0,0,3,7,2495,0,2002,2002,98019,47.724,121.96,2490,6300,12,0,6.5,4985,8795
1.65e+05,2014,242,4,1,1220,7980,1,0,0,3,6,1220,0,1944,1944,98178,47.492,122.24,1210,7920,70,0,5,2430,9140
1.5734e+05,2015,444,2,1,900,23000,1,0,0,2,7,900,0,1953,1953,98042,47.358,122.16,1460,8265,62,0,3,2360,9165
3.28e+05,2014,352,4,2.75,1930,3840,1,0,0,3,7,1170,760,1997,1997,98106,47.53,122.35,1610,3840,17,0,6.75,3540,5770
3.89e+05,2014,182,4,1.75,2400,7700,1,0,0,4,7,1500,900,1927,1927,98133,47.712,122.33,1530,7700,87,0,5.75,3930,10100
4.5e+05,2014,256,3,1.75,1850,8667,1,0,0,4,7,880,970,1982,1982,98033,47.703,122.2,1450,10530,32,0,4.75,3300,12380
7.6e+05,2014,249,4,2.5,2990,5280,2,0,0,3,9,2210,780,2003,2003,98027,47.535,122.07,2990,6299,11,0,6.5,5980,9289
2.6e+05,2014,284,3,2.5,1510,6095,2,0,0,4,7,1510,0,1991,1991,98038,47.35,122.04,1520,6000,23,0,5.5,3030,7510
2.52e+05,2014,353,3,1.75,2050,11313,1,0,0,3,7,1520,530,1987,1987,98023,47.284,122.36,1620,8065,27,0,4.75,3670,10115
6.65e+05,2014,243,4,3.5,3770,47480,2,0,0,3,9,3770,0,2003,2003,98010,47.355,121.99,3380,42689,11,0,7.5,7150,46459
2.32e+05,2014,188,3,1.5,1460,15000,1,0,0,3,7,1460,0,1966,1966,98001,47.318,122.27,1510,15000,48,0,4.5,2970,16460
3.209e+05,2014,194,3,2,1770,7251,1,0,0,4,8,1770,0,1990,1990,98031,47.409,122.17,2560,7210,24,0,5,4330,8980
6.5e+05,2015,463,6,3,2960,5000,1,0,0,3,8,1790,1170,1968,1968,98103,47.697,122.34,1280,1251,47,0,9,4240,4211
7.84e+05,2014,162,3,3.5,3950,1.1108e+05,1,0,0,3,9,2460,1490,1989,1989,98052,47.697,122.07,2480,88500,25,0,6.5,6430,92450
6.53e+05,2014,257,3,3,3040,5067,3,0,2,3,10,3040,0,1993,1993,98118,47.541,122.27,1820,5998,21,0,6,4860,9038
1.96e+05,2015,446,3,1,1090,7400,1,0,0,4,7,1090,0,1962,1962,98092,47.292,122.19,1140,8165,53,0,4,2230,9255
1.58e+06,2014,173,4,2.5,4570,74487,2,0,4,5,12,4570,0,1948,1985,98177,47.728,122.37,3810,74487,66,1,6.5,8380,79057
4.7e+05,2014,204,4,2.5,2680,8062,1,0,3,4,7,1530,1150,1967,1967,98198,47.413,122.33,1920,8600,47,0,6.5,4600,11280
2.25e+05,2014,160,3,1.75,1760,26055,1,0,0,3,7,920,840,1979,1979,98042,47.366,122.1,1350,13475,35,0,4.75,3110,15235
3.7e+05,2014,235,3,2.5,2313,5700,2,0,0,3,9,2313,0,2011,2011,98030,47.357,122.2,2323,5701,3,0,5.5,4636,8014
3.45e+05,2014,159,2,1.5,1340,1210,2,0,0,3,8,1120,220,2008,2008,98144,47.588,122.31,1340,1213,6,0,3.5,2680,2553
6.35e+05,2014,250,4,2,2660,8160,1,0,0,4,7,1380,1280,1949,1949,98177,47.723,122.36,1660,8160,65,0,6,4320,10820
3.65e+05,2014,239,2,1,990,8250,1,0,0,3,7,990,0,1955,1955,98133,47.725,122.33,1080,8168,59,0,3,2070,9158
6.53e+05,2014,152,3,2.5,2290,3475,2,0,0,3,9,2290,0,2006,2006,98029,47.555,122,2340,3626,8,0,5.5,4630,5916
4.435e+05,2014,170,4,2.5,2040,21781,2,0,0,3,8,2040,0,1994,1994,98014,47.646,121.9,2410,21781,20,0,6.5,4450,23821
3.1e+05,2014,313,4,3,2320,7200,2,0,0,3,7,2320,0,1976,1976,98155,47.77,122.31,2050,10000,38,0,7,4370,12320
7.21e+05,2014,264,2,1.5,1790,4250,1,0,0,3,7,920,870,1915,2014,98112,47.637,122.3,1910,4250,99,1,3.5,3700,6040
6.28e+05,2014,133,4,2,2260,6000,1,0,0,3,8,1430,830,1958,1958,98115,47.688,122.3,2030,5874,56,0,6,4290,8134
1.01e+06,2014,319,4,3.5,3350,3752,2,0,0,3,9,2550,800,2007,2007,98117,47.678,122.36,1050,4960,7,0,7.5,4400,8310
1.9195e+05,2015,414,2,2.5,1390,1302,2,0,0,3,7,1390,0,1987,1987,98003,47.308,122.33,1390,2052,28,0,4.5,2780,3442
6.445e+05,2014,301,4,2.5,2990,5342,2,0,0,3,8,2990,0,2004,2004,98074,47.612,122.01,2990,5936,10,0,6.5,5980,8926
2.803e+05,2014,340,2,1,920,5000,1,0,0,4,6,490,430,1949,1949,98103,47.701,122.34,1500,5000,65,0,3,2420,5920
3.25e+05,2015,413,3,2.5,1570,3143,2,0,0,3,7,1570,0,2001,2001,98019,47.736,121.97,1740,3591,14,0,5.5,3310,5161
3.39e+05,2015,474,3,2.25,1970,7210,1,0,0,4,8,1380,590,1978,1978,98030,47.382,122.17,1970,7350,37,0,5.25,3940,9320
4.321e+05,2014,210,3,1.75,1840,7350,1,0,0,3,8,1310,530,1976,1976,98034,47.709,122.23,1860,7000,38,0,4.75,3700,8840
4.4e+05,2014,214,4,2.5,2800,28254,2,0,0,3,9,2800,0,2001,2001,98038,47.355,122.06,2530,4694,13,0,6.5,5330,7494
2.299e+05,2014,291,3,1.75,1100,7224,1,0,0,3,7,1100,0,1981,1981,98032,47.372,122.28,1700,8447,33,0,4.75,2800,9547
4.8e+05,2014,276,3,1.75,1680,2552,1,0,0,4,7,840,840,1952,1952,98117,47.685,122.39,1220,3880,62,0,4.75,2900,5560
5.48e+05,2014,153,3,2.5,2110,4099,2,0,0,3,8,2110,0,2001,2001,98072,47.751,122.17,2110,4871,13,0,5.5,4220,6981
8.85e+05,2014,321,3,3.25,2640,16090,1,0,2,4,8,1960,680,1976,1976,98040,47.537,122.21,3690,15000,38,0,6.25,6330,17640
4.85e+05,2014,242,3,1,1020,6120,1,0,0,3,7,1020,0,1941,1941,98115,47.679,122.28,2370,6695,73,0,4,3390,7715
2.6e+05,2015,485,3,1.75,1680,8725,1,0,0,3,8,1240,440,1978,1978,98023,47.311,122.4,2020,8352,37,0,4.75,3700,10032
6.88e+05,2014,168,3,3,3450,16200,2,0,0,3,10,3450,0,1983,1983,98074,47.632,122.04,3130,12150,31,0,6,6580,15600
3.3e+05,2014,255,5,2.5,3597,4972,2,0,0,3,7,3597,0,2006,2006,98001,47.3,122.28,3193,6000,8,0,7.5,6790,9597
2.31e+05,2015,389,4,1,1220,5120,1,0,0,5,6,1220,0,1940,1940,98022,47.205,122,1540,7670,75,0,5,2760,8890
2.42e+05,2014,292,3,1.5,1640,8922,1,0,0,4,7,1640,0,1963,1963,98146,47.495,122.34,1540,9040,51,0,4.5,3180,10680
3.535e+05,2015,486,3,2.5,2020,4845,2,0,0,3,7,2020,0,2001,2001,98038,47.385,122.03,1930,5134,14,0,5.5,3950,7154
4.25e+05,2014,153,3,2.25,1660,6000,1,0,0,3,7,1110,550,1979,1979,98122,47.611,122.3,1440,4080,35,0,5.25,3100,5740
5.25e+05,2014,326,1,1,830,3200,1,0,0,3,7,830,0,1924,1924,98103,47.656,122.35,1350,2512,90,0,2,2180,3342
1.685e+05,2014,148,3,1,1100,10125,1,0,0,3,7,1100,0,1969,1969,98042,47.367,122.11,1570,10650,45,0,4,2670,11750
4.69e+05,2014,228,2,1,1120,4284,1,0,0,3,6,730,390,1921,1921,98105,47.669,122.32,2050,4160,93,0,3,3170,5280
2.5391e+05,2014,270,3,1,940,8400,1,0,0,5,7,940,0,1958,1958,98056,47.511,122.17,950,8400,56,0,4,1890,9340
1.29e+05,2014,307,2,1,760,5240,1,0,0,3,6,760,0,1949,1949,98032,47.388,122.23,980,5080,65,0,3,1740,5840
4.5e+05,2015,415,3,2,1010,2820,1,0,0,3,7,1010,0,1905,1905,98122,47.607,122.3,1330,3000,110,0,5,2340,4010
1.101e+06,2015,436,3,1.5,2220,4830,2,0,3,3,9,1790,430,1928,2010,98116,47.583,122.4,1670,4830,87,1,4.5,3890,7050
2.05e+05,2014,232,3,2,1800,11419,1,0,0,3,8,1800,0,1989,1989,98092,47.262,122.22,2220,11406,25,0,5,4020,13206
2.4e+05,2014,286,4,1.75,1420,5382,1,0,0,5,5,1040,380,1942,1942,98056,47.495,122.19,1150,5382,72,0,5.75,2570,6802
5.395e+05,2014,156,3,2.5,3080,12476,2,0,0,3,10,3080,0,1990,1990,98038,47.375,122.03,3130,13631,24,0,5.5,6210,16711
7.97e+05,2014,190,3,2.5,1370,1911,2,0,0,3,9,1370,0,1907,2011,98109,47.638,122.35,1630,2090,107,1,5.5,3000,3460
1.059e+06,2014,271,4,3.5,4460,16271,2,0,2,3,11,4460,0,2001,2001,98075,47.586,121.97,4540,17122,13,0,7.5,9000,21582
3.33e+05,2014,321,3,2.5,1520,3041,2,0,0,3,7,1520,0,2009,2009,98059,47.487,122.15,1820,3229,5,0,5.5,3340,4749
8.5e+05,2015,407,3,2.5,3120,12406,2,0,2,3,9,1940,1180,1983,1983,98006,47.551,122.14,3240,13141,32,0,5.5,6360,16261
3.75e+05,2014,306,3,2,1410,10078,1,0,0,4,6,1410,0,1983,1983,98072,47.759,122.14,2090,9202,31,0,5,3500,10612
5.99e+05,2014,143,3,2.75,1960,2500,1,0,0,5,7,1410,550,1926,1926,98103,47.674,122.35,2040,5000,88,0,5.75,4000,6960
2.0995e+05,2014,334,3,1,1660,8800,1,0,0,4,7,960,700,1963,1963,98023,47.321,122.35,1370,10112,51,0,4,3030,11772
7.875e+05,2014,214,4,1.75,1580,9382,1,0,0,3,7,1080,500,1963,1963,98039,47.635,122.23,2010,9382,51,0,5.75,3590,10962
5.36e+05,2015,403,4,2.5,2880,8833,2,0,0,3,7,2880,0,2006,2006,98065,47.539,121.89,2570,5234,9,0,6.5,5450,8114
4e+05,2014,160,4,2.5,2530,7563,1,0,0,3,7,1440,1090,1978,1978,98011,47.776,122.21,1960,7811,36,0,6.5,4490,10341
2.495e+05,2015,401,4,1.5,2120,8554,1,0,0,4,7,1170,950,1977,1977,98002,47.293,122.19,1790,8554,38,0,5.5,3910,10674
5.425e+05,2014,187,3,2.5,2040,10086,2,0,0,3,8,2040,0,1987,1987,98052,47.679,122.11,1940,10272,27,0,5.5,3980,12312
5.75e+05,2014,203,3,2.25,2680,1.0019e+05,2,0,0,4,8,1580,1100,1978,1978,98027,47.478,122.02,2540,60548,36,0,5.25,5220,63228
4.975e+05,2014,278,5,1.5,2170,8610,1,0,0,4,7,1230,940,1959,1959,98008,47.611,122.13,1670,8610,55,0,6.5,3840,10780
2.65e+05,2014,228,5,4,1400,8580,1,0,0,5,7,900,500,1954,1954,98188,47.456,122.29,1220,8832,60,0,9,2620,10232
2.3e+05,2014,300,3,1,1020,12289,1,0,0,4,7,1020,0,1967,1967,98058,47.423,122.16,1300,9894,47,0,4,2320,10914
5.875e+05,2014,264,4,2.25,1780,6120,1,0,0,3,8,1310,470,1951,1951,98115,47.696,122.29,1780,6120,63,0,6.25,3560,7900
6.37e+05,2015,424,4,2.75,2900,5803,2,0,0,3,9,2900,0,2007,2007,98028,47.737,122.23,2900,6212,8,0,6.75,5800,9112
5.125e+05,2015,424,3,1.75,1610,7200,1,0,0,3,7,1180,430,1976,1976,98007,47.597,122.14,1520,7973,39,0,4.75,3130,9583
1.205e+06,2015,453,4,3,3330,7650,1,0,0,3,9,1830,1500,2008,2008,98103,47.689,122.35,1200,3876,7,0,7,4530,7206
4.4e+05,2014,160,3,1.5,1290,1286,3,0,0,3,7,1290,0,2000,2000,98103,47.662,122.35,1720,1286,14,0,4.5,3010,2576
3.29e+05,2014,312,2,1,940,7700,1,0,0,4,6,940,0,1916,1916,98133,47.707,122.35,1290,7375,98,0,3,2230,8315
4e+05,2015,413,4,2.5,2310,5813,2,0,0,3,8,2310,0,2014,2014,98146,47.511,122.36,1830,7200,1,0,6.5,4140,9510
7.825e+05,2014,249,4,2.5,2930,7806,2,0,0,3,9,2930,0,2005,2005,98074,47.622,122.02,2600,6051,9,0,6.5,5530,8981
3.18e+05,2015,390,3,1.75,1570,12506,1,0,0,4,8,1570,0,1959,1959,98003,47.337,122.32,2120,13243,56,0,4.75,3690,14813
2.84e+05,2014,189,4,1.75,1880,8800,1,0,0,3,7,1130,750,1960,1960,98168,47.514,122.33,1340,8733,54,0,5.75,3220,10613
1.6e+05,2015,389,2,1,1070,4200,1,0,0,4,6,1070,0,1983,1983,98002,47.334,122.22,1150,4200,32,0,3,2220,5270
3.5e+05,2014,356,3,1.75,1470,8645,1,0,0,3,6,1470,0,1949,1949,98155,47.752,122.32,1470,7680,65,0,4.75,2940,9150
3.49e+05,2015,436,3,1.75,1790,50529,1,0,0,5,7,1090,700,1965,1965,98042,47.351,122.07,1940,50529,50,0,4.75,3730,52319
4.6e+05,2014,166,2,1,890,2100,1,0,0,4,6,760,130,1919,1919,98107,47.656,122.36,1600,4250,95,0,3,2490,5140
1.35e+06,2015,487,4,1.75,2000,3728,1,0,0,4,9,1820,180,1926,1926,98112,47.643,122.3,1950,3728,89,0,5.75,3950,5728
3.8e+05,2014,222,4,2.5,2500,11070,1,0,2,4,8,1300,1200,1964,1964,98003,47.336,122.33,2500,11070,50,0,6.5,5000,13570
5.25e+05,2015,433,3,2.5,2200,4544,2,0,0,3,8,2200,0,2000,2000,98065,47.532,121.87,2400,5431,15,0,5.5,4600,7631
2.12e+05,2015,374,2,1,790,7153,1,0,0,4,6,790,0,1944,1944,98168,47.487,122.32,810,7128,71,0,3,1600,7918
5.49e+05,2014,125,2,1,1140,5400,1,0,0,5,7,1140,0,1908,1908,98112,47.62,122.29,1520,4800,106,0,3,2660,5940
1e+05,2014,160,4,1,1120,2685,1,0,0,3,5,860,260,1939,1939,98055,47.49,122.2,1120,4838,75,0,5,2240,5958
5.0795e+05,2015,451,4,2.5,2630,6283,2,0,0,3,9,2630,0,2006,2006,98059,47.508,122.16,2630,7210,9,0,6.5,5260,9840
4.3e+05,2014,314,3,2,2350,12480,1,0,0,3,7,1600,750,1981,1981,98028,47.766,122.26,2160,12000,33,0,5,4510,14350
4.75e+05,2015,408,2,1,920,5157,1,0,0,3,6,920,0,1909,1909,98118,47.55,122.27,1700,5150,106,0,3,2620,6070
2.9798e+05,2015,433,3,2.25,2820,8100,1,0,0,4,7,1720,1100,1947,1947,98168,47.494,122.3,1040,8100,68,0,5.25,3860,10920
5.31e+05,2014,318,2,1.5,1260,6660,1,0,0,4,7,1260,0,1926,1926,98115,47.679,122.29,2140,4770,88,0,3.5,3400,6030
2.769e+05,2015,388,3,2.5,1620,7320,2,0,0,3,7,1620,0,1989,1989,98038,47.362,122.05,1550,7686,26,0,5.5,3170,9306
1.105e+06,2014,359,5,2.75,3300,7560,2,0,0,3,10,3300,0,2007,2007,98052,47.647,122.12,3150,8580,7,0,7.75,6450,11880
4.5e+05,2015,376,5,2.5,1900,9460,1,0,0,3,7,1190,710,1969,1969,98034,47.71,122.2,1940,8360,46,0,7.5,3840,10260
1.38e+06,2015,492,5,4.25,4050,18827,1,0,2,4,10,2150,1900,1979,1979,98040,47.532,122.24,3600,25120,36,0,9.25,7650,29170
4.99e+05,2014,155,3,3.5,1690,1432,2,0,0,3,7,1360,330,2008,2008,98199,47.651,122.4,1650,2788,6,0,6.5,3340,4478
3.9e+05,2015,436,3,1.75,1300,10030,1,0,0,4,7,1300,0,1967,1967,98034,47.736,122.19,1520,7713,48,0,4.75,2820,9013
2.24e+05,2015,368,3,1.75,1760,6300,1,0,0,3,7,1060,700,1963,1963,98178,47.5,122.26,1340,7300,52,0,4.75,3100,9060
1.95e+05,2014,141,3,1.75,1380,7350,1,0,0,3,7,990,390,1981,1981,98042,47.369,122.09,1660,8400,33,0,4.75,3040,9780
6.05e+05,2015,436,4,2.25,1750,6120,1,0,0,3,7,1150,600,1962,1962,98115,47.696,122.29,1350,6120,53,0,6.25,3100,7870
2.525e+05,2014,129,3,1,1030,6127,1,0,0,3,7,880,150,1947,1947,98125,47.719,122.32,1610,6127,67,0,4,2640,7157
3.55e+05,2014,263,3,1.75,1960,7705,1,0,0,4,7,980,980,1950,1950,98106,47.53,122.35,1380,4349,64,0,4.75,3340,6309
2.9995e+05,2015,401,4,2.5,1900,4054,2,0,0,3,7,1900,0,2003,2003,98042,47.377,122.12,2520,4085,12,0,6.5,4420,5985
4.25e+05,2014,228,3,2.25,1740,9682,1,0,0,5,8,1740,0,1969,1969,98056,47.514,122.17,2100,9536,45,0,5.25,3840,11276
3.6e+05,2014,214,3,1.75,1560,7930,2,0,0,4,7,1560,0,1980,1980,98059,47.478,122.16,1720,8073,34,0,4.75,3280,9633
4.55e+05,2014,279,5,3.5,3080,7759,2,0,0,3,8,2310,770,2003,2003,98019,47.745,121.98,2980,8223,11,0,8.5,6060,11303
4.12e+05,2014,231,3,1,1660,6992,1,0,0,5,7,1260,400,1952,1952,98155,47.758,122.32,1390,7359,62,0,4,3050,9019
3.75e+05,2014,238,5,1.5,2050,9360,1,0,0,3,7,1520,530,1968,1968,98055,47.436,122.19,1840,9383,46,0,6.5,3890,11433
3.7975e+05,2014,313,4,2.75,2390,9650,1,0,2,3,8,1620,770,1976,1976,98003,47.344,122.32,2390,10000,38,0,6.75,4780,12390
2.625e+05,2014,197,3,1.75,2259,26831,1,0,3,5,7,1491,768,1908,1908,98001,47.274,122.27,1980,15794,106,0,4.75,4239,18053
6.25e+05,2014,285,2,1,2160,2192,1,0,0,5,8,1170,990,1925,1925,98119,47.636,122.37,1150,2152,89,0,3,3310,4312
4.1e+05,2014,210,3,1.5,1750,32500,1,0,0,4,7,1750,0,1966,1966,98027,47.532,121.96,1820,1.028e+05,48,0,4.5,3570,1.0455e+05
2.9e+05,2014,307,3,1.75,1340,63597,1,0,0,4,7,1340,0,1963,1963,98038,47.438,122.01,1950,87120,51,0,4.75,3290,88460
2.99e+05,2014,162,3,2.5,2210,10119,1,0,0,4,7,1450,760,1966,1966,98030,47.378,122.22,2110,10119,48,0,5.5,4320,12329
4.91e+05,2015,415,3,2,1250,1306,3,0,0,3,7,1250,0,2000,2000,98107,47.67,122.39,1320,1306,15,0,5,2570,2556
2.46e+05,2014,286,3,2.25,1440,10500,1,0,0,3,8,1130,310,1983,1983,98023,47.318,122.39,1510,8125,31,0,5.25,2950,9565
3.92e+05,2014,265,5,2.5,2340,5670,2,0,0,3,7,2340,0,2009,2009,98059,47.491,122.15,2190,4869,5,0,7.5,4530,7209
5e+05,2015,402,5,2,2300,7897,2,0,0,4,8,2300,0,1956,1956,98133,47.756,122.36,2030,7902,59,0,7,4330,10202
4.875e+05,2015,437,3,2.5,1810,1988,2,0,0,3,7,1350,460,1997,1997,98199,47.651,122.39,1600,1525,18,0,5.5,3410,3335
2.75e+05,2015,486,3,1.75,1890,5000,1,0,0,3,7,1890,0,2003,2003,98092,47.336,122.17,2960,5421,12,0,4.75,4850,7311
7.15e+05,2014,198,3,3.25,3230,5000,2,0,0,3,9,3230,0,2006,2006,98029,47.556,122,2670,3977,8,0,6.25,5900,7207
1.039e+06,2014,128,4,1,3410,5000,2,0,0,5,8,2190,1220,1910,1910,98144,47.581,122.29,2550,5000,104,0,5,5960,8410
3.53e+05,2015,486,4,1.5,1100,9600,1,0,0,4,6,1100,0,1960,1960,98033,47.7,122.17,1100,9630,55,0,5.5,2200,10730
8e+05,2014,347,4,3.75,3370,6766,2,0,0,3,9,3370,0,2005,2005,98052,47.706,122.11,3530,6766,9,0,7.75,6900,10136
2.925e+05,2014,263,4,1.75,2140,8162,1,0,0,3,7,1420,720,1968,1968,98023,47.31,122.38,2040,7632,46,0,5.75,4180,9772
3.38e+05,2014,320,4,3,2090,7500,1,0,0,3,7,1370,720,1986,1986,98056,47.489,122.18,1810,7650,28,0,7,3900,9740
3.75e+05,2014,306,3,2,1640,9750,1,0,0,3,7,1640,0,1959,1959,98028,47.742,122.24,1340,9750,55,0,5,2980,11390
8.15e+05,2014,298,4,2,1400,4800,2,0,0,3,7,1400,0,1986,1986,98122,47.617,122.3,1620,2595,28,0,6,3020,3995
2.89e+05,2014,236,3,2.5,2110,8304,1,0,0,4,7,2110,0,1985,1985,98030,47.356,122.17,1680,7508,29,0,5.5,3790,9618
7.2208e+05,2015,430,3,3.25,3680,7650,2,0,0,3,9,2340,1340,1988,1988,98074,47.627,122.03,2280,8515,27,0,6.25,5960,12195
3.2e+05,2014,226,3,1,1330,5850,1,0,0,3,7,930,400,1954,1954,98108,47.55,122.3,1440,5850,60,0,4,2770,7180
2.45e+05,2015,422,3,2.25,1350,6775,1,0,0,3,7,930,420,1981,1981,98032,47.359,122.29,1460,7210,34,0,5.25,2810,8560
4.05e+05,2014,173,3,2.25,1520,1245,3,0,0,3,8,1520,0,2004,2004,98103,47.691,122.34,1520,1470,10,0,5.25,3040,2990
3.685e+05,2014,341,5,2.75,2530,7601,1,0,0,3,7,1520,1010,1992,1992,98188,47.468,122.26,2400,7776,22,0,7.75,4930,10306
1.96e+05,2015,446,3,1,1000,8470,1,0,0,4,6,1000,0,1963,1963,98023,47.306,122.37,1020,8470,52,0,4,2020,9470
5.5e+05,2014,189,4,1.75,2150,9000,1,0,0,4,7,1110,1040,1966,1966,98052,47.681,122.11,2040,9000,48,0,5.75,4190,11150
2.988e+05,2014,235,2,1,860,8189,1,0,0,3,6,860,0,1948,1948,98155,47.735,122.31,1180,8189,66,0,3,2040,9049
5.5e+05,2014,306,4,1.75,2550,39460,1,0,0,3,8,1890,660,1982,1982,98072,47.771,122.12,2560,38638,32,0,5.75,5110,41188
2.6e+05,2014,285,4,2.5,2150,3721,2,0,0,3,8,2150,0,2006,2006,98002,47.336,122.22,2150,3721,8,0,6.5,4300,5871
7.65e+05,2015,473,3,2.5,2310,11993,2,0,0,3,9,2310,0,1988,1988,98006,47.544,122.14,2830,10031,27,0,5.5,5140,12341
3.25e+05,2015,467,4,1.75,1370,9993,1,0,0,3,6,1370,0,1918,1918,98028,47.757,122.23,1650,11592,97,0,5.75,3020,12962
7.81e+05,2015,424,3,2.5,1920,1896,3,0,3,3,8,1920,0,2000,2000,98103,47.662,122.36,1670,2994,15,0,5.5,3590,4914
7.25e+05,2014,340,4,2.5,2870,5118,2,0,0,3,9,2870,0,2006,2006,98029,47.554,121.99,2940,4800,8,0,6.5,5810,7670
6.2e+05,2014,340,4,2.5,2580,7465,2,0,0,3,8,2580,0,1993,1993,98074,47.632,122.02,2350,7596,21,0,6.5,4930,10176
7.85e+05,2014,197,4,2.75,2900,17400,1,0,0,4,8,2410,490,1978,1978,98052,47.643,122.11,2620,12240,36,0,6.75,5520,15140
3.1e+05,2014,175,2,1,870,5400,1,0,0,3,6,870,0,1950,2007,98126,47.52,122.37,990,5200,64,1,3,1860,6070
6.3785e+05,2014,321,5,3.25,3340,4900,2,0,2,3,9,2500,840,2014,2014,98065,47.519,121.88,3220,5200,0,0,8.25,6560,8540
2.57e+05,2015,390,3,1.75,1850,10920,1,0,0,3,6,1850,0,1915,1915,98034,47.724,122.22,1510,7871,100,0,4.75,3360,9721
1.28e+06,2015,453,4,3.25,3080,4120,2,0,0,3,9,2380,700,2014,2014,98117,47.684,122.36,1410,4120,1,0,7.25,4490,7200
1.39e+05,2015,414,4,1.5,1410,10648,1,0,0,4,7,1410,0,1966,1966,98030,47.374,122.19,1410,10522,49,0,5.5,2820,11932
7.2e+05,2015,462,3,2.5,2100,2200,2,0,0,4,7,1500,600,1919,1919,98122,47.614,122.29,1750,4400,96,0,5.5,3850,6500
2.85e+05,2014,244,3,1,1440,4268,1,0,0,3,7,1040,400,1953,1953,98108,47.547,122.29,1370,4268,61,0,4,2810,5708
3.49e+05,2015,367,2,1,1150,7552,1,0,0,3,7,1150,0,1951,1951,98125,47.721,122.32,1150,7346,64,0,3,2300,8496
3.35e+05,2014,352,3,2.75,1990,19991,1,0,0,3,7,1340,650,1977,1977,98072,47.743,122.11,1750,9775,37,0,5.75,3740,11765
1.135e+06,2014,243,4,2.5,3370,10602,2,0,0,3,10,3370,0,1999,1999,98007,47.659,122.15,2950,9949,15,0,6.5,6320,13319
8.1e+05,2014,167,3,2.5,2670,10481,2,0,0,3,9,2670,0,2003,2003,98033,47.667,122.18,2620,8895,11,0,5.5,5290,11565
2.45e+05,2014,181,3,2,1190,4072,1,0,0,5,6,1190,0,1907,1907,98118,47.528,122.27,1680,5850,107,0,5,2870,7040
3.145e+05,2014,127,3,1.75,1870,12381,1,0,0,4,8,1870,0,1957,1957,98003,47.336,122.32,1950,12667,57,0,4.75,3820,14537
3.33e+05,2015,446,4,2.5,2400,7270,2,0,0,3,8,2400,0,1993,1993,98003,47.27,122.31,2150,6584,22,0,6.5,4550,8984
2.73e+05,2014,239,3,2.25,1830,7651,2,0,0,3,8,1830,0,1986,1986,98092,47.264,122.22,2160,8442,28,0,5.25,3990,10272
3.2e+05,2014,162,2,1,1100,8281,1,0,0,4,7,1100,0,1947,1947,98155,47.741,122.31,1510,8281,67,0,3,2610,9381
4.1995e+05,2015,430,4,1,1530,7920,1,0,0,3,7,1030,500,1955,1955,98166,47.454,122.36,1690,7920,60,0,5,3220,9450
6.75e+05,2014,174,3,3.5,2300,5611,1,0,0,3,8,2300,0,2004,2004,98053,47.712,122.03,2170,5926,10,0,6.5,4470,8226
6.385e+05,2015,479,4,2.5,1980,6568,2,0,0,3,8,1980,0,2004,2004,98052,47.704,122.1,2310,6496,11,0,6.5,4290,8476
4.6e+05,2014,177,4,2.5,2110,35091,1,0,0,4,8,1290,820,1985,1985,98027,47.467,122.01,2740,36427,29,0,6.5,4850,38537
6.4e+05,2014,153,3,2.5,2370,11172,2,0,0,3,9,2370,0,1993,1993,98056,47.535,122.18,2550,11558,21,0,5.5,4920,13928
2.5595e+05,2014,175,3,2.5,1720,3676,2,0,0,3,7,1720,0,1992,1992,98031,47.404,122.19,1720,3510,22,0,5.5,3440,5230
5.25e+05,2014,214,4,2.5,2310,5573,2,0,0,4,9,2310,0,2003,2003,98056,47.52,122.2,2310,6189,11,0,6.5,4620,8499
5.5e+05,2014,173,3,2.5,1900,3255,2,0,0,3,8,1900,0,1988,2000,98007,47.608,122.15,1880,3350,26,1,5.5,3780,5250
7.5995e+05,2015,425,4,3.5,2100,7560,2,0,0,5,8,2100,0,2005,2005,98133,47.708,122.36,1250,7560,10,0,7.5,3350,9660
6.25e+05,2014,201,3,2,1730,12219,1,0,0,4,7,1730,0,1986,1986,98004,47.583,122.19,2470,13594,28,0,5,4200,15324
3.25e+05,2015,407,4,2.75,1960,8937,1,0,0,5,7,980,980,1954,1954,98188,47.451,122.28,1480,10016,61,0,6.75,3440,11976
8.25e+05,2014,166,4,1.5,1890,6938,1,0,0,3,8,1890,0,1919,1919,98116,47.59,122.39,1700,6250,95,0,5.5,3590,8140
4.01e+05,2015,438,3,2,1270,1333,3,0,0,3,8,1270,0,2006,2006,98103,47.693,122.34,1330,1333,9,0,5,2600,2603
7e+05,2015,447,3,1.75,2000,14733,1,0,0,4,8,2000,0,1958,1958,98005,47.6,122.18,2620,14733,57,0,4.75,4620,16733
5.3e+05,2014,297,3,2.5,1365,1090,3,0,0,3,7,1315,50,2003,2003,98115,47.678,122.32,1360,1124,11,0,5.5,2725,2489
4.1629e+05,2014,125,3,2.5,1408,989,3,0,0,3,8,1408,0,2005,2005,98115,47.686,122.31,1408,1342,9,0,5.5,2816,2750
1.011e+06,2015,451,3,2.5,1920,4480,2,0,1,3,9,1920,0,1949,1997,98119,47.647,122.37,1790,4500,66,1,5.5,3710,6420
2.14e+05,2014,266,3,2.5,1600,2231,2,0,0,3,7,1600,0,2003,2003,98001,47.331,122.29,1600,2962,11,0,5.5,3200,4562
6.35e+05,2014,346,4,2.5,2930,8679,2,0,0,3,8,2930,0,2014,2014,98056,47.516,122.19,2030,7264,0,0,6.5,4960,10194
4.95e+05,2015,486,4,2,1720,5413,2,0,0,3,7,1470,250,1938,1980,98115,47.693,122.32,1510,5413,77,1,6,3230,7133
3.6995e+05,2014,126,3,2,1270,1320,3,0,0,3,8,1270,0,2006,2006,98103,47.694,122.34,1370,1320,8,0,5,2640,2590
1.339e+06,2014,159,4,2.5,4250,19387,2,0,2,4,9,3260,990,1972,1972,98040,47.558,122.21,3690,17024,42,0,6.5,7940,21274
5.09e+05,2014,183,2,1.5,1930,3521,2,0,0,3,8,1930,0,1989,1989,98007,47.609,122.15,1840,3576,25,0,3.5,3770,5506
1.14e+05,2014,287,2,1,730,5200,1,0,0,3,6,730,0,1928,1928,98146,47.494,122.34,1220,6240,86,0,3,1950,6970
3.2e+05,2014,290,4,2.5,2223,5780,2,0,0,3,8,2223,0,2010,2010,98042,47.359,122.16,1690,7766,4,0,6.5,3913,9989
6.85e+05,2014,147,3,2.5,2810,7700,2,0,0,3,9,2810,0,2001,2001,98006,47.546,122.19,2910,8250,13,0,5.5,5720,11060
3.5e+05,2014,313,2,1,940,5000,1,0,0,3,7,940,0,1950,1950,98155,47.752,122.28,1800,7400,64,0,3,2740,8340
7.5e+05,2014,209,4,2.5,3080,4553,2,0,0,3,8,3080,0,2008,2008,98052,47.707,122.11,2750,4929,6,0,6.5,5830,8009
3.63e+05,2014,303,2,2,920,1201,2,0,0,3,8,800,120,2009,2009,98144,47.593,122.3,1150,1161,5,0,4,2070,2081
4.1e+05,2015,430,2,1,2020,7540,1,0,0,3,7,1010,1010,1921,1921,98118,47.536,122.28,1270,4652,94,0,3,3290,6672
3.6e+05,2014,269,4,2.25,2470,8686,1,0,0,4,7,1270,1200,1974,1974,98058,47.437,122.17,1900,7350,40,0,6.25,4370,9820
3.75e+05,2015,452,4,2,1790,61419,2,0,2,2,7,1790,0,1988,1988,98019,47.722,121.91,1790,62290,27,0,6,3580,64080
4.9e+05,2014,173,3,2.25,1470,2500,2,0,0,3,8,1080,390,1984,1984,98117,47.676,122.36,1640,4300,30,0,5.25,3110,5770
2.98e+05,2014,152,3,2.5,1950,3600,2,0,0,3,7,1950,0,2010,2010,98038,47.366,122.02,1870,4184,4,0,5.5,3820,6134
3.5e+05,2015,467,4,2.5,1660,2500,2,0,0,3,7,1660,0,2007,2007,98118,47.544,122.28,1030,5000,8,0,6.5,2690,6660
2.745e+05,2014,168,3,2.25,1720,9000,1,0,0,4,8,1320,400,1969,1969,98023,47.319,122.38,1930,8000,45,0,5.25,3650,9720
3.27e+05,2015,437,4,2.5,2110,3825,2,0,0,3,7,2110,0,2013,2013,98042,47.359,122.08,1950,3825,2,0,6.5,4060,5935
3.65e+05,2014,205,5,2,1600,4168,1,0,0,3,7,1600,0,1927,1927,98126,47.53,122.38,1190,4168,87,0,7,2790,5768
6e+05,2015,445,3,3,1520,1800,3,0,0,3,7,1520,0,2003,2003,98115,47.682,122.33,1520,1500,12,0,6,3040,3020
2.65e+05,2014,334,4,2.5,2040,4443,2,0,0,3,8,2040,0,2001,2001,98092,47.318,122.19,2040,4637,13,0,6.5,4080,6677
3.99e+05,2015,438,4,2.5,2100,7355,1,0,0,5,7,2100,0,1969,1969,98059,47.508,122.16,1750,7200,46,0,6.5,3850,9300
8.26e+05,2015,443,2,1,1060,6120,1,0,0,3,7,1060,0,1908,1908,98103,47.674,122.33,1730,4080,107,0,3,2790,5140
4.12e+05,2014,149,3,1.75,1950,52256,1,0,0,4,8,1950,0,1985,1985,98042,47.313,122.08,2450,51836,29,0,4.75,4400,53786
4.82e+05,2014,175,3,2.5,2420,7307,2,0,0,3,7,2420,0,1998,1998,98065,47.536,121.87,2420,5577,16,0,5.5,4840,7997
2.03e+05,2014,237,3,1.75,1490,8000,1,0,0,4,7,1200,290,1978,1978,98092,47.319,122.18,1540,8000,36,0,4.75,3030,9490
4.5e+05,2014,224,3,2.5,2450,19744,2,0,0,3,10,2450,0,1990,1990,98038,47.375,122.03,2650,19597,24,0,5.5,5100,22047
7.55e+05,2015,464,4,2.5,3010,9323,2,0,0,3,10,3010,0,1992,1992,98075,47.578,122.05,2840,8413,23,0,6.5,5850,11423
2.4e+05,2014,279,3,1.5,1450,9477,1,0,0,4,7,1450,0,1963,1963,98031,47.422,122.2,1460,9477,51,0,4.5,2910,10927
2.34e+05,2014,249,3,1,1010,8906,1,0,0,5,7,1010,0,1968,1968,98042,47.363,122.11,1150,10414,46,0,4,2160,11424
4.225e+05,2014,293,3,1.75,1560,7245,1,0,0,3,7,1560,0,1962,1985,98052,47.687,122.12,2220,8502,52,1,4.75,3780,10062
7.6995e+05,2014,298,3,2,2190,5400,1,0,2,5,7,1260,930,1952,1952,98107,47.674,122.4,2160,5400,62,0,5,4350,7590
2.9175e+05,2014,202,3,2.25,1310,12825,1,0,0,3,7,1310,0,1950,2013,98166,47.452,122.37,1600,11250,64,1,5.25,2910,12560
2.777e+05,2014,310,2,1.5,1240,1055,2,0,0,3,8,1200,40,1967,1967,98008,47.61,122.11,1410,1340,47,0,3.5,2650,2580
2.57e+05,2014,340,4,1.5,1400,8500,2,0,0,3,7,1400,0,1975,1975,98001,47.331,122.28,1580,7650,39,0,5.5,2980,9050
4.35e+05,2014,303,4,1.75,2290,4400,1,0,3,3,7,1290,1000,1959,1959,98126,47.57,122.38,1820,4000,55,0,5.75,4110,6290
5.302e+05,2015,362,4,2.5,1880,3853,2,0,0,3,8,1880,0,2010,2010,98027,47.564,122.09,1890,3078,5,0,6.5,3770,4958
99000,2015,365,2,1,960,8236,1,0,0,2,6,960,0,1948,1948,98058,47.47,122.17,1260,8236,67,0,3,2220,9196
5.8721e+05,2014,170,3,3.5,1890,1710,2,0,0,3,8,1640,250,1999,1999,98103,47.659,122.35,1680,1562,15,0,6.5,3570,3452
4.75e+05,2014,243,4,1,1420,6000,1,0,0,3,7,1420,0,1950,1950,98115,47.684,122.3,1420,6180,64,0,5,2840,7600
2.55e+05,2014,188,3,1.75,1550,9720,1,0,0,3,7,1050,500,1976,1976,98010,47.343,122.04,1550,9750,38,0,4.75,3100,11300
3.8e+05,2015,431,2,1,1040,7372,1,0,0,5,7,840,200,1939,1939,98126,47.529,122.38,1930,5150,76,0,3,2970,6190
7.9e+05,2014,359,4,1.75,2460,10061,1,1,4,3,7,1410,1050,1961,1961,98178,47.511,122.24,2300,10061,53,0,5.75,4760,12521
3.435e+05,2015,374,3,2,1660,7509,1,0,0,3,7,1660,0,2002,2002,98059,47.487,122.14,2380,8598,13,0,5,4040,10258
1.46e+06,2014,287,4,3.5,4200,14353,2,0,2,3,12,3640,560,1996,1996,98040,47.533,122.22,3750,16316,18,0,7.5,7950,20516
8.25e+05,2015,492,3,1.75,2010,3090,1,0,0,5,7,1510,500,1926,1926,98103,47.682,122.35,1600,3150,89,0,4.75,3610,5160
1.75e+05,2014,134,2,1,1170,8925,1,0,2,3,6,1170,0,1911,1911,98198,47.402,122.32,1380,7440,103,0,3,2550,8610
4e+05,2014,310,3,1,1130,4100,1,0,0,3,7,990,140,1941,1941,98117,47.686,122.39,1800,4100,73,0,4,2930,5230
7.35e+05,2014,173,4,2.25,2270,5102,1,0,0,5,8,1340,930,1954,1954,98199,47.653,122.41,1800,5102,60,0,6.25,4070,7372
9.65e+05,2014,332,4,2.5,4070,57587,2,0,0,3,10,4070,0,1989,1989,98052,47.691,122.05,3890,35960,25,0,6.5,7960,40030
3.9583e+05,2014,223,2,2.5,1590,1679,2,0,0,3,8,1590,0,2012,2012,98029,47.545,122.01,1590,1680,2,0,4.5,3180,3270
7.99e+05,2014,252,3,2.5,2140,9897,1,0,0,4,8,2140,0,1959,1959,98040,47.55,122.22,2680,10083,55,0,5.5,4820,12223
5e+05,2015,488,3,1,2000,21780,1,0,0,3,8,1480,520,1978,1978,98074,47.606,122.04,2000,45738,37,0,4,4000,47738
4.85e+05,2014,349,4,2,1400,3600,1,0,0,3,7,1100,300,1900,1900,98119,47.639,122.37,1630,2048,114,0,6,3030,3448
7.7e+05,2014,203,5,2.75,3010,5398,2,0,0,3,9,3010,0,2014,2014,98074,47.607,122.05,3360,5407,0,0,7.75,6370,8417
3.53e+05,2015,400,3,2.5,2510,9240,2,0,0,4,8,2510,0,2001,2001,98022,47.19,122.01,2690,9240,14,0,5.5,5200,11750
1.95e+05,2015,415,2,2,1180,2553,2,0,0,3,6,1180,0,2005,2005,98038,47.35,122.02,1310,2687,10,0,4,2490,3867
6.5e+05,2014,194,4,1.75,2010,5070,1,0,1,4,7,1300,710,1963,1963,98116,47.579,122.4,2180,5400,51,0,5.75,4190,7410
6.6e+05,2014,335,3,1.75,2030,9032,2,0,2,4,7,2030,0,1963,1963,98008,47.586,122.12,2350,8937,51,0,4.75,4380,10967
4.95e+05,2014,301,4,2.5,2460,4862,2,0,0,3,8,2460,0,2004,2004,98028,47.772,122.23,2900,4895,10,0,6.5,5360,7355
4.76e+05,2014,181,4,3,2890,6885,1,0,0,3,7,1590,1300,1945,2015,98115,47.676,122.28,2180,6885,69,1,7,5070,9775
3.57e+05,2014,341,3,1.5,1340,11744,1,0,0,2,7,1340,0,1950,1950,98146,47.495,122.36,2020,13673,64,0,4.5,3360,15013
3.528e+05,2014,266,4,2.25,1800,2752,2,0,0,3,8,1800,0,2014,2014,98106,47.517,122.35,1650,2752,0,0,6.25,3450,4552
3.03e+05,2014,229,4,2.5,2100,6783,2,0,0,3,8,2100,0,2003,2003,98042,47.35,122.14,2100,6192,11,0,6.5,4200,8292
4.435e+05,2014,214,2,1,1330,4140,1,0,0,4,7,930,400,1919,1940,98115,47.68,122.31,1410,5100,95,1,3,2740,6430
3.35e+05,2014,279,4,1.75,2000,10890,1,0,0,4,7,1390,610,1961,1961,98003,47.32,122.32,1520,9250,53,0,5.75,3520,11250
3.1e+05,2014,236,3,2.5,2370,6752,2,0,0,3,8,2370,0,1994,1994,98003,47.27,122.31,1870,7455,20,0,5.5,4240,9825
3.5e+05,2015,394,4,2.75,2500,11659,1,0,2,3,9,1490,1010,1979,1979,98003,47.338,122.33,2830,9915,36,0,6.75,5330,12415
5.9995e+05,2014,257,2,1,1150,3775,1,0,0,3,7,1150,0,1917,1917,98103,47.654,122.33,2240,3753,97,0,3,3390,4903
3.2e+05,2015,467,4,2.25,2000,10374,2,0,1,4,7,2000,0,1967,1967,98023,47.334,122.34,2170,10374,48,0,6.25,4170,12374
7e+05,2015,474,4,2,1930,5398,1,0,0,3,7,1430,500,1953,1953,98119,47.646,122.36,1910,4902,62,0,6,3840,6832
5.18e+05,2015,474,3,1,1270,6612,1,0,3,3,7,1270,0,1927,1927,98118,47.543,122.26,2100,7680,88,0,4,3370,8950
2.45e+05,2014,133,5,1.75,2020,7902,1,0,0,3,7,1220,800,1962,1962,98168,47.51,122.33,2220,8819,52,0,6.75,4240,10839
2.1e+05,2014,194,3,1,920,6612,1,0,0,3,6,920,0,1948,1948,98118,47.548,122.28,1860,8424,66,0,4,2780,9344
2.8215e+05,2014,262,2,1,700,5940,1,0,0,3,7,700,0,1948,1948,98133,47.729,122.34,1070,5995,66,0,3,1770,6695
7.65e+05,2014,273,4,2.5,2660,5043,2,0,2,3,9,2660,0,2003,2003,98029,47.544,122,3010,5500,11,0,6.5,5670,8160
2.45e+05,2014,349,4,1.75,1930,7650,1,0,0,4,8,1280,650,1981,1981,98023,47.308,122.39,1860,8800,33,0,5.75,3790,10730
3.74e+05,2014,245,2,2.25,1100,1695,2,0,0,3,9,1100,0,2009,2009,98118,47.566,122.29,1100,3082,5,0,4.25,2200,4182
4.6e+05,2014,245,3,1,1860,6360,1,0,0,3,8,1470,390,1954,1954,98136,47.533,122.39,1770,6175,60,0,4,3630,8035
9.75e+05,2014,195,3,2.5,3050,7410,1,0,0,5,8,1950,1100,1950,1950,98115,47.677,122.3,1890,5814,64,0,5.5,4940,8864
2.4462e+05,2014,148,3,2.5,2060,4030,2,0,0,3,7,2060,0,1999,1999,98032,47.391,122.24,2060,4029,15,0,5.5,4120,6089
6.25e+05,2014,237,3,2.5,2330,3141,2,0,0,3,8,2330,0,2003,2003,98116,47.562,122.39,1980,5265,11,0,5.5,4310,7595
5.6e+05,2015,456,3,1.75,2340,12443,1,0,0,4,8,2340,0,1965,1965,98006,47.543,122.18,1970,9600,50,0,4.75,4310,11940
7.65e+05,2014,154,4,3,4410,5104,2,0,0,3,9,3400,1010,2006,2006,98065,47.539,121.86,4390,5537,8,0,7,8800,9947
3.45e+05,2014,212,2,1,860,8250,1,0,0,3,7,860,0,1940,1940,98133,47.713,122.33,1780,11200,74,0,3,2640,12060
6.05e+05,2015,413,3,2.5,3200,35012,1,0,0,3,8,2100,1100,1965,1965,98027,47.465,121.99,2690,35100,50,0,5.5,5890,38300
6.075e+05,2015,403,4,2.5,2460,45738,1,0,0,4,8,1650,810,1969,1969,98075,47.595,122.06,2550,32040,46,0,6.5,5010,34500
1.1e+06,2015,433,5,2.75,2520,4643,1,0,0,4,8,2120,400,1916,1916,98112,47.635,122.3,2100,4564,99,0,7.75,4620,7084
4.48e+05,2014,170,4,2.5,2510,6853,2,0,2,3,9,2510,0,2006,2006,98038,47.355,122,3400,6965,8,0,6.5,5910,9475
7.25e+05,2014,313,5,2.5,3780,20000,1,0,1,4,9,1890,1890,1978,1978,98155,47.76,122.27,2840,19908,36,0,7.5,6620,23688
6.15e+05,2014,163,3,1.75,2350,20820,1,0,0,4,8,1800,550,1978,1978,98074,47.609,122.06,2040,10800,36,0,4.75,4390,13150
3.81e+05,2014,280,3,1.75,2700,18246,1,0,0,4,7,1510,1190,1967,1967,98059,47.482,122.1,1620,16986,47,0,4.75,4320,19686
6e+05,2015,486,2,1.75,1180,5000,1,0,0,2,7,880,300,1925,1925,98107,47.675,122.4,1470,5000,90,0,3.75,2650,6180
7.45e+05,2014,194,3,2.75,3010,12432,1,0,0,4,8,1890,1120,1970,1970,98052,47.639,122.11,2500,12432,44,0,5.75,5510,15442
3.35e+05,2014,215,3,2.5,1650,13816,2,0,0,3,7,1650,0,1998,1998,98014,47.655,121.91,1630,18750,16,0,5.5,3280,20400
3.96e+05,2015,415,4,1,1040,4420,1,0,0,3,6,1040,0,1944,1944,98117,47.694,122.37,1310,4920,71,0,5,2350,5960
3.95e+05,2015,432,3,1.75,1400,8640,1,0,0,3,7,1400,0,1962,1962,98011,47.766,122.2,1630,8640,53,0,4.75,3030,10040
6.75e+05,2015,407,4,1.75,2440,7475,1,0,0,4,9,2040,400,1969,1969,98052,47.634,122.1,2040,8480,46,0,5.75,4480,10920
3.0995e+05,2014,125,4,2.75,2310,5000,2,0,0,3,7,2310,0,2006,2006,98038,47.361,122.03,1980,5000,8,0,6.75,4290,7310
4.94e+05,2014,187,2,1,1290,4650,1,0,0,4,7,1290,0,1906,1906,98115,47.688,122.33,1640,3900,108,0,3,2930,5190
4.8999e+05,2014,128,5,2.25,2440,20828,1,0,0,4,8,2440,0,1975,1975,98042,47.376,122.16,2670,14472,39,0,7.25,5110,16912
5.25e+05,2014,258,2,2.75,1310,1268,3,0,0,3,8,1310,0,2007,2007,98103,47.653,122.36,1350,1288,7,0,4.75,2660,2598
3.95e+05,2014,186,3,1.75,1480,7700,1,0,0,3,8,1480,0,1975,1975,98034,47.722,122.2,1930,8560,39,0,4.75,3410,10040
3.5e+05,2014,221,3,1.5,1320,4400,1,0,0,3,6,1320,0,1909,1909,98112,47.623,122.29,1350,4400,105,0,4.5,2670,5720
5.525e+05,2014,215,5,3,2320,7229,1,0,0,4,8,1370,950,1986,1986,98052,47.697,122.1,2090,7554,28,0,8,4410,9874
4.99e+05,2014,266,3,2.5,1750,2150,2,0,0,3,7,1230,520,1900,2014,98122,47.604,122.31,1410,3300,114,1,5.5,3160,5050
3e+05,2014,173,4,2.5,2620,4469,2,0,0,3,7,2620,0,2008,2008,98042,47.366,122.11,2250,4500,6,0,6.5,4870,7120
8.21e+05,2014,187,3,2.75,2760,8476,1,0,0,4,8,1690,1070,1967,1967,98040,47.54,122.22,2610,9835,47,0,5.75,5370,12595
3.673e+05,2014,159,4,2.75,2190,14937,2,0,0,3,8,2190,0,1993,1993,98001,47.353,122.27,1920,11360,21,0,6.75,4110,13550
8e+05,2015,486,5,2.5,3000,10560,1,0,0,3,8,1500,1500,1966,1966,98004,47.625,122.21,2690,11616,49,0,7.5,5690,14616
4.3e+05,2014,255,5,3,3880,8432,2,0,0,3,7,3880,0,2004,2004,98056,47.481,122.18,2620,5623,10,0,8,6500,9503
4.79e+05,2014,320,2,2.25,1330,1380,2,0,0,3,8,1060,270,2005,2005,98116,47.577,122.41,1580,4802,9,0,4.25,2910,6132
6.18e+05,2014,251,3,2.5,2340,3630,2,0,0,3,9,2340,0,1998,1998,98122,47.606,122.31,1820,5120,16,0,5.5,4160,7460
5.55e+05,2014,297,3,2,1980,3478,1,0,0,4,7,1440,540,1929,1929,98117,47.678,122.37,1610,3478,85,0,5,3590,5458
2.06e+05,2014,191,3,1.75,1140,9800,1,0,0,4,7,1140,0,1968,1968,98001,47.306,122.27,1370,9800,46,0,4.75,2510,10940
4.5e+05,2014,256,3,1.75,1830,5488,1,0,2,4,7,1010,820,1939,1939,98115,47.691,122.31,1200,5488,75,0,4.75,3030,7318
4.89e+05,2014,317,3,1.75,2090,7667,1,0,2,3,7,1200,890,1952,1952,98115,47.701,122.31,1480,7666,62,0,4.75,3570,9756
1.15e+06,2015,367,3,2.5,2100,15120,1,0,0,4,8,2100,0,1953,1953,98004,47.62,122.22,3070,16078,62,0,5.5,5170,18178
6.77e+05,2015,450,4,2,2180,6000,1,0,0,3,8,2060,120,1927,1927,98144,47.596,122.31,1370,4500,88,0,6,3550,6680
5.925e+05,2014,135,4,2.5,2240,12032,1,0,0,3,9,2240,0,1983,1983,98074,47.614,122.02,2520,12368,31,0,6.5,4760,14608
5.9995e+05,2015,375,6,3,2020,4129,1,0,0,3,7,1230,790,1994,1994,98105,47.665,122.32,2080,4080,21,0,9,4100,6100
8.185e+05,2014,249,5,3.5,4790,12957,2,0,1,3,9,3110,1680,2005,2005,98006,47.547,122.19,2620,13538,9,0,8.5,7410,18328
1.675e+06,2014,249,4,4.75,4790,25412,2,0,0,3,12,4790,0,1999,1999,98074,47.603,122.01,3830,16314,15,0,8.75,8620,21104
1.75e+05,2015,437,2,1,620,6600,1,0,0,3,6,620,0,1963,1963,98168,47.486,122.33,1050,6600,52,0,3,1670,7220
5.55e+05,2014,142,4,2.25,2350,8140,1,0,0,4,8,1430,920,1977,1977,98006,47.558,122.13,2640,8700,37,0,6.25,4990,11050
2.25e+05,2014,224,3,1,1120,10665,1,0,0,4,6,1120,0,1961,1961,98001,47.289,122.27,1240,10639,53,0,4,2360,11759
1.03e+06,2014,262,5,2.5,3050,8200,1,0,4,4,8,1650,1400,1962,1962,98006,47.565,122.16,2970,8792,52,0,7.5,6020,11842
4.9e+05,2014,177,3,2.5,2230,5348,2,0,0,3,8,2230,0,2000,2000,98065,47.535,121.87,2190,5205,14,0,5.5,4420,7435
6.1e+05,2015,433,4,2.25,2240,45738,2,0,0,3,7,2240,0,1988,1988,98053,47.687,122.05,3180,45738,27,0,6.25,5420,47978
1.07e+06,2014,305,3,1.75,2320,6090,2,0,3,3,8,2040,280,1939,1939,98199,47.643,122.41,3110,7052,75,0,4.75,5430,9372
2.15e+05,2015,472,3,1,880,7648,1,0,2,4,6,880,0,1940,1940,98022,47.196,122,1020,7566,75,0,4,1900,8446
2.41e+05,2015,394,3,1,880,6050,1,0,0,3,6,880,0,1945,1945,98178,47.499,122.25,1130,6050,70,0,4,2010,6930
2.6e+05,2015,399,4,1.75,1810,7480,1,0,0,3,7,1230,580,1977,1977,98023,47.328,122.36,1870,9594,38,0,5.75,3680,11404
1.6695e+05,2014,305,3,1,1190,8820,1,0,0,3,6,1190,0,1959,1959,98058,47.462,122.18,1230,7980,55,0,4,2420,9170
5.25e+05,2014,170,3,2.25,1750,1879,3,0,0,3,8,1750,0,2001,2001,98107,47.672,122.39,1750,3155,13,0,5.25,3500,4905
5.85e+05,2015,423,2,2,1370,7920,1,0,0,3,8,950,420,1949,1949,98199,47.659,122.4,1370,4680,66,0,4,2740,6050
3.3e+05,2014,280,3,1,1160,9600,1,0,0,4,7,1160,0,1967,1967,98077,47.742,122.07,1160,9730,47,0,4,2320,10890
4.65e+05,2014,300,3,1,1580,3774,1,0,0,3,6,1580,0,1900,1900,98117,47.684,122.36,1580,3860,114,0,4,3160,5440
3.44e+05,2014,135,3,2.5,1232,1130,3,0,0,3,7,1232,0,2007,2007,98125,47.718,122.32,1232,1202,7,0,5.5,2464,2434
3.8e+05,2014,127,5,1.75,3000,6000,1,0,0,5,7,1500,1500,1958,1958,98178,47.492,122.22,2230,7125,56,0,6.75,5230,10125
1.23e+06,2014,263,5,4,4390,6656,2,0,0,3,9,2930,1460,2008,2008,98199,47.648,122.4,1560,6656,6,0,9,5950,11046
2.075e+06,2014,173,4,3.5,4230,20377,2,0,0,3,11,4230,0,1997,1997,98004,47.595,122.21,3980,20489,17,0,7.5,8210,24719
3.4e+05,2015,423,5,1,1880,3774,1,0,0,3,6,1360,520,1917,1917,98126,47.566,122.37,1420,2550,98,0,6,3300,4430
5.52e+05,2014,299,3,2.5,1280,1920,3,0,0,3,8,1280,0,2009,2009,98105,47.662,122.32,1450,1900,5,0,5.5,2730,3180
3.63e+05,2014,354,3,2,1750,7000,1,0,0,3,8,1750,0,1993,1993,98038,47.369,122.04,1840,6969,21,0,5,3590,8719
8.071e+05,2015,444,4,2.5,2680,4499,2,0,0,3,9,2680,0,1999,1999,98006,47.565,122.13,2920,4500,16,0,6.5,5600,7180
3.85e+05,2014,150,3,1,1220,4800,1,0,0,3,6,1220,0,1901,1901,98122,47.61,122.31,1200,4800,113,0,4,2420,6020
3.975e+05,2014,191,3,2.5,1470,1256,2,0,0,3,8,930,540,2006,2006,98122,47.603,122.31,1510,1797,8,0,5.5,2980,3267
3.6e+05,2014,294,2,1,840,7414,1,0,0,4,6,840,0,1928,1928,98033,47.677,122.17,1740,9784,86,0,3,2580,10624
3.53e+05,2014,345,4,2.5,1830,5331,2,0,0,3,7,1830,0,2002,2002,98038,47.356,122.02,1830,5175,12,0,6.5,3660,7005
3.7495e+05,2014,229,3,2.5,2120,9653,2,0,0,3,8,2120,0,1992,1992,98030,47.384,122.21,1780,9801,22,0,5.5,3900,11921
9.8e+05,2014,143,4,3,3680,5854,1,0,3,3,10,2060,1620,1967,1967,98199,47.633,122.39,3140,5000,47,0,7,6820,8680
5.65e+05,2014,172,2,1.75,1330,6000,1,0,0,4,7,960,370,1914,1945,98199,47.654,122.4,1620,6000,100,1,3.75,2950,7330
8.6e+05,2015,457,4,3.5,3950,9600,2,0,0,3,10,3950,0,1998,1998,98075,47.594,121.98,3110,10213,17,0,7.5,7060,14163
2.65e+05,2014,354,3,2.25,1510,6071,1,0,0,4,7,1150,360,1985,1985,98042,47.362,122.08,1510,7271,29,0,5.25,3020,8781
4.45e+05,2014,205,3,2,1620,5101,1,0,0,3,7,590,1030,2006,2006,98118,47.545,122.29,1700,7750,8,0,5,3320,9370
2.22e+05,2015,480,3,1,990,8840,1,0,0,3,6,990,0,1966,1966,98023,47.307,122.37,1120,8625,49,0,4,2110,9615
2.87e+05,2014,347,3,2.25,2300,7200,1,0,0,4,8,1550,750,1978,1978,98003,47.324,122.33,2000,7350,36,0,5.25,4300,9650
4.24e+05,2014,176,4,2,2100,4857,2,0,0,3,8,2100,0,1965,1984,98155,47.752,122.28,1450,5965,49,1,6,3550,8065
3.6e+05,2014,208,4,2.5,2210,17715,2,0,0,3,8,2210,0,1997,1997,98030,47.382,122.2,2210,16907,17,0,6.5,4420,19117
3.03e+05,2014,248,2,1,1100,27007,1,0,0,4,6,1100,0,1943,1943,98070,47.447,122.47,1746,91476,71,0,3,2846,92576
2.85e+05,2014,298,4,3.5,2770,10505,2,0,0,3,8,2770,0,1940,2015,98133,47.741,122.36,1760,10505,74,1,7.5,4530,13275
5.8e+05,2015,472,5,2.5,2500,11900,1,0,0,3,7,1400,1100,1963,1963,98007,47.592,122.13,2820,11900,52,0,7.5,5320,14400
3.85e+05,2015,423,3,1.75,1930,14389,1,0,0,3,7,1130,800,1963,1998,98155,47.773,122.32,1730,14378,52,1,4.75,3660,16308
2.25e+05,2014,339,3,1.5,1310,10491,1,0,0,4,7,1310,0,1969,1969,98042,47.368,122.15,1430,9664,45,0,4.5,2740,10974
4.5e+05,2015,450,3,2.75,2840,39324,1,0,0,3,9,2200,640,1988,1988,98092,47.308,122.1,2840,39413,27,0,5.75,5680,42253
3.2e+05,2015,474,4,1.5,2020,8474,1,0,0,5,7,1010,1010,1962,1962,98058,47.458,122.17,1720,8166,53,0,5.5,3740,10186
6.5e+05,2014,305,3,2,1870,3388,1,0,0,4,8,1230,640,1925,1925,98199,47.637,122.39,1780,4050,89,0,5,3650,5920
5.6e+05,2014,230,4,2.75,2930,22000,1,0,3,4,9,1580,1350,1978,1978,98023,47.323,122.38,2930,9758,36,0,6.75,5860,12688
7.7101e+05,2015,485,5,4.5,4000,6713,2,0,0,3,9,4000,0,2015,2015,98024,47.525,121.89,3690,6600,0,0,9.5,7690,10600
4.9245e+05,2014,211,3,1.75,1540,13002,1,0,0,2,8,1200,340,1984,1984,98074,47.623,122.04,1620,10098,30,0,4.75,3160,11638
1.9e+05,2015,453,4,2,1580,6250,1,0,0,3,7,860,720,1977,1977,98155,47.766,122.31,1580,6250,38,0,6,3160,7830
2.4215e+05,2015,493,4,1.75,1490,8544,1,0,0,4,7,1490,0,1970,1970,98031,47.389,122.17,1180,8372,45,0,5.75,2670,9862
1.68e+05,2014,209,3,1,1200,7210,1,0,0,4,6,1200,0,1977,1977,98030,47.373,122.18,1200,7650,37,0,4,2400,8850
2.25e+05,2014,324,3,1,960,6500,1,0,0,4,5,960,0,1954,1954,98056,47.497,122.17,1150,6500,60,0,4,2110,7460
7.15e+05,2015,438,3,2.25,1990,4977,3,0,0,3,9,1990,0,2012,2012,98118,47.54,122.27,1280,5000,3,0,5.25,3270,6990
2.1845e+05,2014,198,2,1,840,7425,1,0,0,4,6,840,0,1952,1952,98166,47.475,122.34,1300,11674,62,0,3,2140,12514
6.15e+05,2014,168,5,2.25,2480,12070,2,0,0,3,9,2480,0,1978,1978,98074,47.631,122.05,2570,12000,36,0,7.25,5050,14480
4.85e+05,2015,425,3,2.5,1760,3097,2,0,0,3,8,1760,0,1992,1992,98029,47.576,122,1760,3285,23,0,5.5,3520,5045
5.336e+05,2014,265,3,2.5,1930,5080,2,0,0,4,8,1930,0,1990,1990,98029,47.569,122,2190,5085,24,0,5.5,4120,7015
3.25e+05,2014,234,4,2.5,1820,9161,1,0,0,4,7,1220,600,1975,1975,98058,47.433,122.17,1860,7650,39,0,6.5,3680,9470
3.25e+05,2014,258,3,2.25,2220,16020,1,0,0,4,8,1780,440,1966,1966,98030,47.376,122.22,2080,9583,48,0,5.25,4300,11803
6.6e+05,2014,151,4,1.75,2780,9900,2,0,0,4,10,2780,0,1978,1978,98074,47.635,122.06,2600,12000,36,0,5.75,5380,14780
4.8995e+05,2014,252,3,2.5,2400,7478,2,0,0,3,9,2400,0,2002,2002,98019,47.736,121.97,2980,8182,12,0,5.5,5380,10582
2.59e+05,2014,140,3,1,1320,8625,1,0,0,4,7,1320,0,1957,1957,98056,47.49,122.18,1370,8295,57,0,4,2690,9615
4.2e+05,2015,431,2,1,1000,5375,1,0,0,3,7,1000,0,1953,1953,98118,47.54,122.27,1380,5000,62,0,3,2380,6000
5.1e+05,2014,187,3,2.5,1420,1237,3,0,0,3,8,1420,0,2014,2014,98107,47.674,122.39,1510,2501,0,0,5.5,2930,3921
2.6e+05,2014,211,2,1,820,6771,1,0,0,4,6,820,0,1918,1918,98106,47.52,122.35,1000,4440,96,0,3,1820,5260
7.9e+05,2015,447,3,2.75,2460,3600,2,0,0,3,9,2460,0,2007,2007,98029,47.541,121.99,2570,3600,8,0,5.75,5030,6060
2.23e+05,2014,211,3,2,1310,8440,1,0,0,5,6,1310,0,1951,1951,98178,47.5,122.27,1790,10775,63,0,5,3100,12085
2.93e+05,2014,255,3,2.5,1690,17383,2,0,0,3,7,1690,0,2003,2003,98038,47.369,122.03,2610,7999,11,0,5.5,4300,9689
4.35e+05,2014,211,3,2.25,1740,8491,1,0,0,3,8,1240,500,1958,1958,98177,47.776,122.38,2080,8494,56,0,5.25,3820,10234
1.436e+06,2015,450,4,3.5,4970,16582,2,0,3,4,11,3930,1040,1992,1992,98006,47.55,122.12,3580,13335,23,0,7.5,8550,18305
3.33e+05,2015,466,4,2.5,2100,7208,2,0,0,3,8,2100,0,1974,1974,98058,47.448,122.13,2060,7480,41,0,6.5,4160,9580
2.4995e+05,2014,142,2,1,940,8532,1,0,0,4,7,940,0,1959,1959,98166,47.481,122.34,1050,8100,55,0,3,1990,9040
6.35e+05,2014,229,3,3,2230,1407,2,0,0,3,8,1850,380,2013,2013,98027,47.545,122.02,2290,1407,1,0,6,4520,3637
3.75e+05,2014,321,3,2.25,2120,18500,2,0,0,4,8,2120,0,1983,1983,98031,47.391,122.17,2120,14479,31,0,5.25,4240,16599
2.7795e+05,2014,190,4,2.5,1889,6000,2,0,0,3,7,1889,0,2012,2012,98001,47.268,122.26,1990,6350,2,0,6.5,3879,8239
3.995e+05,2014,188,4,1.75,1360,4840,1,0,0,4,7,1360,0,1928,1928,98126,47.556,122.38,1320,4840,86,0,5.75,2680,6200
8.28e+05,2014,228,4,2.5,3520,9901,2,0,0,3,10,3520,0,1998,1998,98074,47.608,122.01,3490,9667,16,0,6.5,7010,13187
8.5e+05,2015,414,2,1.5,1800,4144,1,0,4,4,7,900,900,1962,1962,98116,47.593,122.39,2090,4173,53,0,3.5,3890,5973
1.945e+06,2014,360,4,4,4690,6900,2,0,0,3,11,3480,1210,2001,2001,98004,47.617,122.22,2800,11240,13,0,8,7490,15930
7.855e+05,2014,283,4,4,3280,8448,2,0,0,3,10,3280,0,2007,2007,98075,47.582,121.97,3730,8030,7,0,8,7010,11310
4.45e+05,2014,136,3,3,1970,24318,1,0,0,3,8,1970,0,2010,2010,98028,47.765,122.25,2150,14695,4,0,6,4120,16665
7e+05,2014,141,4,2.5,3010,46173,2,0,0,3,9,3010,0,1996,1996,98053,47.647,121.96,2590,49222,18,0,6.5,5600,52232
1.161e+06,2014,292,4,2.5,2960,26742,1,0,3,3,8,1480,1480,1949,1996,98115,47.685,122.27,2500,9460,65,1,6.5,5460,12420
2.6e+05,2015,464,2,1,1550,15250,1,0,0,5,7,1550,0,1920,1920,98038,47.407,122.05,1520,34929,95,0,3,3070,36479
2.67e+05,2015,493,3,2.25,2510,9900,1,0,0,3,8,1610,900,1978,1978,98023,47.299,122.37,1940,8510,37,0,5.25,4450,11020
3.9e+05,2014,126,5,3.75,2890,5000,1,0,0,3,7,1310,1580,2006,2006,98108,47.57,122.3,1930,5117,8,0,8.75,4820,8007
7.72e+05,2014,140,3,2.25,1640,1204,3,0,0,3,8,1640,0,2014,2014,98112,47.62,122.3,1630,3136,0,0,5.25,3270,4776
2.35e+05,2014,159,3,1,1330,8912,1,0,0,3,6,1330,0,1948,1948,98188,47.449,122.27,1200,8913,66,0,4,2530,10243
4.15e+05,2014,133,3,1.75,1960,5000,1,0,0,5,6,980,980,1911,1911,98108,47.558,122.32,1790,5000,103,0,4.75,3750,6960
1.15e+06,2015,393,5,4.25,4010,8252,2,0,0,3,10,4010,0,2015,2015,98075,47.597,122.01,3370,8252,0,0,9.25,7380,12262
6.49e+05,2014,347,4,2.5,2730,4847,2,0,0,3,9,2730,0,2008,2008,98126,47.549,122.37,1250,4840,6,0,6.5,3980,7570
4.8e+05,2014,236,4,2.25,2520,2370,2,0,0,3,8,1690,830,1908,1908,98122,47.611,122.3,1530,2370,106,0,6.25,4050,4890
6.89e+05,2014,342,4,3.5,4490,5805,2,0,0,3,9,3390,1100,2006,2006,98065,47.539,121.86,4410,6299,8,0,7.5,8900,10789
4.05e+05,2014,348,2,0.75,1160,15029,1,0,0,4,6,870,290,1937,1937,98014,47.693,121.87,1870,25346,77,0,2.75,3030,26506
7.6725e+05,2014,291,4,3,2170,2500,2,0,0,3,8,1710,460,1997,1997,98115,47.674,122.3,2170,4080,17,0,7,4340,6250
4.78e+05,2014,223,3,1.75,2790,36585,1,0,0,4,8,1410,1380,1970,1970,98027,47.473,122,1900,45302,44,0,4.75,4690,48092
5.35e+05,2014,147,2,1,1040,5527,1,0,0,3,7,1040,0,1951,1951,98115,47.677,122.28,2080,7020,63,0,3,3120,8060
5.7e+05,2014,187,3,1,1890,3330,1,0,0,4,7,1390,500,1901,1901,98103,47.66,122.35,1530,3330,113,0,4,3420,5220
4e+05,2014,333,5,2.75,2470,19200,1,0,0,5,8,1250,1220,1977,1977,98058,47.45,122.08,2140,35140,37,0,7.75,4610,37610
3.58e+05,2014,194,3,1,940,6695,1,0,0,4,6,940,0,1959,1959,98008,47.62,122.12,1230,7400,55,0,4,2170,8340
6.395e+05,2014,171,4,2.25,2330,8994,2,0,0,3,8,2330,0,1986,1986,98052,47.726,122.1,2330,8396,28,0,6.25,4660,10726
7.5e+05,2014,166,4,3.25,3430,9870,2,0,0,3,9,3430,0,2014,2014,98011,47.776,122.17,3360,9724,0,0,7.25,6790,13154
8.75e+05,2014,250,4,1,1670,4600,1,0,0,5,8,1670,0,1906,1906,98103,47.684,122.33,1820,4600,108,0,5,3490,6270
2.79e+05,2014,266,2,1,1020,47044,1,0,0,5,7,1020,0,1904,1958,98042,47.421,122.16,1930,12139,110,1,3,2950,13159
7.6e+05,2014,224,4,3,2840,13554,1,0,2,4,9,1990,850,1974,1974,98034,47.715,122.26,2840,16940,40,0,7,5680,19780
4.6e+05,2015,466,3,2,2930,29136,2,0,0,3,8,2240,690,1990,1990,98010,47.31,122.04,2110,29362,25,0,5,5040,32292
3.16e+05,2014,152,3,2.25,2130,8721,1,0,0,3,8,1570,560,1987,1987,98031,47.42,122.2,2130,9477,27,0,5.25,4260,11607
2.535e+05,2014,221,3,1,1220,20400,1,0,0,5,6,1220,0,1959,1959,98022,47.206,122.02,1640,53578,55,0,4,2860,54798
7.72e+05,2014,136,4,2.5,2110,3750,2,0,0,3,8,2110,0,2000,2000,98117,47.679,122.36,1700,5000,14,0,6.5,3810,7110
4e+05,2014,317,4,3,2240,7035,2,0,0,3,7,2240,0,1942,1993,98146,47.512,122.37,1060,6300,72,1,7,3300,8540
5.53e+05,2015,451,3,1,1380,6250,1,0,0,4,7,1380,0,1918,1918,98136,47.551,122.39,2270,6250,97,0,4,3650,7630
1.56e+05,2014,132,3,1,970,8580,1,0,0,3,7,970,0,1959,1959,98003,47.336,122.31,1430,11907,55,0,4,2400,12877
2.25e+05,2014,139,2,1,910,9612,1,0,0,4,7,910,0,1981,1981,98058,47.43,122.15,1410,9611,33,0,3,2320,10521
2.805e+05,2014,297,3,1.75,2440,10179,1,0,0,4,7,1220,1220,1962,1962,98198,47.412,122.31,1650,9711,52,0,4.75,4090,12151
6.99e+05,2014,339,4,2.5,2440,14470,1,0,0,4,9,1660,780,1970,1970,98005,47.64,122.17,2810,15564,44,0,6.5,5250,18004
2.8e+05,2014,280,3,1,1100,5132,1,0,0,3,6,840,260,1948,1948,98103,47.701,122.34,1280,5132,66,0,4,2380,6232
5.5e+05,2014,333,3,2.25,1540,1005,3,0,0,3,8,1540,0,2008,2008,98103,47.683,122.35,1510,1501,6,0,5.25,3050,3041
2e+05,2015,417,3,2,1010,7896,1,0,0,3,7,1010,0,1984,1984,98031,47.405,122.18,1540,7896,31,0,5,2550,8906
3.8995e+05,2015,437,3,2.5,2170,8140,2,0,0,3,9,2170,0,1994,1994,98030,47.385,122.17,2390,8100,21,0,5.5,4560,10270
3.3e+05,2014,214,3,1,1030,7620,1,0,0,3,7,1030,0,1953,1953,98126,47.528,122.38,1030,7560,61,0,4,2060,8590
4.65e+05,2015,382,5,3,2010,7264,1,0,0,3,7,1290,720,1990,1990,98103,47.694,122.33,1510,7326,25,0,8,3520,9336
5.25e+05,2015,464,4,2,2680,14157,1,0,0,3,8,1460,1220,1966,1966,98188,47.429,122.29,2100,9199,49,0,6,4780,11879
2.68e+05,2015,471,3,1,1420,6000,1,0,0,3,6,1420,0,1941,1941,98146,47.491,122.34,1480,6000,74,0,4,2900,7420
2.73e+05,2014,285,3,1,1500,6250,1,0,0,3,6,890,610,1945,1945,98126,47.536,122.37,1210,6250,69,0,4,2710,7750
9e+05,2015,493,3,1.75,1540,8400,1,0,0,3,7,1540,0,1902,1902,98122,47.619,122.3,1330,4800,113,0,4.75,2870,6340
7.0538e+05,2014,125,3,2.5,2490,4343,2,0,0,3,9,2490,0,2003,2003,98029,47.549,121.99,2130,4106,11,0,5.5,4620,6596
3.98e+05,2014,264,2,2,1300,3865,1,0,0,3,8,1300,0,2006,2006,98053,47.719,122.02,1350,4199,8,0,4,2650,5499
3.9995e+05,2015,447,4,2.75,3210,41689,1,0,0,4,8,1610,1600,1989,1989,98042,47.349,122.06,2100,41384,26,0,6.75,5310,44594
7.033e+05,2015,375,3,2,1980,3525,1,0,0,4,8,1590,390,1932,1932,98117,47.685,122.37,1760,3760,83,0,5,3740,5740
6.35e+05,2014,148,3,2.5,2300,5500,1,0,0,4,8,2000,300,1921,1921,98144,47.578,122.29,2100,5000,93,0,5.5,4400,7300
4.05e+05,2015,407,3,1.5,1330,12500,1,0,0,3,7,1330,0,1966,1966,98027,47.526,122.05,2310,12500,49,0,4.5,3640,13830
7.23e+05,2014,134,4,2.5,2700,4004,2,0,0,3,9,2700,0,2004,2004,98029,47.552,122,2260,4459,10,0,6.5,4960,7159
8.4e+05,2014,298,4,2.25,2100,3671,1,0,0,3,8,1750,350,1929,1929,98112,47.636,122.3,1800,4560,85,0,6.25,3900,6660
5.9e+05,2014,173,4,2.5,3220,7875,1,0,0,4,8,3220,0,1966,1966,98008,47.626,122.12,1600,7875,48,0,6.5,4820,11095
2.9e+05,2015,444,3,2.5,1610,2937,2,0,0,3,8,1610,0,2006,2006,98055,47.449,122.19,1610,3049,9,0,5.5,3220,4659
5.45e+05,2014,189,3,2.5,2760,17377,2,0,0,3,9,2760,0,2002,2002,98056,47.493,122.19,1940,8504,12,0,5.5,4700,11264
7.05e+05,2014,272,6,2.75,2830,10579,1,0,0,4,8,1430,1400,1967,1967,98005,47.636,122.17,2060,10745,47,0,8.75,4890,13575
4.7e+05,2015,429,3,2.5,2480,5082,2,0,0,3,7,2480,0,2004,2004,98065,47.53,121.85,2480,5874,11,0,5.5,4960,8354
6.16e+05,2014,181,4,1.75,1700,5846,1,0,0,3,8,1700,0,1957,1957,98199,47.654,122.41,1480,5177,57,0,5.75,3180,6877
3.35e+05,2014,221,3,2.5,2440,7632,2,0,0,3,8,2440,0,1998,1998,98003,47.349,122.3,2510,7903,16,0,5.5,4950,10343
4.01e+05,2015,424,4,1.75,3010,12523,1,0,0,3,8,1780,1230,1952,1952,98125,47.707,122.32,2040,7560,63,0,5.75,5050,10570
8.1e+05,2014,318,3,2,2390,8025,2,0,0,5,7,2390,0,1921,1921,98105,47.671,122.29,1920,5350,93,0,5,4310,7740
6.03e+05,2014,221,4,2.5,2670,5895,2,0,0,3,8,2670,0,1999,1999,98074,47.607,122.02,2820,6531,15,0,6.5,5490,9201
4.4e+05,2015,494,5,2,1430,5600,1,0,0,3,6,1430,0,1947,1947,98118,47.519,122.27,1860,5980,68,0,7,3290,7410
2.65e+05,2014,303,3,2.25,1450,13439,1,0,0,4,7,1180,270,1963,1963,98003,47.281,122.3,1520,12348,51,0,5.25,2970,13798
2.69e+05,2015,412,3,2.25,1420,7297,1,0,0,3,7,1130,290,1984,1984,98031,47.405,122.19,1730,7419,31,0,5.25,3150,8839
4.65e+05,2014,203,3,2.5,2150,4084,2,0,0,3,8,2150,0,2007,2007,98126,47.549,122.37,1750,2385,7,0,5.5,3900,4535
5.68e+05,2014,127,3,2,2350,5080,1,0,0,3,8,1780,570,1929,1929,98118,47.552,122.26,1700,5080,85,0,5,4050,7430
5.1995e+05,2014,311,5,3.5,2440,10200,2,0,0,4,7,2440,0,1974,1974,98075,47.581,122,2000,10568,40,0,8.5,4440,13008
5.5e+05,2014,321,3,1.5,2440,7200,1,0,0,3,7,2440,0,1949,1949,98118,47.56,122.27,1920,6900,65,0,4.5,4360,9340
3e+05,2015,479,2,1,1290,2482,2,0,0,3,7,1290,0,2008,2008,98053,47.697,122.03,1290,2482,7,0,3,2580,3772
2.1e+05,2015,424,2,1,750,34133,1,0,0,3,6,750,0,1950,1950,98168,47.478,122.29,1460,25792,65,0,3,2210,26542
3.65e+05,2014,262,3,2,2140,26600,1,0,0,4,7,2140,0,1983,1983,98031,47.407,122.17,2310,8783,31,0,5,4450,10923
4e+05,2015,478,3,2.5,1390,2815,2,0,0,3,8,1390,0,1999,1999,98126,47.566,122.37,1390,3700,16,0,5.5,2780,5090
2.6735e+05,2014,133,4,2.25,2510,8165,1,0,0,4,7,1610,900,1972,1972,98023,47.309,122.37,1940,8250,42,0,6.25,4450,10760
3.2e+05,2014,166,3,2.25,1200,1400,3,0,0,3,8,1200,0,2005,2005,98133,47.705,122.36,1370,6552,9,0,5.25,2570,7752
2.7315e+05,2014,242,3,1.75,1710,7210,1,0,0,4,7,1240,470,1974,1974,98031,47.409,122.17,1840,7245,40,0,4.75,3550,8955
4.8e+05,2015,437,3,2,1460,7860,1,0,0,5,7,1460,0,1967,1967,98008,47.623,122.11,1850,8148,48,0,5,3310,9608
2.54e+05,2014,148,3,2,1480,7480,1,0,0,4,7,1480,0,1992,1992,98038,47.354,122.06,1680,7146,22,0,5,3160,8626
2.8e+05,2015,400,3,2.25,1220,5739,1,0,0,3,7,790,430,1984,1984,98115,47.695,122.33,1870,5739,31,0,5.25,3090,6959
2.2e+05,2015,451,2,1,580,7500,1,0,0,3,5,580,0,1943,1943,98178,47.485,122.25,1700,11250,72,0,3,2280,11830
6.57e+05,2014,190,4,2.5,2640,25038,2,0,0,4,8,2640,0,1995,1995,98056,47.528,122.17,2630,16668,19,0,6.5,5270,19308
4.25e+05,2014,150,3,1.75,1680,3000,1,0,2,4,6,840,840,1900,1900,98103,47.686,122.35,1540,3700,114,0,4.75,3220,5380
2.46e+05,2014,128,3,1.75,1390,7399,1,0,0,4,7,1390,0,1975,1975,98031,47.418,122.18,1460,7800,39,0,4.75,2850,9190
7.1e+05,2014,305,4,2.5,4070,1.2981e+05,2,0,0,3,10,4070,0,1998,1998,98038,47.443,122.02,4070,1.0237e+05,16,0,6.5,8140,1.0644e+05
2.78e+05,2015,472,3,1.5,1900,9994,1,0,0,3,7,1120,780,1960,1960,98168,47.473,122.3,1900,9994,55,0,4.5,3800,11894
2.675e+05,2014,209,3,1.75,1650,7807,1,0,0,3,7,1650,0,1986,1986,98030,47.351,122.17,1810,8475,28,0,4.75,3460,10125
5.53e+05,2015,367,3,1,1310,18135,1,0,0,3,7,1310,0,1948,1948,98008,47.606,122.11,2150,18135,67,0,4,3460,19445
2.55e+05,2015,383,4,2.5,1660,6724,2,0,0,3,7,1660,0,2009,2009,98001,47.259,122.26,1544,6054,6,0,6.5,3204,7714
9.6399e+05,2014,204,4,3.25,3830,6765,2,0,0,3,9,3830,0,2014,2014,98053,47.685,122.02,3830,6507,0,0,7.25,7660,10337
4.85e+05,2014,255,3,2.5,2270,7887,2,0,2,3,8,2270,0,2004,2004,98065,47.533,121.86,2550,7133,10,0,5.5,4820,9403
4.05e+05,2015,443,3,2.5,2460,12600,1,0,0,4,8,1810,650,1970,1970,98059,47.473,122.12,1820,11180,45,0,5.5,4280,13640
4.4e+05,2015,396,3,1.75,2840,16851,1,0,3,3,8,1600,1240,1950,1950,98155,47.746,122.29,2650,11063,65,0,4.75,5490,13903
5.25e+05,2015,470,3,1.75,1470,6550,1,0,2,3,7,1070,400,1916,1916,98126,47.546,122.38,1440,6550,99,0,4.75,2910,8020
4.4e+05,2015,389,1,1,1160,64469,1,0,0,3,7,1160,0,2009,2009,98072,47.743,122.08,1580,48352,6,0,2,2740,49512
4.7e+05,2014,280,4,1,1740,37238,1,0,0,4,7,1740,0,1932,1932,98024,47.565,121.9,1810,18352,82,0,5,3550,20092
5.1e+05,2014,162,3,1.75,1600,19200,1,0,0,4,7,1600,0,1967,1967,98034,47.72,122.25,2010,14850,47,0,4.75,3610,16450
2.55e+05,2015,414,3,2,1310,8454,1,0,0,3,7,1310,0,1994,1994,98042,47.37,122.08,1310,8454,21,0,5,2620,9764
1.4439e+06,2014,276,4,3,3720,5000,2,0,0,5,9,2720,1000,1905,1905,98102,47.628,122.32,2610,5000,109,0,7,6330,8720
3.825e+05,2014,304,3,2.5,1760,5390,1,0,0,3,8,1760,0,2014,2014,98038,47.348,122.04,2310,5117,0,0,5.5,4070,6877
6.25e+05,2014,244,3,2.75,2240,3600,2,0,0,3,7,1650,590,1901,1901,98102,47.624,122.33,1716,3120,113,0,5.75,3956,5360
2.5e+05,2015,416,3,2.25,1481,2820,2,0,0,3,7,1481,0,2012,2012,98002,47.346,122.22,1481,2889,3,0,5.25,2962,4370
2.695e+05,2014,173,3,1.75,1840,7412,1,0,0,4,7,1240,600,1976,1976,98031,47.393,122.19,1980,7350,38,0,4.75,3820,9190
2.9e+05,2014,129,4,2.5,2000,13300,1,0,0,4,7,1200,800,1968,1968,98001,47.353,122.29,1800,9810,46,0,6.5,3800,11810
8.25e+05,2014,287,2,1,1240,42247,1,0,1,4,7,1240,0,1915,1915,98056,47.517,122.2,1550,12459,99,0,3,2790,13699
7.2e+05,2014,221,5,2.75,2860,5379,2,0,0,3,9,2860,0,2005,2005,98052,47.708,122.1,2980,6018,9,0,7.75,5840,8878
6e+05,2015,488,2,1,1410,4500,1,0,0,3,7,1020,390,1939,1939,98117,47.688,122.38,1300,4500,76,0,3,2710,5910
4.4495e+05,2014,324,3,2.5,2020,7800,1,0,0,4,7,1330,690,1958,1958,98133,47.737,122.34,1870,7800,56,0,5.5,3890,9820
8.52e+05,2015,440,4,2.5,2620,7328,2,0,0,3,8,2620,0,1983,1983,98118,47.551,122.26,1670,5080,32,0,6.5,4290,7700
1.08e+06,2015,457,3,2.75,2770,5800,1,0,0,4,8,1650,1120,1959,1959,98199,47.65,122.41,2340,5800,56,0,5.75,5110,8570
5e+05,2014,352,4,2,1680,3813,2,0,0,4,7,1680,0,1900,1900,98144,47.593,122.29,2540,3996,114,0,6,4220,5676
2.76e+05,2014,348,3,1,870,8040,1,0,0,3,7,870,0,1953,1953,98177,47.705,122.37,1440,8040,61,0,4,2310,8910
3.05e+05,2014,313,4,1.75,2251,12731,1,0,1,4,8,1390,861,1957,1957,98003,47.337,122.32,2520,12539,57,0,5.75,4771,14790
6.455e+05,2014,312,4,2.5,2990,8622,2,0,0,3,9,2990,0,2000,2000,98065,47.539,121.88,2980,8622,14,0,6.5,5970,11612
3.3995e+05,2014,202,3,1,1320,11457,1,0,0,3,8,1320,0,1959,1959,98028,47.774,122.26,1900,9800,55,0,4,3220,11120
6.85e+05,2014,339,6,2.25,2770,5854,1,0,0,3,8,2120,650,1921,1921,98112,47.647,122.3,2300,5450,93,0,8.25,5070,8220
1.31e+06,2015,381,2,2.25,3950,3938,2,0,4,3,10,2910,1040,1991,1991,98116,47.591,122.38,3220,4500,24,0,4.25,7170,8450
2.81e+05,2014,312,3,1,1340,21336,1,0,0,4,5,1340,0,1945,1945,98032,47.402,122.27,1340,37703,69,0,4,2680,39043
3.34e+05,2014,173,4,1.5,1150,9360,1,0,0,3,6,1150,0,1970,1970,98034,47.72,122.17,1480,8155,44,0,5.5,2630,9305
5.3e+05,2015,426,3,3.5,1550,1233,2,0,0,3,8,1160,390,2005,2005,98122,47.603,122.31,1490,1539,10,0,6.5,3040,3089
4.7995e+05,2015,478,3,2.5,2810,4984,1,0,0,3,9,1750,1060,2006,2006,98055,47.446,122.21,2810,5711,9,0,5.5,5620,8521
5.9e+05,2015,458,3,2.5,1710,2875,2,0,0,3,8,1710,0,2006,2006,98116,47.579,122.39,1640,5750,9,0,5.5,3350,7460
1.335e+06,2014,348,4,1.75,2300,13342,1,1,4,3,7,2300,0,1934,1958,98125,47.731,122.28,2500,13342,80,1,5.75,4800,15642
5.625e+05,2014,273,4,2.5,2320,8721,2,0,0,3,8,2320,0,1991,1991,98034,47.733,122.23,2260,8268,23,0,6.5,4580,10588
4e+05,2014,264,1,1,530,13679,1,0,0,4,6,530,0,1949,1949,98053,47.642,121.95,1930,20624,65,0,2,2460,21154
5.27e+05,2014,161,2,1.75,1640,4080,1,0,0,3,7,840,800,1921,1921,98105,47.664,122.33,1980,4080,93,0,3.75,3620,5720
7.45e+05,2014,191,3,1.75,2050,11041,1,0,0,5,9,2050,0,1959,1959,98005,47.597,122.17,2530,11041,55,0,4.75,4580,13091
3.8e+05,2014,311,2,2,1120,780,2,0,0,3,8,760,360,2004,2004,98116,47.579,122.41,1120,1322,10,0,4,2240,2442
4.5295e+05,2015,481,3,2.5,1150,1194,2,0,0,3,8,1020,130,2006,2006,98107,47.668,122.36,1450,1714,9,0,5.5,2600,2864
8.055e+05,2015,387,3,1,1440,10330,1,0,0,4,7,1440,0,1952,1952,98004,47.624,122.19,2080,10327,63,0,4,3520,11767
9.308e+05,2014,245,5,2.5,4150,96574,2,0,0,3,10,4150,0,1988,1988,98053,47.666,122.05,3320,40803,26,0,7.5,7470,44953
6.08e+05,2015,447,3,2.75,2610,5000,2,0,0,4,7,1710,900,1946,1946,98107,47.673,122.37,1500,5000,69,0,5.75,4110,7610
4.35e+05,2014,305,2,2,1440,1170,2,0,0,3,9,960,480,2004,2004,98116,47.559,122.39,1440,1350,10,0,4,2880,2790
7.4e+05,2015,450,4,2.25,2230,6000,1,0,2,3,8,1810,420,1928,1928,98199,47.646,122.39,2840,6000,87,0,6.25,5070,8230
1.1e+06,2014,297,3,2.25,2420,7200,1,0,0,3,8,1420,1000,1948,1948,98115,47.687,122.28,2500,7200,66,0,5.25,4920,9620
4.945e+05,2014,198,4,3,3760,8804,2,0,0,3,8,2470,1290,2002,2002,98056,47.516,122.19,1960,7225,12,0,7,5720,10985
1.827e+05,2014,278,3,2.25,1740,6650,1,0,0,3,7,1240,500,1978,1978,98023,47.298,122.38,1740,7000,36,0,5.25,3480,8740
2.9075e+05,2015,474,3,2.5,1270,865,2,0,0,3,7,1080,190,2008,2008,98118,47.535,122.28,1630,7752,7,0,5.5,2900,9022
2.099e+05,2014,256,3,1,1030,60720,1,0,0,3,5,1030,0,1912,1912,98042,47.375,122.17,1330,10342,102,0,4,2360,11372
5.55e+05,2014,148,3,2.5,3160,4270,2,0,0,3,8,2650,510,2006,2006,98011,47.745,122.19,2720,12523,8,0,5.5,5880,15683
4.8523e+05,2014,317,4,2.5,2714,12558,2,0,0,3,9,2714,0,2014,2014,98031,47.352,122.2,2873,8269,0,0,6.5,5587,10983
4.2e+05,2014,271,3,1.5,1130,5413,1,0,0,3,7,940,190,1946,1946,98125,47.702,122.32,1400,7168,68,0,4.5,2530,8298
4.05e+05,2014,141,3,1.75,2470,9620,1,0,1,4,7,1570,900,1962,1962,98198,47.4,122.32,2600,9620,52,0,4.75,5070,12090
8.95e+05,2014,231,4,3,3500,13444,2,0,0,3,10,2360,1140,1977,1977,98040,47.547,122.23,3140,12935,37,0,7,6640,16435
3e+05,2014,238,4,1.75,2080,8750,1,0,0,4,8,1330,750,1967,1967,98032,47.375,122.29,1790,8750,47,0,5.75,3870,10830
5.35e+05,2015,473,3,2.5,1970,6634,2,0,0,3,8,1970,0,1989,1989,98029,47.576,122.01,2090,6176,26,0,5.5,4060,8146
1.25e+06,2015,439,4,2.25,1830,7200,2,0,2,3,8,1750,80,1923,1923,98112,47.632,122.28,3100,7200,92,0,6.25,4930,9030
5e+05,2015,459,3,2.5,2440,7600,1,0,0,3,7,1420,1020,1981,1981,98052,47.697,122.13,2060,7700,34,0,5.5,4500,10140
3.4995e+05,2014,278,3,2.5,1420,1162,3,0,0,3,8,1420,0,2002,2002,98103,47.698,122.35,1430,1560,12,0,5.5,2850,2980
7.25e+05,2014,341,3,2.5,2620,28703,1,0,0,3,10,2620,0,1985,1985,98052,47.724,122.11,2950,30290,29,0,5.5,5570,32910
8.5e+05,2014,222,3,2.25,1950,3600,1,0,0,5,8,1430,520,1911,1911,98119,47.637,122.36,1950,3600,103,0,5.25,3900,5550
5.15e+05,2014,318,4,2.5,2890,7306,2,0,0,3,7,2890,0,2006,2006,98065,47.545,121.88,2850,6687,8,0,6.5,5740,9577
7.84e+05,2014,204,4,2.75,3540,7091,1,0,1,4,8,1970,1570,1947,1947,98199,47.647,122.39,2200,6000,67,0,6.75,5740,9540
4.55e+05,2014,269,2,1,1030,5000,1,0,0,5,6,1030,0,1917,1917,98107,47.658,122.36,1550,5000,97,0,3,2580,6030
7e+05,2014,315,4,1.75,2340,9100,1,0,0,3,8,1610,730,1975,1975,98052,47.64,122.11,2470,11000,39,0,5.75,4810,13340
1.1203e+06,2015,402,4,4,2530,1774,3,0,2,3,9,2100,430,2013,2013,98119,47.636,122.37,2160,2400,2,0,8,4690,4930
4.15e+05,2014,216,4,2.25,2520,4200,1,0,0,4,7,1510,1010,1909,1909,98144,47.581,122.31,1460,4200,105,0,6.25,3980,6720
4.28e+05,2015,440,3,2.25,2600,15000,2,0,0,3,9,2600,0,1978,1978,98038,47.372,122.06,2380,15000,37,0,5.25,4980,17600
3.22e+05,2015,369,4,2.5,1950,4553,2,0,0,3,7,1950,0,2000,2000,98056,47.507,122.17,1780,4598,15,0,6.5,3730,6548
3.66e+05,2014,320,4,2.75,2020,8093,1,0,0,5,7,1300,720,1961,1961,98133,47.769,122.33,1920,8089,53,0,6.75,3940,10109
4.105e+05,2014,293,3,1,1150,6800,1,0,0,3,7,1150,0,1954,1954,98133,47.727,122.34,1210,6800,60,0,4,2360,7950
3.45e+05,2015,465,2,1.5,830,1034,2,0,0,3,8,830,0,2009,2009,98144,47.593,122.3,1130,2534,6,0,3.5,1960,3364
2.85e+05,2015,457,3,2.5,1320,955,3,0,0,3,7,1320,0,2009,2009,98106,47.52,122.36,1300,1003,6,0,5.5,2620,2323
6.45e+05,2015,444,3,1,2270,4182,1,0,0,4,7,1170,1100,1946,1946,98115,47.688,122.32,1860,4080,69,0,4,4130,6350
7.2e+05,2014,257,3,1.5,1590,7080,1,0,2,3,8,1310,280,1952,1952,98136,47.524,122.39,2080,7200,62,0,4.5,3670,8790
9.2995e+05,2014,194,3,3.5,3790,10829,2,0,0,3,11,3790,0,1993,1993,98027,47.553,122.1,3620,10989,21,0,6.5,7410,14779
3.7495e+05,2014,249,3,2.5,2540,11562,1,0,1,3,8,1290,1250,1964,1964,98028,47.761,122.23,2230,10310,50,0,5.5,4770,12850
5.89e+05,2014,148,3,1,1110,6000,1,0,0,5,7,1110,0,1932,1932,98199,47.65,122.4,1420,6000,82,0,4,2530,7110
3.93e+05,2015,487,4,2.5,2641,8091,2,0,0,3,7,2641,0,1998,1998,98031,47.404,122.21,2641,8535,17,0,6.5,5282,11176
5.15e+05,2014,306,2,1.75,1930,5570,1,0,0,3,8,1930,0,2005,2005,98053,47.717,122.03,1810,5178,9,0,3.75,3740,7108
8.1e+05,2014,250,4,2.5,3340,8384,2,0,0,3,9,3340,0,2014,2014,98052,47.676,122.15,1560,9429,0,0,6.5,4900,12769
3.2e+05,2015,429,3,2.5,1590,3480,2,0,0,3,7,1590,0,2004,2004,98056,47.48,122.18,1680,3480,11,0,5.5,3270,5070
3.1495e+05,2015,413,3,1.75,1520,9600,1,0,0,4,7,1520,0,1967,1967,98059,47.473,122.15,1590,10183,48,0,4.75,3110,11703
4.65e+05,2014,135,3,1.75,1410,6886,1,0,0,3,7,1410,0,1924,2013,98133,47.718,122.35,1410,6561,90,1,4.75,2820,7971
1.001e+06,2014,354,4,2,3100,8000,1,0,0,5,7,2040,1060,1939,1939,98103,47.685,122.33,1650,4000,75,0,6,4750,7100
2.4995e+05,2014,125,3,2,1550,15040,1,0,0,4,6,1550,0,1958,1958,98059,47.487,122.1,1510,41416,56,0,5,3060,42966
5.46e+05,2015,449,2,1,1120,6180,1,0,0,4,7,1120,0,1939,1939,98115,47.682,122.3,1420,5356,76,0,3,2540,6476
2.73e+05,2015,423,3,2.25,1230,11601,1,0,0,4,7,910,320,1992,1992,98022,47.196,121.99,1820,8465,23,0,5.25,3050,9695
5.443e+05,2014,305,4,1.75,1560,9000,1,0,0,5,7,1560,0,1969,1969,98052,47.671,122.15,1510,8848,45,0,5.75,3070,10408
3.57e+05,2014,183,2,1,870,4600,1,0,0,4,7,870,0,1942,1942,98126,47.527,122.38,930,4600,72,0,3,1800,5470
3.75e+05,2015,470,3,1,1210,7425,1,0,0,4,6,1210,0,1910,1910,98133,47.712,122.33,1260,7425,105,0,4,2470,8635
4.95e+05,2014,249,4,2.5,2020,7200,1,0,0,5,7,1010,1010,1968,1968,98034,47.729,122.2,1620,7275,46,0,6.5,3640,9295
8.22e+05,2014,162,4,2.5,2683,40386,2,0,0,4,9,2683,0,1987,1987,98052,47.698,122.14,2683,34800,27,0,6.5,5366,37483
3.898e+05,2014,173,3,1.75,1880,12821,1,0,0,3,7,1880,0,1959,1959,98155,47.768,122.31,1540,12868,55,0,4.75,3420,14748
5.85e+05,2014,208,3,1.75,1480,4800,2,0,0,4,7,1140,340,1944,1944,98199,47.657,122.4,1810,4800,70,0,4.75,3290,6280
3.05e+05,2015,368,4,2.25,2340,5250,2,0,0,5,7,2340,0,1965,1965,98118,47.518,122.27,1540,5250,50,0,6.25,3880,7590
9.15e+05,2014,182,3,4.5,3850,62726,2,0,0,3,10,3120,730,2013,2013,98053,47.673,122.06,2630,46609,1,0,7.5,6480,50459
2.25e+05,2014,201,2,1,1030,9192,1,0,0,4,6,1030,0,1959,1959,98058,47.456,122.18,1030,9190,55,0,3,2060,10220
2.3e+05,2015,386,2,2,1300,3608,1,0,0,3,7,1300,0,2004,2004,98198,47.362,122.31,1510,3608,11,0,4,2810,4908
6.85e+05,2015,480,4,2.5,3550,10968,2,0,0,3,9,3550,0,2006,2006,98065,47.543,121.89,3550,8583,9,0,6.5,7100,12133
3.3e+05,2014,167,3,2.5,3040,7232,2,0,0,3,7,3040,0,2003,2003,98092,47.336,122.17,2760,6926,11,0,5.5,5800,9966
5e+05,2015,443,4,2.25,2060,44431,2,0,0,3,7,2060,0,1988,1988,98077,47.744,122.05,2160,45657,27,0,6.25,4220,47717
3.55e+05,2014,203,3,1,940,8512,1,0,0,4,7,940,0,1967,1967,98033,47.7,122.19,1060,8512,47,0,4,2000,9452
3.2e+05,2014,196,3,2.5,1820,1855,2,0,0,3,8,1570,250,2008,2008,98166,47.464,122.35,1470,6900,6,0,5.5,3290,8720
3e+05,2015,365,4,2.5,1981,4828,2,0,0,3,8,1981,0,2013,2013,98092,47.325,122.17,1981,3783,2,0,6.5,3962,5764
2.9e+05,2014,228,3,1,960,9000,1,0,0,4,7,960,0,1955,1955,98006,47.577,122.15,1520,9000,59,0,4,2480,9960
3.4e+05,2014,324,2,1.75,1270,1916,2,0,0,3,8,1270,0,2012,2012,98108,47.565,122.29,1140,1916,2,0,3.75,2410,3186
5.925e+05,2014,229,4,2.5,3370,35150,1,0,0,5,8,1770,1600,1993,1993,98027,47.461,122,2920,41241,21,0,6.5,6290,44611
1.688e+06,2015,373,4,4,5000,12941,3,0,2,3,12,5000,0,2002,2002,98006,47.55,122.1,4560,12941,13,0,8,9560,17941
4.65e+05,2015,459,3,1,800,3060,1,0,0,4,6,800,0,1903,1903,98117,47.677,122.39,1180,3060,112,0,4,1980,3860
3.81e+05,2014,273,4,2.5,2130,6003,2,0,0,3,8,2130,0,2003,2003,98058,47.452,122.12,1940,4529,11,0,6.5,4070,6659
4.445e+05,2014,265,3,2.5,2600,4724,2,0,0,3,7,2600,0,2002,2002,98065,47.536,121.88,2400,4724,12,0,5.5,5000,7324
3.73e+05,2014,133,5,2.5,3001,5710,2,0,0,3,8,3001,0,2006,2006,98042,47.373,122.18,2340,5980,8,0,7.5,5341,8981
2.295e+05,2014,154,3,1.75,1770,33224,1,0,0,4,8,1770,0,1968,1968,98092,47.338,122.19,1690,22069,46,0,4.75,3460,23839
2.7e+05,2015,410,5,2.5,2140,10320,1,0,0,4,7,1330,810,1967,1967,98031,47.393,122.19,2050,8964,48,0,7.5,4190,11104
1.5e+05,2014,210,3,1,1320,24684,1,0,0,3,7,1320,0,1979,1979,98168,47.477,122.32,1120,21214,35,0,4,2440,22534
3.22e+05,2014,270,3,1.75,2200,12231,1,0,0,4,7,1250,950,1964,1964,98056,47.508,122.17,2200,9825,50,0,4.75,4400,12025
4.45e+05,2014,166,3,1.75,1890,32340,1,0,3,3,8,1890,0,1976,1976,98070,47.414,122.44,1890,40180,38,0,4.75,3780,42070
2.45e+05,2015,390,2,1,710,6322,1,0,0,3,6,710,0,1942,1942,98126,47.517,122.38,740,6720,73,0,3,1450,7430
1.6e+05,2014,257,2,2.5,1660,2258,2,0,0,3,7,1660,0,1981,1981,98042,47.379,122.15,1740,2390,33,0,4.5,3400,4050
7e+05,2014,354,3,3,2090,7440,1,0,0,5,7,1290,800,1922,1922,98103,47.689,122.33,1570,4960,92,0,6,3660,7050
3.75e+05,2015,477,4,2,1620,4600,2,0,0,3,7,1620,0,1909,1909,98108,47.553,122.31,1620,4500,106,0,6,3240,6120
7.35e+05,2014,190,3,2.5,2820,8159,2,0,0,3,9,2820,0,2004,2004,98029,47.553,121.99,2910,5000,10,0,5.5,5730,7820
1.7995e+05,2015,463,4,1.5,1130,5200,1,0,0,3,6,1130,0,1968,1968,98042,47.362,122.09,1140,5200,47,0,5.5,2270,6330
8.081e+05,2014,307,4,3.25,3020,13457,1,0,0,5,9,3020,0,1956,1956,98133,47.717,122.34,2120,7553,58,0,7.25,5140,10573
1.345e+06,2015,445,4,3.25,3440,4920,2,0,4,3,10,2520,920,2014,2014,98116,47.573,122.41,2350,5166,1,0,7.25,5790,8606
3.9e+05,2014,228,4,1.75,2020,9750,1,0,0,3,7,1100,920,1975,1975,98074,47.619,122.06,1670,9600,39,0,5.75,3690,11620
1.195e+05,2014,154,3,1,1170,11000,1,0,0,2,6,1170,0,1980,1980,98019,47.735,121.98,1590,10894,34,0,4,2760,12064
5.99e+05,2014,174,5,2.75,2730,22572,1,0,0,3,7,2080,650,1968,1992,98075,47.595,122.04,2260,15458,46,1,7.75,4990,18188
6.1121e+05,2015,485,1,1,1940,6300,1,0,3,3,8,1940,0,1963,1963,98116,47.578,122.4,2560,6300,52,0,2,4500,8240
5.9495e+05,2014,189,4,2.5,2720,10006,2,0,0,3,9,2720,0,1989,1989,98074,47.63,122.04,2720,10759,25,0,6.5,5440,13479
1.905e+06,2015,402,4,3.5,4210,18564,2,0,0,3,11,4210,0,2001,2001,98039,47.621,122.22,3520,18564,14,0,7.5,7730,22774
1.75e+05,2014,170,2,1,1020,5130,1,0,0,4,6,1020,0,1948,1948,98002,47.301,122.23,1200,6497,66,0,3,2220,7517
3.7e+05,2014,345,3,2.25,3230,35306,2,0,0,3,9,3230,0,1987,1987,98092,47.306,122.11,2760,35285,27,0,5.25,5990,38515
8.71e+05,2015,480,5,1.75,2360,6150,1,0,0,5,7,1180,1180,1940,1940,98107,47.673,122.4,2100,5500,75,0,6.75,4460,7860
2.45e+05,2014,242,3,3,1990,9600,1,0,0,3,7,1440,550,1988,1988,98003,47.35,122.3,1670,9600,26,0,6,3660,11590
1.8e+06,2014,126,5,5,4490,10279,2,0,0,3,10,3930,560,2013,2013,98004,47.597,122.2,2490,10279,1,0,10,6980,14769
1e+06,2014,330,3,2.25,3040,52302,1,0,0,3,9,3040,0,2005,2005,98072,47.764,122.11,2070,38600,9,0,5.25,5110,41640
4.47e+05,2014,201,2,1,980,1600,2,0,0,3,8,980,0,2010,2010,98119,47.638,122.38,1180,1600,4,0,3,2160,2580
5.4995e+05,2014,203,4,3.5,3906,9674,2,0,2,3,9,3906,0,2014,2014,98001,47.293,122.26,2673,6500,0,0,7.5,6579,10406
4.56e+05,2015,463,3,2.5,1820,2935,2,0,0,3,8,1820,0,1999,1999,98074,47.602,122.02,1820,2936,16,0,5.5,3640,4756
7.8e+05,2015,372,6,4,3300,5720,1,0,0,3,8,1960,1340,1963,1963,98115,47.676,122.31,2030,4080,52,0,10,5330,7380
3.985e+05,2015,433,3,1,1200,15960,1,0,0,3,6,1200,0,1945,1945,98125,47.716,122.3,1120,7800,70,0,4,2320,9000
3.4e+05,2014,154,3,1.75,2190,12626,2,0,0,4,8,2190,0,1978,1978,98042,47.385,122.15,3110,14592,36,0,4.75,5300,16782
6.5345e+05,2014,205,3,2.5,2070,49658,1,0,0,4,8,1540,530,1980,1980,98075,47.594,122.01,2620,35160,34,0,5.5,4690,37230
8.33e+05,2015,451,4,1.75,2260,12238,1,0,0,3,9,2260,0,1967,1967,98005,47.598,122.18,2430,10204,48,0,5.75,4690,12464
3.5136e+05,2014,274,2,1.75,1210,1189,2,0,0,3,8,1210,0,2014,2014,98029,47.553,122,1540,1672,0,0,3.75,2750,2882
6.6995e+05,2014,284,3,3,2330,1944,2,0,0,3,8,1950,380,2014,2014,98027,47.545,122.02,2290,1407,0,0,6,4620,3737
3.05e+05,2015,451,3,2.5,1260,895,3,0,0,3,7,1160,100,2009,2009,98133,47.707,122.34,1190,1095,6,0,5.5,2450,2355
2.35e+05,2015,374,3,2.25,1670,7606,2,0,0,3,7,1670,0,1990,1990,98022,47.195,121.98,1670,7433,25,0,5.25,3340,9103
4.265e+05,2015,395,4,2.75,2100,88426,1,0,0,3,6,2100,0,1990,1990,98038,47.399,122.01,2150,63162,25,0,6.75,4250,65262
3.05e+05,2015,472,3,1,1120,10125,1,0,0,3,6,1120,0,1961,1961,98059,47.479,122.08,1120,8820,54,0,4,2240,9940
1.0655e+06,2015,470,3,2.25,2950,7232,1,0,2,3,8,1520,1430,1983,1983,98136,47.526,122.38,2130,7140,32,0,5.25,5080,10090
3.7e+05,2014,338,3,1.75,1580,7000,1,0,0,3,7,1180,400,1976,1976,98034,47.721,122.17,1640,7500,38,0,4.75,3220,9080
6.5e+05,2014,175,4,2.75,1910,16532,1,0,0,4,7,1420,490,1940,1940,98117,47.695,122.39,2300,8250,74,0,6.75,4210,10160
9.917e+05,2014,203,4,3,2290,2350,2,0,1,3,9,1610,680,1924,2011,98116,47.574,122.42,1610,3820,90,1,7,3900,6110
5.88e+05,2015,433,4,2.25,2510,19550,1,0,0,4,9,1810,700,1977,1977,98034,47.704,122.24,2450,19250,38,0,6.25,4960,21760
2.1e+05,2014,217,2,0.75,840,49658,1,0,0,2,6,840,0,1948,1948,98168,47.473,122.29,1240,11000,66,0,2.75,2080,11840
3.7e+05,2014,176,3,1.5,2380,14500,1,0,0,4,7,1850,530,1961,1961,98028,47.771,122.26,1830,13600,53,0,4.5,4210,15980
2.06e+05,2014,167,3,1,1320,7000,1,0,0,4,7,1320,0,1967,1967,98002,47.279,122.2,1260,7455,47,0,4,2580,8775
1e+05,2014,197,2,1,770,17334,1,0,0,3,7,770,0,1978,1978,98001,47.3,122.27,1480,17334,36,0,3,2250,18104
3.45e+05,2014,173,3,1,1140,4200,2,0,0,4,7,1140,0,1904,1904,98144,47.601,122.3,1510,4000,110,0,4,2650,5140
4.6e+05,2014,272,4,3.5,2870,3225,2,0,3,3,9,2070,800,2006,2006,98178,47.501,122.22,1770,6450,8,0,7.5,4640,9320
3.1e+05,2014,243,1,1,570,6000,1,0,0,2,5,570,0,1918,1918,98136,47.552,122.39,1530,6000,96,0,2,2100,6570
5.9e+05,2014,153,4,4.25,2360,57514,2,0,0,4,8,2360,0,1939,1987,98003,47.284,122.29,2037,35733,75,1,8.25,4397,38093
8.5e+05,2014,292,4,3.25,3450,6500,2,0,0,3,8,2450,1000,1994,1994,98136,47.544,122.39,1750,6500,20,0,7.25,5200,9950
4.9e+05,2015,365,4,2.25,2110,16200,1,0,0,3,8,1630,480,1978,1978,98072,47.752,122.14,2370,16000,37,0,6.25,4480,18110
2.4599e+05,2014,266,3,1,1040,8410,1,0,0,3,7,1040,0,1942,2014,98188,47.453,122.29,1350,8410,72,1,4,2390,9450
2.8e+05,2015,448,2,1,790,13170,1,0,0,3,6,790,0,1947,1947,98106,47.549,122.36,970,12700,68,0,3,1760,13490
3.3995e+05,2014,307,4,2.25,2670,9040,1,0,0,3,8,2170,500,1955,1955,98148,47.467,122.33,1880,2648,59,0,6.25,4550,5318
4.19e+05,2015,381,3,2.25,1760,16418,1,0,0,3,7,1190,570,1990,1990,98053,47.653,121.98,2260,20747,25,0,5.25,4020,22507
9.89e+05,2014,154,5,3.5,3280,4000,2,0,0,3,9,2440,840,2003,2003,98117,47.689,122.4,1980,4000,11,0,8.5,5260,7280
2.9e+05,2014,347,2,1.75,1700,18000,1,0,0,3,8,1700,0,1972,1972,98056,47.507,122.19,1700,8225,42,0,3.75,3400,9925
1.288e+06,2015,381,3,2.5,3240,12625,2,0,0,3,11,3240,0,1987,1987,98040,47.533,122.23,3470,12331,28,0,5.5,6710,15571
6.33e+05,2015,362,4,2.5,2020,8044,2,0,0,3,8,2020,0,1990,1990,98074,47.625,122.04,2320,7328,25,0,6.5,4340,9348
4.95e+05,2015,400,3,3,1520,4080,2,0,0,5,7,1520,0,1948,1948,98144,47.572,122.29,1320,4080,67,0,6,2840,5600
2.72e+05,2014,203,3,2.5,1790,6371,2,0,0,3,8,1790,0,1998,1998,98092,47.329,122.17,1850,6371,16,0,5.5,3640,8161
6.1e+05,2014,152,5,2.5,3990,3839,1,0,0,4,8,1990,2000,1962,1962,98112,47.624,122.3,2090,5000,52,0,7.5,6080,8990
2.65e+05,2015,375,3,2.25,1750,9298,1,0,0,4,7,1410,340,1969,1969,98058,47.458,122.16,1720,7875,46,0,5.25,3470,9625
5.85e+05,2015,447,4,2.5,2200,9099,2,0,0,3,8,2200,0,1994,1994,98034,47.733,122.22,2270,8900,21,0,6.5,4470,11100
2.5e+05,2015,463,2,1,860,4320,1,0,0,3,7,860,0,1925,1925,98108,47.526,122.33,980,6000,90,0,3,1840,6860
8.1725e+05,2015,447,3,2.5,2980,7202,2,0,0,3,8,2980,0,1999,1999,98033,47.677,122.18,2430,7280,16,0,5.5,5410,10260
3.1185e+05,2015,429,4,2.5,1890,4158,2,0,0,3,8,1890,0,2014,2014,98042,47.343,122.06,2720,4549,1,0,6.5,4610,6439
4.35e+05,2015,463,2,1,960,6250,1,0,0,4,6,740,220,1940,1940,98126,47.538,122.38,1090,6000,75,0,3,2050,6960
6.05e+05,2015,487,3,2.75,3230,9576,1,0,0,4,8,3230,0,1966,1966,98034,47.731,122.18,2820,9576,49,0,5.75,6050,12806
6.75e+05,2015,477,3,1.5,1460,6480,1,0,2,4,7,980,480,1940,1940,98117,47.696,122.4,2180,6912,75,0,4.5,3640,8372
9.7e+05,2014,141,4,3.25,2790,5420,1,0,3,3,9,1130,1660,1963,2013,98177,47.77,122.39,2530,7200,51,1,7.25,5320,9990
4.3995e+05,2014,334,3,2,1230,1613,2,0,0,3,8,1010,220,2003,2003,98107,47.666,122.37,1610,1873,11,0,5,2840,3103
8.7275e+05,2015,478,3,2.5,2870,13695,2,0,0,3,10,2870,0,1991,1991,98052,47.694,122.1,2840,8472,24,0,5.5,5710,11342
7.7e+05,2015,491,5,3.5,4750,8234,2,0,2,3,10,3350,1400,2013,2013,98198,47.357,122.32,2160,14496,2,0,8.5,6910,19246
4.1e+05,2014,242,3,2.5,1830,2839,2,0,0,3,8,1830,0,1999,1999,98074,47.602,122.02,1830,3011,15,0,5.5,3660,4841
2.7e+05,2014,301,3,2.25,1520,7930,1,0,0,3,7,1160,360,1988,1988,98038,47.361,122.05,1530,7930,26,0,5.25,3050,9450
5.15e+05,2014,298,3,2.5,1510,1178,2,0,0,3,8,1060,450,2007,2007,98122,47.618,122.3,1510,1210,7,0,5.5,3020,2720
3.465e+05,2014,175,2,1.75,1610,6300,1,0,0,3,7,1010,600,1941,1941,98108,47.554,122.3,1370,5225,73,0,3.75,2980,6835
9.4999e+05,2015,403,4,4,3970,7314,2,0,0,3,9,3970,0,2014,2014,98074,47.617,122.06,3560,5258,1,0,8,7530,9228
2.6995e+05,2015,365,3,2.5,2244,4079,2,0,0,3,7,2244,0,2012,2012,98001,47.261,122.25,2077,4078,3,0,5.5,4321,6322
1.95e+05,2014,230,3,1,1300,9600,1,0,0,4,6,1300,0,1975,1975,98092,47.304,122.11,1150,10222,39,0,4,2450,11522
3.9795e+05,2015,444,4,1.75,2360,8116,1,0,0,4,7,1180,1180,1916,1970,98133,47.764,122.33,1670,8160,99,1,5.75,4030,10520
1.4e+06,2014,339,4,3.25,4290,12103,1,0,3,3,11,2690,1600,1997,1997,98006,47.55,122.1,3860,11244,17,0,7.25,8150,15534
1.44e+06,2014,169,3,3.5,3870,3819,2,0,0,3,11,2760,1110,2002,2002,98102,47.645,122.32,2530,5500,12,0,6.5,6400,9370
5.18e+05,2014,205,4,2.25,2640,34870,1,0,0,3,8,1770,870,1977,1977,98027,47.469,122.01,2500,35580,37,0,6.25,5140,38220
3.499e+05,2014,142,4,2.5,2052,3723,2,0,0,3,8,2052,0,2014,2014,98003,47.282,122.3,2052,5250,0,0,6.5,4104,7302
3.6995e+05,2014,298,4,2.5,2050,4502,2,0,0,3,7,2050,0,2005,2005,98059,47.5,122.15,2480,4504,9,0,6.5,4530,6554
5.3e+05,2014,360,3,0.75,920,20412,1,1,2,5,6,920,0,1950,1950,98070,47.478,122.49,1162,54705,64,0,3.75,2082,55625
1.85e+06,2014,224,5,2.25,2800,8442,2,1,4,3,9,2800,0,1963,2001,98075,47.578,122.08,3220,9156,51,1,7.25,6020,11956
3.21e+05,2014,181,4,2.5,1830,9601,2,0,0,3,7,1830,0,2003,2003,98038,47.354,122.02,1830,5892,11,0,6.5,3660,7722
2.9e+05,2015,402,3,2.5,2360,8764,2,0,0,3,8,2360,0,1991,1991,98022,47.211,122.01,2360,8746,24,0,5.5,4720,11106
2.8e+05,2014,169,3,2,1790,42399,1,0,0,4,7,1790,0,1990,1990,98092,47.314,122.13,1330,40015,24,0,5,3120,41805
4.2959e+05,2014,271,2,2.75,1992,10946,1,1,4,5,6,1288,704,1903,1903,98070,47.355,122.47,1110,8328,111,0,4.75,3102,10320
4.69e+05,2014,270,3,3.25,1390,1278,2,0,0,3,8,1140,250,2005,2005,98107,47.673,122.38,1390,1256,9,0,6.25,2780,2646
3.1e+05,2014,346,1,1,920,8282,1,0,0,3,6,920,0,1944,1980,98011,47.761,122.21,2260,14025,70,1,2,3180,14945
5.5e+05,2014,189,4,1,1440,3600,1,0,0,4,7,1440,0,1924,1924,98116,47.569,122.39,1010,5175,90,0,5,2450,6615
3.55e+05,2014,265,4,2.5,2770,7000,1,0,0,4,7,1940,830,1979,1979,98001,47.34,122.26,2140,7684,35,0,6.5,4910,10454
1.89e+05,2014,148,2,2,1700,3171,1,0,0,5,5,850,850,1927,1927,98002,47.303,122.22,1380,5906,87,0,4,3080,7606
3.2999e+05,2015,429,4,2.75,2420,8438,2,0,0,3,8,2420,0,1997,1997,98022,47.209,122.01,2270,8770,18,0,6.75,4690,11190
7.1e+05,2014,251,2,1,1210,6000,1,0,0,4,7,1000,210,1942,1942,98199,47.648,122.4,1840,6000,72,0,3,3050,7210
4.71e+05,2015,445,2,1,840,5100,1,0,0,4,7,840,0,1949,1949,98117,47.678,122.38,1550,5100,66,0,3,2390,5940
6.521e+05,2015,464,3,2.5,2380,5017,2,0,0,3,9,2380,0,2003,2003,98074,47.63,122.02,2670,6066,12,0,5.5,5050,8446
2.1995e+05,2015,395,3,1,1020,4960,1,0,0,3,6,920,100,1926,1926,98118,47.533,122.28,1230,7335,89,0,4,2250,8355
1.0725e+06,2014,285,3,2.25,2890,21480,2,0,4,3,8,1790,1100,1941,1989,98146,47.503,122.38,2110,8107,73,1,5.25,5000,10997
4.1e+05,2014,137,3,2,1700,4250,1,0,0,3,6,890,810,1944,1944,98199,47.654,122.39,1440,4250,70,0,5,3140,5950
4.9e+05,2015,480,2,1.75,1440,6265,1,0,0,3,8,1440,0,2005,2005,98053,47.703,122.01,1810,5209,10,0,3.75,3250,6649
1.425e+06,2015,444,4,5,4630,24054,2,0,3,3,11,4630,0,2005,2005,98075,47.587,121.97,4630,17584,10,0,9,9260,22214
5.85e+05,2014,352,5,3.5,3180,40946,1,0,3,3,7,1690,1490,1968,1968,98075,47.583,122.07,2430,29620,46,0,8.5,5610,32800
2.55e+05,2014,214,3,1,1710,12000,1,0,0,4,7,1710,0,1972,1972,98001,47.262,122.28,1310,9600,42,0,4,3020,11310
6.162e+05,2014,250,5,3.25,3920,4832,2,0,0,3,9,3030,890,2014,2014,98065,47.52,121.89,2660,4832,0,0,8.25,6580,8752
6.15e+05,2015,468,4,1,1330,2400,1,0,0,4,6,1330,0,1901,1901,98103,47.65,122.34,1330,4400,114,0,5,2660,5730
5.25e+05,2014,258,2,1.5,960,7200,1,0,0,3,7,960,0,1910,1987,98199,47.649,122.4,1550,6000,104,1,3.5,2510,6960
3.375e+05,2014,298,5,2.5,2070,4698,2,0,0,3,7,2070,0,1999,1999,98038,47.354,122.02,2010,4698,15,0,7.5,4080,6768
3.89e+05,2015,386,2,2,1200,7131,1,0,0,3,8,1200,0,2006,2006,98053,47.72,122.02,1670,4601,9,0,4,2870,5801
4.3e+05,2014,142,2,2.5,1520,1588,2,0,0,3,8,1240,280,2007,2007,98144,47.583,122.31,1660,6000,7,0,4.5,3180,7520
5.3995e+05,2014,211,4,2.5,2960,37430,2,0,0,3,9,2960,0,1990,1990,98038,47.399,122.02,2800,36384,24,0,6.5,5760,39344
2.38e+05,2015,481,2,1,1088,8453,1,0,0,3,6,1088,0,1952,2009,98001,47.269,122.23,1088,8016,63,1,3,2176,9104
1.53e+05,2015,416,3,1,1200,10500,1,0,0,3,7,1200,0,1962,1962,98023,47.322,122.35,1350,10500,53,0,4,2550,11700
1.325e+06,2015,480,3,2.5,3590,8400,1,0,0,3,9,2950,640,1958,2007,98005,47.595,122.17,1620,7875,57,1,5.5,5210,11465
8.625e+05,2014,136,4,2.75,3280,24440,2,0,0,3,10,3280,0,1996,1996,98077,47.707,122.07,3490,25138,18,0,6.75,6770,28418
4.15e+05,2014,140,3,2.25,1970,2377,2,0,0,3,8,1680,290,2008,2008,98108,47.563,122.3,1690,1936,6,0,5.25,3660,3906
2.3e+05,2015,473,3,1.75,1310,6960,1,0,0,4,7,1310,0,1974,1974,98092,47.276,122.15,1580,7200,41,0,4.75,2890,8510
5.35e+05,2014,339,3,2.5,1850,1499,2,0,0,3,9,1790,60,2005,2005,98199,47.648,122.4,1770,1539,9,0,5.5,3620,3389
4.98e+05,2015,466,3,1.5,1720,6570,1,0,0,4,8,1720,0,1909,1909,98118,47.528,122.27,1360,6000,106,0,4.5,3080,7720
3.65e+05,2014,154,2,1,1250,8100,1,0,0,4,7,1250,0,1947,1947,98125,47.729,122.33,1710,8100,67,0,3,2960,9350
3.65e+05,2014,303,2,1.5,790,1123,2,0,0,3,8,700,90,2003,2003,98119,47.651,122.37,1370,1281,11,0,3.5,2160,2071
3.25e+05,2014,284,4,2.5,2963,5797,2,0,0,3,9,2963,0,2006,2006,98030,47.383,122.19,2665,6119,8,0,6.5,5628,9082
3.2995e+05,2015,444,4,1.75,1740,7208,1,0,0,3,8,1740,0,1976,1976,98058,47.448,122.13,1680,7350,39,0,5.75,3420,9090
4.35e+05,2015,446,4,2.5,3100,4699,2,0,0,3,9,3100,0,2010,2010,98038,47.379,122.02,2450,5130,5,0,6.5,5550,8230
3.655e+05,2014,333,2,1,1140,15624,1,0,0,4,6,1140,0,1909,1909,98177,47.767,122.37,2110,15493,105,0,3,3250,16633
6.163e+05,2015,431,3,2,1700,8400,2,0,2,3,7,1700,0,1927,1927,98033,47.682,122.19,1820,9000,88,0,5,3520,10700
8.75e+05,2014,155,3,3.5,3250,6000,2,0,0,3,10,2500,750,2001,2001,98136,47.553,122.39,1650,6000,13,0,6.5,4900,9250
7.65e+05,2014,266,2,1.75,1660,4000,1,0,0,3,7,990,670,1940,1940,98112,47.639,122.28,2070,4000,74,0,3.75,3730,5660
9.5e+05,2014,299,5,4,4100,8120,2,0,0,3,9,4100,0,2011,2011,98053,47.692,122.02,4100,7625,3,0,9,8200,11725
3.8288e+05,2015,491,3,2,1620,9566,1,0,0,4,7,1620,0,1968,1968,98059,47.474,122.15,1660,10011,47,0,5,3280,11631
4.7e+05,2015,374,4,2,1500,3659,1,0,0,3,7,830,670,1906,1906,98122,47.609,122.29,1560,3706,109,0,6,3060,5206
5.05e+05,2015,481,3,1.75,1800,7210,1,0,0,3,7,1370,430,1976,1976,98072,47.735,122.17,1820,8100,39,0,4.75,3620,9900
5.715e+05,2014,276,4,2.25,2810,25990,2,0,0,3,8,1860,950,1959,1959,98001,47.299,122.29,2020,16140,55,0,6.25,4830,18950
3.45e+05,2015,395,4,2.5,2280,8190,1,0,3,3,7,1390,890,1983,1983,98188,47.441,122.27,1990,9000,32,0,6.5,4270,11280
4.8e+05,2015,463,2,1,820,4200,1,0,0,3,7,820,0,1980,1980,98112,47.625,122.3,1290,4000,35,0,3,2110,4820
6.25e+05,2014,123,4,2.75,2920,6605,2,0,0,3,8,2920,0,2012,2012,98059,47.491,122.14,3030,6605,2,0,6.75,5950,9525
3.7e+05,2015,394,3,1,1060,7419,1,0,2,4,6,1060,0,1906,1906,98177,47.771,122.39,2190,5953,109,0,4,3250,7013
3.9e+05,2014,251,2,1,860,1800,1,0,0,3,7,860,0,1909,1909,98119,47.633,122.37,2160,3120,105,0,3,3020,3980
5.92e+05,2014,325,3,1.75,1560,7424,1,0,0,5,8,1560,0,1940,1940,98117,47.698,122.37,1370,7424,74,0,4.75,2930,8984
4.28e+05,2015,467,3,2.5,1650,2201,3,0,0,3,8,1650,0,2007,2007,98133,47.711,122.33,1650,1965,8,0,5.5,3300,3615
5e+05,2014,223,3,2.75,1560,77536,1,0,0,3,7,1400,160,1978,1978,98072,47.77,122.13,2210,41449,36,0,5.75,3770,43009
6.5e+05,2014,348,3,1.75,1940,10245,1,0,0,3,7,1940,0,1957,1957,98040,47.583,122.24,2720,11448,57,0,4.75,4660,13388
6.95e+05,2014,298,4,1.75,2390,5880,1,0,2,3,8,1390,1000,1957,1957,98117,47.696,122.4,2210,6260,57,0,5.75,4600,8650
5.71e+05,2014,214,3,2.5,1920,3867,2,0,0,3,8,1920,0,2005,2005,98029,47.554,121.99,2190,3841,9,0,5.5,4110,5761
8.8e+05,2014,299,2,1,1530,6350,1,0,0,4,7,1530,0,1923,1923,98112,47.633,122.3,2640,6350,91,0,3,4170,7880
5.557e+05,2014,211,3,2,1810,12420,1,0,0,4,7,1810,0,1957,1957,98008,47.589,122.13,2230,12330,57,0,5,4040,14140
5.15e+05,2014,293,3,2.5,1440,4394,1,0,0,5,8,1440,0,1987,1987,98029,47.569,122.02,1900,5893,27,0,5.5,3340,7333
3.41e+05,2014,209,3,2.25,1750,8900,2,0,0,4,8,1750,0,1977,1977,98058,47.445,122.14,1680,7910,37,0,5.25,3430,9660
8.1e+05,2014,271,4,2.5,3520,15420,2,0,0,3,10,3520,0,1991,1991,98074,47.638,122.02,3400,21455,23,0,6.5,6920,24975
5.3e+05,2014,174,2,1.5,1580,3680,1,0,2,3,8,1280,300,1941,1941,98126,47.576,122.38,1730,3680,73,0,3.5,3310,5260
3.78e+05,2014,333,4,1.5,2140,7920,1,0,0,3,7,1190,950,1959,1959,98118,47.549,122.27,2140,7238,55,0,5.5,4280,9378
2.45e+05,2014,197,2,1,860,6120,1,0,0,3,7,860,0,1948,1948,98155,47.75,122.33,1100,6860,66,0,3,1960,7720
7.5e+05,2014,205,5,3,2230,8560,1,0,0,3,8,1150,1080,1960,2014,98008,47.615,122.11,2040,8560,54,1,8,4270,10790
7.21e+05,2014,346,3,2.25,2680,10440,1,0,1,3,8,1540,1140,1963,1963,98116,47.561,122.4,2140,7560,51,0,5.25,4820,10240
2.719e+05,2015,375,3,2,1450,8771,2,0,0,4,7,1450,0,1991,1991,98022,47.195,121.99,1450,8653,24,0,5,2900,10103
5.77e+05,2014,243,3,1.75,1740,5500,1,0,0,5,7,970,770,1953,1953,98116,47.577,122.39,1740,7250,61,0,4.75,3480,8990
3.3e+05,2015,446,4,2.5,2210,5929,2,0,0,3,8,2210,0,2004,2004,98042,47.35,122.14,2200,5901,11,0,6.5,4410,8111
1.83e+05,2014,166,3,1.75,1070,8100,1,0,0,4,6,1070,0,1957,1957,98002,47.285,122.22,1260,8100,57,0,4.75,2330,9170
1.2806e+06,2014,290,4,2.5,3560,15450,1,0,1,5,8,2060,1500,1977,1977,98040,47.566,122.23,3680,17314,37,0,6.5,7240,20874
2.95e+05,2014,235,3,1.75,1500,15246,1,0,0,3,6,1500,0,1925,1998,98070,47.437,122.46,1500,16988,89,1,4.75,3000,18488
2.85e+05,2015,438,3,1.5,1480,7117,1,0,0,3,7,1170,310,1960,1960,98028,47.777,122.25,2230,14775,55,0,4.5,3710,16255
4.7e+05,2014,166,3,1.5,1510,8000,1,0,0,4,7,1510,0,1956,1956,98007,47.587,122.14,1430,8000,58,0,4.5,2940,9510
6.275e+05,2014,271,4,1,1560,4080,1,0,0,3,7,1560,0,1923,1923,98103,47.671,122.33,1890,4080,91,0,5,3450,5640
2.5e+05,2015,445,4,1,1550,7296,1,0,0,3,6,1550,0,1957,1957,98106,47.518,122.37,1370,7680,58,0,5,2920,9230
5.25e+05,2015,430,4,1.5,1680,10500,2,0,0,3,7,1680,0,1962,1962,98033,47.681,122.17,1830,10264,53,0,5.5,3510,11944
1.01e+06,2014,338,5,3.25,3510,10930,2,0,0,3,9,3510,0,2013,2013,98033,47.691,122.21,1970,7488,1,0,8.25,5480,10998
3.861e+05,2014,349,3,2,1270,6760,1,0,0,5,7,1270,0,1972,1972,98034,47.738,122.18,1550,5734,42,0,5,2820,7004
3.393e+05,2014,310,3,2,970,10000,1,0,0,5,7,970,0,1972,1972,98074,47.62,122.06,1230,7500,42,0,5,2200,8470
2.95e+05,2015,478,4,2.5,2160,7725,1,0,0,4,8,1460,700,1978,1978,98023,47.308,122.38,2060,8250,37,0,6.5,4220,10410
5.15e+05,2014,128,2,1,1060,4960,1,0,0,3,7,1060,0,1926,1926,98103,47.69,122.33,1420,4960,88,0,3,2480,6020
3.17e+05,2014,161,3,1,1160,8813,1,0,0,3,7,1160,0,1952,1952,98125,47.726,122.33,1200,7615,62,0,4,2360,8775
3.975e+05,2014,298,3,1,1480,5100,1,0,0,3,7,1480,0,1938,1959,98103,47.691,122.35,1300,5100,76,1,4,2780,6580
2.35e+05,2015,439,3,1,1864,6978,1,0,0,4,7,1864,0,1958,1958,98002,47.285,122.21,990,8000,57,0,4,2854,9864
2.95e+05,2015,440,2,1,720,4125,1,0,0,4,6,720,0,1943,1943,98106,47.525,122.35,1000,6100,72,0,3,1720,6820
5.9733e+05,2014,175,4,4,3570,8250,2,0,0,3,10,2860,710,2015,2015,98040,47.578,122.23,2230,10000,-1,0,8,5800,13570
9.85e+05,2014,152,3,1.75,1670,5400,2,0,0,5,8,1670,0,1912,1912,98112,47.635,122.28,2100,5400,102,0,4.75,3770,7070
5.3e+05,2014,259,2,2.25,1260,1312,3,0,0,3,8,1260,0,2007,2007,98103,47.654,122.36,1300,1312,7,0,4.25,2560,2572
4e+05,2015,431,2,2.5,1170,1811,2,0,0,3,8,1170,0,2001,2001,98122,47.613,122.3,1250,3146,14,0,4.5,2420,4316
1.063e+06,2015,412,5,4.5,4820,13165,2,0,0,4,11,3950,870,1990,1990,98077,47.73,122.06,3880,13810,25,0,9.5,8700,18630
5.31e+05,2014,125,2,3,1270,1175,2,0,0,3,8,1110,160,2000,2000,98103,47.663,122.34,1290,1800,14,0,5,2560,3070
9.351e+05,2014,300,4,3.5,3200,8049,1,0,0,3,8,2700,500,1980,1980,98005,47.584,122.17,1640,8506,34,0,7.5,4840,11706
4.45e+05,2014,129,4,2,1650,6000,1,0,0,5,7,1000,650,1959,1959,98144,47.583,122.31,1540,6000,55,0,6,3190,7650
2.42e+05,2015,463,3,2.25,1690,7292,1,0,0,3,7,1250,440,1985,1985,98003,47.264,122.3,1670,7747,30,0,5.25,3360,9437
5.26e+05,2014,277,2,1,1450,4500,1,0,0,4,7,1450,0,1921,1921,98107,47.674,122.4,1470,5000,93,0,3,2920,6450
4.565e+05,2014,339,4,3.5,2000,2309,3,0,0,3,8,2000,0,2008,2008,98177,47.703,122.36,1440,1548,6,0,7.5,3440,3548
3.54e+05,2014,176,4,2.5,2580,5476,2,0,0,3,8,2580,0,2005,2005,98031,47.404,122.2,2900,5476,9,0,6.5,5480,8056
2.6e+05,2014,277,4,2.5,1960,5238,2,0,0,3,7,1960,0,2003,2003,98038,47.348,122.05,1800,5894,11,0,6.5,3760,7854
5.5232e+05,2014,306,3,2.5,1960,8469,2,0,0,4,8,1960,0,1984,1984,98052,47.724,122.11,2040,8189,30,0,5.5,4000,10149
3.15e+05,2015,381,2,1,970,18557,1,0,0,3,6,970,0,1939,1939,98146,47.512,122.37,1150,7200,76,0,3,2120,8170
4.86e+05,2014,134,4,2.5,2150,39449,1,0,0,3,7,1420,730,1978,1978,98024,47.553,121.89,2010,35717,36,0,6.5,4160,37867
3.345e+05,2014,221,3,2,1700,8160,1,0,0,3,7,1120,580,1961,1961,98133,47.74,122.34,1740,8181,53,0,5,3440,9881
3.065e+05,2014,136,3,2.25,2060,38377,1,0,0,4,8,1560,500,1978,1978,98003,47.275,122.32,2080,60513,36,0,5.25,4140,62573
5.695e+05,2014,245,4,2.5,2800,8190,1,0,0,3,8,1700,1100,1971,1971,98177,47.77,122.37,2460,8165,43,0,6.5,5260,10965
9.65e+05,2015,477,4,2.5,3920,41206,2,0,0,4,10,3920,0,1988,1988,98072,47.733,122.13,3780,36562,27,0,6.5,7700,40482
1.58e+06,2014,141,3,3.25,3690,7200,2,0,0,3,11,3690,0,2007,2007,98033,47.681,122.2,1880,7200,7,0,6.25,5570,10890
4.3892e+05,2014,241,3,1.5,1050,4590,1,0,0,3,7,850,200,1949,1949,98115,47.694,122.29,1770,5400,65,0,4.5,2820,6450
3.3e+05,2014,225,3,1,1040,11900,1,0,0,5,6,1040,0,1972,1972,98070,47.433,122.45,1250,9600,42,0,4,2290,10640
1.6e+06,2014,147,3,3.25,3790,19000,2,0,4,3,10,3790,0,1985,1985,98177,47.724,122.37,2740,18628,29,0,6.25,6530,22418
3.75e+05,2015,432,3,3.25,1280,1730,2,0,0,3,8,1090,190,2005,2005,98177,47.703,122.36,1280,2121,10,0,6.25,2560,3401
5.85e+05,2015,380,6,3,3870,43787,2,0,0,3,8,2700,1170,1976,1976,98077,47.764,122.1,2600,35381,39,0,9,6470,39251
6.1825e+05,2014,169,4,3.25,2520,3360,1,0,0,4,8,1550,970,1931,1931,98115,47.68,122.31,1730,3360,83,0,7.25,4250,5880
8.375e+05,2014,154,4,2.5,2700,9320,2,0,0,4,8,2700,0,1994,1994,98033,47.686,122.2,2120,8056,20,0,6.5,4820,10756
8.68e+05,2015,414,4,2.5,2020,4350,2,0,0,5,9,1730,290,1943,1943,98199,47.65,122.41,1620,5800,72,0,6.5,3640,7820
4.035e+05,2014,173,3,1,1830,8004,1,0,0,3,8,1200,630,1960,1960,98125,47.726,122.3,1860,7971,54,0,4,3690,9801
2.68e+05,2014,248,3,1.75,1250,5546,1,0,0,4,7,1250,0,1987,1987,98055,47.472,122.19,1640,4791,27,0,4.75,2890,6041
4.2e+05,2014,256,5,2.25,3070,64033,1,0,0,3,9,2730,340,1983,1983,98001,47.324,122.29,1560,28260,31,0,7.25,4630,31330
6.24e+05,2015,444,5,3.75,3570,14648,2,0,0,3,9,3570,0,2005,2005,98019,47.738,121.97,3160,7882,10,0,8.75,6730,11452
5.9e+05,2014,181,3,2,1410,6413,1,0,0,4,7,910,500,1947,1947,98115,47.683,122.3,1330,6050,67,0,5,2740,7460
5.225e+05,2014,287,4,1.75,2100,6480,1,0,0,5,7,1300,800,1947,1947,98177,47.705,122.36,1840,7500,67,0,5.75,3940,9600
2.34e+05,2014,324,3,1.75,1420,8738,1,0,0,4,7,1420,0,1966,1966,98002,47.311,122.21,1660,8738,48,0,4.75,3080,10158
3.05e+05,2014,202,4,2.5,2100,14773,2,0,0,3,8,2100,0,1998,1998,98023,47.304,122.39,2370,15440,16,0,6.5,4470,17540
7.75e+05,2015,380,3,2.5,2480,5007,2,0,0,3,8,1960,520,2014,2014,98117,47.697,122.37,1650,7806,1,0,5.5,4130,10286
2.6595e+05,2015,424,3,1.75,1470,13068,1,0,0,4,7,1470,0,1975,1975,98092,47.31,122.2,2090,16988,40,0,4.75,3560,18458
4.8e+05,2015,493,3,2.25,1820,15000,1,0,0,3,7,1480,340,1978,1978,98028,47.74,122.25,1930,13600,37,0,5.25,3750,15420
5.35e+05,2014,182,3,1.75,2330,12141,1,0,0,3,7,1390,940,1983,1983,98072,47.761,122.15,1850,12141,31,0,4.75,4180,14471
7.75e+05,2014,214,3,2.5,3010,74390,2,0,0,3,10,3010,0,1998,1998,98053,47.644,122,3240,1.0977e+05,16,0,5.5,6250,1.1278e+05
2.58e+05,2014,300,5,2,2260,12500,1,0,0,4,8,1130,1130,1960,1960,98032,47.389,122.29,1360,18000,54,0,7,3620,20260
1.74e+05,2014,236,2,1,600,4854,1,0,0,5,6,600,0,1922,1922,98168,47.493,122.28,1470,5000,92,0,3,2070,5600
8.99e+05,2015,368,4,2.25,2290,40946,1,0,3,4,8,1550,740,1960,1960,98008,47.616,122.1,2790,20076,55,0,6.25,5080,22366
2.3e+05,2015,410,3,1.5,1900,9630,1,0,0,3,8,1900,0,1967,1967,98023,47.335,122.34,2010,9630,48,0,4.5,3910,11530
7.85e+05,2014,282,4,2.5,2960,4750,2,0,0,3,9,2960,0,2005,2005,98029,47.554,121.99,2960,4750,9,0,6.5,5920,7710
3.25e+05,2014,280,2,2,970,5000,1,0,0,3,7,970,0,1983,1983,98034,47.722,122.16,1540,5000,31,0,4,2510,5970
1.75e+05,2015,436,3,1,1480,8415,1,0,0,3,7,1080,400,1967,1967,98188,47.459,122.28,1780,8512,48,0,4,3260,9992
5.71e+05,2015,463,4,2.25,2290,9900,1,0,2,4,8,1550,740,1959,1959,98166,47.443,122.34,2320,9900,56,0,6.25,4610,12190
2.65e+05,2014,236,3,1.75,1630,5999,1,0,0,4,7,1630,0,1985,1985,98198,47.382,122.31,1540,7500,29,0,4.75,3170,9130
3.55e+05,2014,232,4,2,1770,8890,1,0,0,5,6,1770,0,1949,1949,98166,47.459,122.35,1010,7620,65,0,6,2780,9390
2.75e+05,2014,237,3,1.75,1300,20700,1,0,0,3,7,1300,0,1962,1962,98024,47.559,121.9,1930,37638,52,0,4.75,3230,38938
3e+05,2014,270,4,2.25,2080,7700,1,0,0,3,7,1450,630,1968,1968,98058,47.435,122.17,1900,7980,46,0,6.25,3980,10060
6.01e+05,2014,191,4,2.5,2090,6906,2,0,0,4,8,2090,0,1992,1992,98029,47.572,122,2090,6370,22,0,6.5,4180,8460
5.72e+05,2014,237,3,2.75,2200,3885,2,0,0,3,8,2200,0,2002,2002,98074,47.617,122.03,2710,6000,12,0,5.75,4910,8200
3.12e+05,2014,204,2,1.75,1160,8625,1,0,0,4,6,1160,0,1941,1941,98106,47.551,122.37,960,5750,73,0,3.75,2120,6910
5.31e+05,2014,198,5,2.75,2540,5022,1,0,0,4,8,1540,1000,1955,1955,98108,47.559,122.3,2510,5182,59,0,7.75,5050,7722
4.31e+05,2014,230,3,2.25,2360,14950,1,0,0,4,9,2360,0,1978,1978,98042,47.386,122.16,2720,14388,36,0,5.25,5080,16748
2.05e+05,2014,320,3,2.5,1870,3118,2,0,0,3,8,1870,0,1993,1993,98038,47.374,122.06,1580,3601,21,0,5.5,3450,5471
4.01e+05,2014,181,3,2,1240,11172,1,0,0,3,7,1000,240,1984,1984,98074,47.636,122.04,1330,14102,30,0,5,2570,15342
3.37e+05,2015,472,3,1.75,1440,11364,1,0,0,3,7,1440,0,1985,1985,98155,47.743,122.33,1950,9390,30,0,4.75,3390,10830
4.8e+05,2014,177,2,1,1500,3420,1,0,0,3,7,1500,0,1902,1902,98103,47.661,122.34,2050,3420,112,0,3,3550,4920
4.75e+05,2014,238,3,1.75,1870,25157,2,0,0,3,7,1870,0,1978,1978,98014,47.695,121.92,1870,15391,36,0,4.75,3740,17261
3.073e+05,2014,229,2,2,1520,1020,3,0,0,3,7,1520,0,1999,1999,98133,47.729,122.34,1500,1245,15,0,4,3020,2765
4.9e+05,2015,480,3,2.75,1990,31200,1,0,0,3,8,1990,0,1986,1986,98029,47.554,122.03,3120,29625,29,0,5.75,5110,31615
4.4e+05,2015,492,4,2.5,2410,7517,2,0,0,3,8,2410,0,1983,1983,98058,47.439,122.14,2420,8095,32,0,6.5,4830,10505
6e+05,2014,339,4,2.5,2520,10850,1,0,0,4,8,1680,840,1968,1968,98155,47.775,122.28,2590,10800,46,0,6.5,5110,13320
3.806e+05,2014,224,3,2.5,1920,12244,2,0,0,3,7,1920,0,1998,1998,98019,47.726,121.97,1920,11859,16,0,5.5,3840,13779
5.8e+05,2014,143,3,2.5,1620,1173,3,0,4,3,8,1470,150,2008,2008,98103,47.668,122.36,1620,1505,6,0,5.5,3240,3125
6.475e+05,2014,128,4,1.75,2060,26036,1,0,0,4,8,1160,900,1947,1947,98166,47.444,122.35,2590,21891,67,0,5.75,4650,23951
4.43e+05,2014,331,2,1,1130,5413,1,0,0,3,7,880,250,1939,1939,98115,47.697,122.31,1250,5413,75,0,3,2380,6543
3.535e+05,2014,298,2,1,800,8775,1,0,0,3,6,800,0,1942,1942,98125,47.717,122.31,1470,8976,72,0,3,2270,9776
5.5e+05,2014,155,4,2.5,2700,5150,2,0,0,3,9,2700,0,2007,2007,98059,47.507,122.15,3160,7620,7,0,6.5,5860,10320
8.6e+05,2014,140,4,2.75,3160,8097,2,0,0,3,9,3160,0,2014,2014,98033,47.671,122.17,2200,8097,0,0,6.75,5360,11257
3.74e+05,2014,250,2,1,1140,5650,1,0,1,3,6,980,160,1920,1920,98116,47.563,122.39,1220,5700,94,0,3,2360,6840
8.1e+05,2014,352,4,3.25,4140,46173,2,0,0,3,9,4140,0,2007,2007,98011,47.765,122.21,2060,43103,7,0,7.25,6200,47243
3.25e+05,2015,457,3,1,950,4500,1,0,0,4,6,950,0,1943,1943,98118,47.527,122.27,1140,4500,72,0,4,2090,5450
3.4e+05,2015,452,4,1,1140,13440,1,0,0,2,5,1140,0,1944,1944,98166,47.462,122.34,1450,7560,71,0,5,2590,8700
8.3e+05,2014,347,6,3,2530,9000,1,0,0,3,6,2530,0,1978,1978,98033,47.672,122.2,1886,6000,36,0,9,4416,8530
2.25e+05,2015,444,3,1.75,1580,14400,1,0,0,4,7,1580,0,1981,1981,98001,47.26,122.28,1480,9600,34,0,4.75,3060,11180
3.83e+05,2015,401,5,2,2280,5750,1,0,0,4,8,1140,1140,1951,1951,98116,47.567,122.39,1780,5750,64,0,7,4060,8030
2.5e+05,2015,425,3,1,1130,7800,1,0,0,3,7,1130,0,1952,1952,98118,47.524,122.29,1170,7800,63,0,4,2300,8930
2.205e+05,2014,263,2,1,990,57499,1,0,0,2,6,990,0,1949,1949,98070,47.414,122.46,2090,27442,65,0,3,3080,28432
2.93e+05,2014,196,1,1,1110,5421,1,0,0,3,6,1110,0,1935,1935,98177,47.732,122.36,1230,8100,79,0,2,2340,9210
3.7e+05,2014,191,3,1,1170,1105,1,0,0,3,7,1170,0,1965,1965,98126,47.545,122.38,1380,1399,49,0,4,2550,2569
7.6e+05,2015,482,4,2.5,3520,8095,2,0,0,3,9,3520,0,2006,2006,98052,47.706,122.11,2460,4676,9,0,6.5,5980,8196
2.95e+05,2014,221,3,1.75,1440,4000,1,0,0,4,7,1050,390,1979,1979,98106,47.533,122.35,1560,4000,35,0,4.75,3000,5440
2.678e+05,2014,332,3,1.75,1410,1899,2,0,0,3,8,1410,0,2014,2014,98106,47.517,122.35,1410,1811,0,0,4.75,2820,3221
6.9e+05,2014,149,4,2.5,2920,9904,2,0,0,4,9,2920,0,1990,1990,98029,47.576,122,1810,5617,24,0,6.5,4730,8537
7.0018e+05,2015,485,2,1.75,1530,4387,1,0,0,3,8,1020,510,1952,1952,98115,47.673,122.26,1870,5029,63,0,3.75,3400,6559
3.2e+05,2014,332,4,1,1460,7200,1,0,0,4,7,1460,0,1955,1955,98155,47.76,122.31,1690,7357,59,0,5,3150,8817
3.7e+05,2015,481,3,1.75,1496,1423,2,0,0,3,8,1248,248,2006,2006,98133,47.715,122.36,1460,1423,9,0,4.75,2956,2919
1.029e+06,2014,341,5,3.25,2680,3011,2,0,0,3,9,1870,810,1910,2014,98122,47.611,122.29,3440,5165,104,1,8.25,6120,7845
4.25e+05,2014,331,3,1.75,1530,9800,1,0,0,5,8,1530,0,1958,1958,98133,47.766,122.34,1660,9800,56,0,4.75,3190,11330
5.85e+05,2014,163,3,1,1870,2807,1,0,0,4,7,1580,290,1927,1927,98107,47.667,122.36,1640,4500,87,0,4,3510,6370
5.5e+05,2015,387,3,2,1490,3880,1,0,0,3,7,1490,0,1959,1959,98107,47.662,122.36,1490,3880,56,0,5,2980,5370
8.39e+05,2014,221,5,4,4280,11307,2,0,0,3,10,2710,1570,1996,1996,98027,47.55,122.08,3080,11307,18,0,9,7360,15587
5.5e+05,2014,258,3,2.25,2160,15360,1,0,0,3,8,1410,750,1965,2000,98007,47.623,122.14,2180,8480,49,1,5.25,4340,10640
5.48e+05,2014,249,4,3.25,3420,5012,2,0,0,3,10,2330,1090,2008,2008,98019,47.732,121.98,2320,5465,6,0,7.25,5740,8885
5.51e+05,2014,203,4,1.5,1470,5100,1,0,0,3,7,1470,0,1946,1946,98117,47.677,122.38,1470,5100,68,0,5.5,2940,6570
2.2498e+05,2015,424,3,1,960,12745,1,0,0,4,6,960,0,1977,1977,98038,47.362,122.03,1160,10488,38,0,4,2120,11448
5.25e+05,2014,230,3,1,1240,4800,1,0,0,3,7,800,440,1951,1951,98103,47.656,122.35,1440,4800,63,0,4,2680,6040
2.325e+05,2014,189,3,1.5,1940,9887,1,0,0,4,7,1140,800,1969,1969,98003,47.329,122.33,1410,9936,45,0,4.5,3350,11876
1.0171e+06,2014,159,4,3.75,4060,19290,2,0,0,3,10,4060,0,2002,2002,98074,47.605,122.05,4020,13250,12,0,7.75,8080,17310
1.85e+05,2015,415,3,1,840,12091,1,0,0,3,6,840,0,1959,1959,98023,47.328,122.34,840,9324,56,0,4,1680,10164
5.25e+05,2015,486,3,2.25,1490,9414,2,0,0,3,7,1490,0,1981,1981,98052,47.684,122.11,1290,10125,34,0,5.25,2780,11615
7.6e+05,2015,383,4,2.5,3120,8792,2,0,0,4,9,3120,0,1992,1992,98029,47.57,121.99,2150,7688,23,0,6.5,5270,10808
4.37e+05,2014,215,3,2.25,1980,8775,1,0,0,3,7,1290,690,1959,1959,98177,47.775,122.36,1550,9240,55,0,5.25,3530,11220
4.55e+05,2014,325,3,1.75,1760,11371,1,0,0,5,8,1760,0,1959,1959,98155,47.762,122.27,2220,19884,55,0,4.75,3980,21644
3.12e+05,2014,147,3,1.5,1255,1374,3,0,0,3,7,1255,0,2004,2004,98125,47.715,122.31,1307,1232,10,0,4.5,2562,2487
4.25e+05,2015,396,3,2.25,1420,1230,2,0,0,3,8,940,480,2009,2009,98144,47.57,122.29,1400,1230,6,0,5.25,2820,2650
7.9e+05,2015,452,4,2.5,3020,36893,2,0,0,3,9,3020,0,1986,2007,98077,47.768,122.09,3020,36444,29,1,6.5,6040,39464
3.8e+05,2014,232,3,1,1380,5400,1,0,0,4,7,1380,0,1954,1954,98125,47.713,122.29,1190,6075,60,0,4,2570,7455
4.7995e+05,2015,458,4,2.25,2570,11070,2,0,0,4,8,2570,0,1966,1966,98058,47.451,122.15,2210,9600,49,0,6.25,4780,12170
4.3e+05,2014,256,3,2.75,2600,12860,1,0,0,3,7,1350,1250,1965,1965,98014,47.695,121.92,2260,12954,49,0,5.75,4860,15554
1.225e+06,2014,196,3,3.5,3680,11491,2,0,2,3,11,3680,0,1999,1999,98007,47.565,122.13,3710,10030,15,0,6.5,7390,13710
5.25e+05,2014,236,3,2.5,2340,35021,1,0,0,3,9,2340,0,1986,1986,98038,47.399,122.03,2630,35190,28,0,5.5,4970,37530
3.8e+05,2015,414,5,2,1680,3240,1,0,0,3,5,840,840,1906,1906,98144,47.596,122.31,1380,1260,109,0,7,3060,2940
5.43e+05,2014,301,4,2.5,2060,8451,2,0,0,3,8,2060,0,1995,1995,98133,47.717,122.33,2060,9460,19,0,6.5,4120,11520
3.03e+05,2014,201,3,2.75,1850,8820,2,0,0,4,8,1850,0,1993,1993,98022,47.193,122.01,1850,8651,21,0,5.75,3700,10501
2.27e+05,2014,325,1,2,1150,9812,1,0,0,4,7,1150,0,1962,1962,98001,47.295,122.28,1200,9812,52,0,3,2350,10962
3.759e+05,2014,153,6,1.5,2550,33740,1,0,0,4,8,1750,800,1958,1958,98023,47.322,122.36,2010,28200,56,0,7.5,4560,30750
3.495e+05,2014,181,3,2,1270,3600,1,0,0,3,7,1270,0,1963,1963,98122,47.61,122.3,1660,3600,51,0,5,2930,4870
6.15e+05,2014,202,3,3.25,1470,1152,3,0,0,3,8,1470,0,2003,2003,98103,47.652,122.34,1470,1506,11,0,6.25,2940,2976
4.051e+05,2014,134,2,1,840,3522,1,0,0,3,6,840,0,1947,1947,98199,47.657,122.39,1390,4800,67,0,3,2230,5640
2.6e+05,2014,158,4,2.5,1811,4381,2,0,0,3,8,1811,0,2007,2007,98055,47.454,122.19,1811,4150,7,0,6.5,3622,5961
1.2e+06,2014,224,5,4,2710,2800,3,0,0,3,10,2380,330,1974,2008,98119,47.635,122.36,1530,3600,40,1,9,4240,6310
6.15e+05,2014,255,5,3.5,2950,7980,2,0,3,3,9,2350,600,2005,2005,98065,47.534,121.86,2950,7980,9,0,8.5,5900,10930
1.6325e+05,2014,313,2,1,770,8150,1,0,0,3,6,770,0,1951,1951,98118,47.532,122.28,1140,8550,63,0,3,1910,9320
2.75e+05,2014,195,3,1.75,1300,8099,1,0,0,4,7,1080,220,1976,1976,98056,47.503,122.17,1270,8099,38,0,4.75,2570,9399
6.29e+05,2014,152,3,2,1760,5000,1,0,0,5,7,960,800,1920,1920,98199,47.641,122.4,1380,5000,94,0,5,3140,6760
3.25e+05,2014,353,3,2.25,1440,6443,2,0,0,3,7,1440,0,1995,1995,98019,47.747,121.98,1700,6749,19,0,5.25,3140,8189
1.7e+05,2014,297,3,1,1310,9529,1,0,0,3,7,1310,0,1956,1956,98198,47.41,122.3,1330,9529,58,0,4,2640,10839
6.3e+05,2015,414,4,1.75,2950,9025,1,0,2,4,8,1780,1170,1975,1975,98034,47.713,122.22,2120,9600,40,0,5.75,5070,12550
4.6e+05,2015,438,3,2.25,1620,7350,1,0,0,3,7,1170,450,1969,1969,98034,47.725,122.18,1800,7350,46,0,5.25,3420,8970
8.3e+05,2015,365,2,1.5,2130,35679,1,0,0,4,7,2130,0,1963,1963,98033,47.664,122.17,2670,35679,52,0,3.5,4800,37809
5.095e+05,2014,318,2,2.5,1590,1485,2,0,0,3,8,1300,290,1994,1994,98199,47.638,122.39,1880,3675,20,0,4.5,3470,5265
7.99e+05,2014,280,3,2,2550,4794,2,0,0,3,9,2550,0,2007,2007,98115,47.696,122.29,1630,5100,7,0,5,4180,7650
3.25e+05,2014,214,4,3.25,2800,5291,2,0,0,3,7,2800,0,2011,2011,98022,47.194,121.98,2380,5291,3,0,7.25,5180,8091
6.95e+05,2015,402,2,2.5,2170,7665,1,0,2,3,8,2170,0,2013,2013,98053,47.711,122.02,2300,7100,2,0,4.5,4470,9270
3.24e+05,2014,142,3,2.5,1750,7208,2,0,0,3,8,1750,0,1994,1994,98055,47.431,122.19,2050,7524,20,0,5.5,3800,9274
4.4995e+05,2015,466,4,2.25,3490,8400,1,0,0,4,8,3490,0,1976,1976,98058,47.451,122.13,2320,8723,39,0,6.25,5810,12213
5.147e+05,2015,466,3,3.25,1310,1072,2,0,0,3,8,1060,250,2008,2008,98107,47.674,122.37,1160,1266,7,0,6.25,2470,2576
9.628e+05,2014,235,4,2.5,3780,23623,2,0,0,3,9,3780,0,1997,1997,98006,47.559,122.12,3370,10210,17,0,6.5,7150,13990
3.3999e+05,2014,214,3,2.5,2060,4200,2,0,0,3,8,2060,0,2014,2014,98038,47.371,122.02,2370,4200,0,0,5.5,4430,6260
9.3e+05,2014,255,3,3.25,2950,4446,2,0,0,3,9,2450,500,2001,2001,98116,47.585,122.39,1930,4255,13,0,6.25,4880,7205
3.65e+05,2015,487,3,2.25,2860,8458,2,0,0,3,7,2860,0,1983,1983,98058,47.427,122.15,1760,8458,32,0,5.25,4620,11318
2.35e+05,2014,305,4,1.5,1690,11054,1,0,0,4,5,1690,0,1930,1930,98055,47.467,122.22,1690,9040,84,0,5.5,3380,10730
3.5e+05,2014,280,3,1.5,1860,17640,1,0,0,4,7,1860,0,1966,1966,98059,47.484,122.11,1860,17820,48,0,4.5,3720,19680
5.435e+05,2014,279,3,2.25,1270,2790,1,0,0,3,7,990,280,1970,1970,98199,47.658,122.4,1920,4000,44,0,5.25,3190,5270
5.095e+05,2014,216,5,2.25,2060,9000,1,0,0,4,7,1320,740,1961,1961,98007,47.612,122.14,2050,8800,53,0,7.25,4110,10860
2.4e+05,2015,395,3,1,1690,20063,1,0,0,4,7,1690,0,1913,1913,98001,47.356,122.29,1700,15899,102,0,4,3390,17589
4.48e+05,2015,400,3,2.25,1530,3056,2,0,0,3,7,1530,0,2003,2003,98053,47.682,122.03,1560,3064,12,0,5.25,3090,4594
2.9495e+05,2014,292,4,2.25,1740,9600,1,0,2,3,7,1160,580,1957,1957,98188,47.432,122.28,1630,9600,57,0,6.25,3370,11340
3.25e+05,2015,446,2,1,1130,6908,1,0,0,3,6,1130,0,1945,1945,98155,47.745,122.31,1150,6908,70,0,3,2280,8038
2.775e+05,2014,334,4,2.5,2550,7500,1,0,0,3,8,1750,800,1976,1976,98023,47.316,122.39,2260,8800,38,0,6.5,4810,11350
3.4e+05,2014,125,5,1,1120,9022,1,0,0,4,7,1120,0,1962,1962,98034,47.73,122.24,1310,7500,52,0,6,2430,8620
3.15e+05,2015,375,3,2.25,2200,8750,1,0,0,4,7,1120,1080,1964,1964,98166,47.476,122.34,1460,10139,51,0,5.25,3660,12339
9.78e+05,2014,325,3,1.5,2390,4000,1,0,0,3,9,1690,700,1936,1936,98105,47.66,122.28,2350,4000,78,0,4.5,4740,6390
4.8e+05,2014,160,5,2.5,2732,9500,1,0,2,4,8,1870,862,1975,1975,98003,47.344,122.32,2720,10000,39,0,7.5,5452,12732
4.4995e+05,2015,433,4,2.5,2420,5244,2,0,0,3,9,2420,0,2007,2007,98166,47.473,122.35,1400,5250,8,0,6.5,3820,7670
5e+05,2014,173,3,1,1150,5100,2,0,0,3,8,1150,0,1911,2005,98136,47.535,122.38,1440,5100,103,1,4,2590,6250
9.29e+05,2014,305,4,3.25,4030,57499,2,0,0,3,9,4030,0,2002,2002,98053,47.662,122.03,3470,57499,12,0,7.25,7500,61529
6.15e+05,2014,280,4,2.25,2500,10062,1,0,0,3,8,1600,900,1975,1975,98052,47.639,122.1,2500,9750,39,0,6.25,5000,12250
3.5e+05,2014,252,2,1.5,1070,937,3,0,0,3,8,1070,0,2003,2003,98115,47.676,122.3,1100,3200,11,0,3.5,2170,4270
4.85e+05,2014,188,4,2.25,1900,7200,1,0,0,3,8,1370,530,1977,1977,98146,47.503,122.37,2030,8008,37,0,6.25,3930,9908
4.7e+05,2014,262,3,2.5,2120,2374,2,0,0,3,8,1770,350,2005,2005,98052,47.674,122.14,2480,3043,9,0,5.5,4600,5163
4.5e+05,2015,467,5,2.5,2510,10240,1,0,0,4,8,1410,1100,1984,1984,98059,47.473,122.14,2170,10500,31,0,7.5,4680,13010
8.78e+05,2015,466,4,2.5,3810,7728,2,0,0,3,9,3810,0,2007,2007,98074,47.593,122.06,3290,7728,8,0,6.5,7100,11538
1.03e+06,2014,252,4,3.25,2830,4000,2,0,0,3,9,1910,920,1912,2012,98144,47.584,122.29,2740,4000,102,1,7.25,5570,6830
2.94e+05,2014,304,3,1.75,1420,1361,2,0,0,3,7,960,460,2014,2014,98108,47.568,122.31,1340,1343,0,0,4.75,2760,2763
3.25e+05,2015,410,3,1.5,2120,41325,1,0,0,4,7,1420,700,1973,1973,98092,47.291,122.06,1780,42000,42,0,4.5,3900,44120
1.698e+06,2014,236,4,3,3600,9687,2,0,0,4,9,3600,0,1959,1995,98004,47.626,122.21,2620,10400,55,1,7,6220,14000
2.89e+05,2014,238,3,1.75,1260,8400,1,0,0,3,7,1260,0,1954,1954,98148,47.437,122.33,1290,8750,60,0,4.75,2550,10010
7.6e+05,2014,214,4,2.25,2500,8500,2,0,0,4,8,2500,0,1979,1979,98006,47.557,122.15,2470,9100,35,0,6.25,4970,11600
3.45e+05,2014,286,3,1.75,710,5050,1,0,0,4,6,710,0,1950,1950,98126,47.519,122.38,900,5050,64,0,4.75,1610,5760
3.567e+06,2015,367,5,4.5,4850,10584,2,1,4,3,10,3540,1310,2007,2007,98008,47.594,122.11,3470,18270,8,0,9.5,8320,23120
7.7e+05,2014,271,3,1.75,1900,6334,1,0,2,3,8,1450,450,1948,1948,98105,47.667,122.28,1530,6334,66,0,4.75,3430,8234
5.295e+05,2015,415,2,1,900,4800,1,0,0,4,6,780,120,1944,1944,98199,47.657,122.4,1270,5520,71,0,3,2170,6420
4.3611e+05,2014,122,3,2.5,1770,1235,3,0,0,3,8,1600,170,2007,2007,98103,47.697,122.34,1680,1203,7,0,5.5,3450,2973
2.8e+05,2014,272,3,1.75,2080,87991,1,0,0,3,6,1040,1040,1970,1970,98014,47.672,121.86,2080,84300,44,0,4.75,4160,86380
2.4125e+05,2014,356,3,1.75,1350,7588,1,0,0,3,7,1350,0,1993,1993,98010,47.312,122.02,1470,7341,21,0,4.75,2820,8691
4.389e+05,2014,340,4,2.5,2740,5700,2,0,0,3,9,2740,0,2006,2006,98038,47.353,122.03,3010,5281,8,0,6.5,5750,8021
9.95e+05,2014,263,3,2.5,2460,10300,1,0,0,3,10,2460,0,1992,1992,98117,47.7,122.39,2410,5250,22,0,5.5,4870,7710
4.36e+05,2015,481,2,1,1040,7538,1,0,0,4,7,1040,0,1939,1939,98133,47.711,122.35,1440,7530,76,0,3,2480,8570
2.4995e+05,2014,250,3,3,1790,2003,2,0,0,3,7,1480,310,2006,2006,98108,47.542,122.32,1220,4000,8,0,6,3010,5790
4.5495e+05,2015,460,4,2.5,2413,5701,2,0,0,3,8,2413,0,2014,2014,98042,47.373,122.16,2380,5725,1,0,6.5,4793,8138
9e+05,2014,125,3,1,1330,77972,1,0,0,3,7,1330,0,1928,1954,98033,47.689,122.16,1340,17689,86,1,4,2670,19019
3.62e+05,2014,244,3,2.75,1420,955,2,0,0,3,8,1160,260,2004,2004,98029,47.548,122,1420,955,10,0,5.75,2840,2375
8.65e+05,2015,458,3,1.75,1480,8163,1,0,0,3,7,1040,440,1953,1953,98004,47.638,122.21,2170,11124,62,0,4.75,3650,12604
3.3e+05,2014,331,2,1,950,3090,1,0,0,4,6,950,0,1909,1909,98118,47.551,122.28,1230,4120,105,0,3,2180,5070
4.47e+05,2014,194,3,2.5,1740,3043,2,0,0,3,7,1740,0,2012,2012,98011,47.744,122.18,1920,2869,2,0,5.5,3660,4609
2.45e+05,2014,340,3,1.75,1720,9342,1,0,0,4,7,1140,580,1981,1981,98092,47.318,122.18,1330,7540,33,0,4.75,3050,9260
7.99e+05,2014,161,3,1.5,2210,6300,1,0,0,5,8,2210,0,1916,1916,98144,47.589,122.29,2700,6300,98,0,4.5,4910,8510
6.05e+05,2015,450,2,1,860,6510,1,0,0,3,7,860,0,1952,1952,98004,47.602,122.2,1740,10800,63,0,3,2600,11660
4.7e+05,2014,214,4,2.5,2350,3800,2,0,0,3,8,2350,0,2014,2014,98059,47.478,122.12,2670,4180,0,0,6.5,5020,6530
3.7e+05,2014,238,4,1,1540,9541,1,0,0,4,7,1540,0,1961,1961,98034,47.71,122.21,1290,9541,53,0,5,2830,11081
3.7e+05,2015,415,4,2.5,2320,9264,2,0,0,3,8,2320,0,1994,1994,98188,47.445,122.27,2320,9129,21,0,6.5,4640,11449
9.75e+05,2014,328,4,3.5,3130,52322,2,0,0,3,9,2430,700,2011,2011,98005,47.593,122.16,3200,5820,3,0,7.5,6330,8950
2.15e+05,2014,208,3,1,1180,7669,1,0,0,4,7,1180,0,1967,1967,98058,47.448,122.18,1190,7669,47,0,4,2370,8849
5.9995e+05,2014,140,3,2.5,2660,4975,2,0,0,3,8,2660,0,2014,2014,98118,47.549,122.27,1840,6653,0,0,5.5,4500,9313
1.99e+05,2014,250,3,1.75,1050,9871,1,0,0,5,7,1050,0,1968,1968,98042,47.382,122.09,1300,10794,46,0,4.75,2350,11844
7.05e+05,2015,457,4,1.5,1780,3120,1,0,3,3,8,1780,0,1926,1926,98118,47.559,122.26,1710,3600,89,0,5.5,3490,5380
2.84e+05,2015,416,3,2.5,2150,9375,1,0,0,3,8,1550,600,1968,1968,98188,47.458,122.27,1950,9100,47,0,5.5,4100,11250
1.05e+06,2015,394,4,1,1330,9729,1,0,0,3,6,1330,0,1952,1952,98004,47.622,122.21,2920,10353,63,0,5,4250,11683
5.95e+05,2015,415,5,3,2980,10064,1,0,0,3,7,1680,1300,1940,1940,98155,47.737,122.32,1590,7800,75,0,8,4570,10780
5.25e+05,2015,473,4,2.25,2620,98881,1,0,0,3,7,1820,800,1952,1952,98070,47.466,122.45,1728,95832,63,0,6.25,4348,98452
2.45e+05,2014,187,2,1,1500,6685,1,0,0,3,7,1190,310,1926,1926,98133,47.719,122.35,1420,6561,88,0,3,2920,8061
4e+05,2014,276,4,3,1810,5012,2,0,0,4,7,1810,0,1997,1997,98108,47.569,122.29,1670,5161,17,0,7,3480,6971
2.9999e+05,2014,297,2,1,1570,1.2545e+05,1,0,3,4,7,1570,0,1953,1953,98022,47.208,122.02,1660,46119,61,0,3,3230,47689
4.5e+05,2014,224,4,2.5,2290,5515,2,0,0,3,8,2290,0,2006,2006,98106,47.552,122.36,1380,5515,8,0,6.5,3670,7805
6.3e+05,2014,217,5,2,2330,6783,1,0,0,3,7,1310,1020,1956,1956,98115,47.696,122.3,1930,6783,58,0,7,4260,9113
6.55e+05,2015,472,6,5,2850,6600,2,0,0,3,7,2850,0,1994,1994,98033,47.681,122.19,1870,9900,21,0,11,4720,12750
3.6e+05,2014,265,4,2.25,3220,7700,2,0,0,4,8,3220,0,1976,1976,98023,47.319,122.38,2570,7700,38,0,6.25,5790,10920
2.6995e+05,2014,294,4,2.5,1960,7230,2,0,0,3,8,1960,0,2002,2002,98023,47.285,122.36,1850,7208,12,0,6.5,3810,9168
3.8e+05,2014,314,6,2,1870,6969,1,0,0,4,7,1870,0,1968,1968,98027,47.534,122.04,1500,6969,46,0,8,3370,8839
5.974e+05,2014,273,4,2.5,2420,4500,2,0,0,3,7,2420,0,2001,2001,98053,47.687,122.04,2280,4500,13,0,6.5,4700,6920
6.26e+05,2014,196,3,1,1040,4240,1,0,0,4,7,860,180,1924,1924,98117,47.677,122.37,1170,4240,90,0,4,2210,5280
3.6e+05,2014,243,4,2.5,2340,13445,2,0,0,3,8,2340,0,1990,1990,98042,47.374,122.13,2340,11188,24,0,6.5,4680,13528
5.5e+05,2014,194,3,1.75,1680,4800,1,0,0,4,7,1400,280,1960,1960,98126,47.553,122.38,1540,5000,54,0,4.75,3220,6680
2.04e+05,2014,235,3,1,1000,12070,1,0,0,4,7,1000,0,1968,1968,98042,47.362,122.11,1010,12635,46,0,4,2010,13635
7.19e+05,2015,453,3,3.5,2540,10578,2,0,1,3,9,2010,530,2014,2014,98006,47.547,122.19,3240,9831,1,0,6.5,5780,12371
4.18e+05,2014,287,3,1.75,1500,19113,1,0,0,3,7,1500,0,1984,1984,98014,47.698,121.92,1820,18151,30,0,4.75,3320,19651
3.8695e+05,2015,409,3,2.5,1070,1089,2,0,0,3,7,900,170,2009,2009,98116,47.59,122.39,1450,1437,6,0,5.5,2520,2507
7.65e+05,2015,466,4,2.25,2620,17366,1,0,3,3,9,1430,1190,1984,1984,98075,47.584,122.08,2620,15335,31,0,6.25,5240,17955
3.1775e+05,2014,238,3,2.5,1980,4500,2,0,0,3,7,1980,0,2012,2012,98042,47.368,122.12,1980,4500,2,0,5.5,3960,6480
6.79e+05,2015,454,4,1.75,2260,41236,1,0,0,4,8,1690,570,1962,1962,98029,47.553,122.03,3080,30240,53,0,5.75,5340,32500
5.95e+05,2014,259,4,2.25,1920,3225,1,0,0,5,7,1300,620,1923,1923,98116,47.585,122.38,1960,3750,91,0,6.25,3880,5670
2.2895e+05,2014,285,4,3,2160,5200,1,0,0,3,7,1320,840,1978,1978,98042,47.363,122.09,1460,5144,36,0,7,3620,7304
7.1e+05,2015,457,2,1,1700,3040,1,0,0,3,8,1460,240,1914,1914,98119,47.644,122.37,1620,3230,101,0,3,3320,4930
5.55e+05,2014,259,4,2,1680,2600,1,0,0,5,7,840,840,1915,1915,98107,47.665,122.36,1680,3340,99,0,6,3360,5020
4.6495e+05,2015,473,4,2.5,1640,6000,2,0,0,3,7,1640,0,2011,2011,98106,47.559,122.36,1640,4800,4,0,6.5,3280,6440
2.49e+05,2015,369,3,1,1030,24750,1,0,2,3,5,1030,0,1943,1943,98023,47.334,122.36,2810,28800,72,0,4,3840,29830
5.35e+05,2015,395,3,2.75,2490,3600,2,0,0,3,8,2290,200,1906,1906,98122,47.61,122.29,1880,3600,109,0,5.75,4370,6090
2.633e+05,2015,427,2,1,900,4500,1,0,0,3,7,900,0,1951,1951,98118,47.527,122.27,1175,5320,64,0,3,2075,6220
4.25e+05,2014,174,4,1.5,1600,6180,1,0,0,3,6,1600,0,1946,1946,98118,47.568,122.28,1410,6180,68,0,5.5,3010,7780
2.37e+05,2014,334,3,2,1290,7952,1,0,0,3,7,1290,0,1998,1998,98030,47.387,122.19,1670,7280,16,0,5,2960,8570
6.305e+05,2014,324,3,2.5,1909,1300,3,0,0,3,8,1766,143,2006,2006,98103,47.654,122.35,1780,1248,8,0,5.5,3689,3157
3.1899e+05,2014,141,4,2.25,2000,9000,1,0,0,4,8,2000,0,1978,1978,98023,47.313,122.39,2190,8374,36,0,6.25,4190,10374
3.5e+05,2015,464,3,1.75,1000,8268,1,0,0,3,6,1000,0,1969,1969,98072,47.742,122.17,1220,7800,46,0,4.75,2220,8800
1.45e+06,2015,447,3,1.75,2230,13529,1,0,0,3,9,2230,0,1949,1949,98004,47.62,122.22,2230,11900,66,0,4.75,4460,14130
6.15e+05,2015,409,4,2.75,3120,34040,2,0,0,3,9,3120,0,1997,1997,98010,47.343,122.03,2420,25201,18,0,6.75,5540,28321
1.45e+06,2014,277,3,2.75,3940,9671,1,0,4,5,9,2140,1800,1967,1967,98006,47.565,122.16,3390,9360,47,0,5.75,7330,13300
5.44e+05,2014,175,4,2.5,2030,3974,2,0,0,3,8,2030,0,1994,1994,98029,47.569,122.01,1780,3953,20,0,6.5,3810,5983
4.79e+05,2015,457,4,2.5,2370,30378,2,0,0,3,8,2370,0,1996,1996,98042,47.339,122.07,2870,34834,19,0,6.5,5240,37204
4.325e+05,2014,209,4,2.5,3172,5033,2,0,0,3,8,3172,0,2014,2014,98023,47.296,122.35,2704,5232,0,0,6.5,5876,8404
6.5e+05,2014,238,3,1,1300,8266,1,0,0,4,7,1300,0,1953,1953,98004,47.634,122.2,1300,8707,61,0,4,2600,10007
2.75e+05,2014,223,2,1.75,2090,11317,1,0,0,5,7,1090,1000,1931,1931,98188,47.459,122.28,1940,11317,83,0,3.75,4030,13407
3.05e+05,2014,303,5,2.25,2660,8400,1,0,0,5,7,2660,0,1961,1961,98092,47.291,122.19,1590,8165,53,0,7.25,4250,10825
5.15e+05,2015,414,3,2.5,3020,12184,2,0,0,3,8,3020,0,2003,2003,98019,47.744,121.98,2980,10029,12,0,5.5,6000,13049
5.0995e+05,2014,229,3,2.5,2210,70567,2,0,3,3,9,2210,0,1995,1995,98014,47.609,121.89,2000,73616,19,0,5.5,4210,75826
2.625e+05,2014,319,4,2.75,1500,7036,1,0,0,3,7,1060,440,1979,1979,98032,47.367,122.28,1620,7200,35,0,6.75,3120,8700
5.8e+05,2014,259,3,1.75,2040,81021,1,0,0,3,8,2040,0,1980,1980,98053,47.654,122.05,2260,39280,34,0,4.75,4300,41320
4.99e+05,2014,258,3,2.5,2090,8505,2,0,0,3,8,2090,0,1951,1977,98177,47.719,122.37,1640,8100,63,1,5.5,3730,10190
2.33e+05,2015,386,4,2,2130,9579,1,0,0,4,7,1250,880,1968,1968,98001,47.307,122.27,1590,9800,47,0,6,3720,11930
4.36e+05,2015,436,3,1.5,1500,10200,1,0,0,3,8,1300,200,1955,1955,98177,47.76,122.36,1950,9500,60,0,4.5,3450,11000
3.29e+05,2014,348,4,2.5,2650,5880,2,0,0,3,9,2650,0,2005,2005,98042,47.351,122.17,2610,6490,9,0,6.5,5260,9140
3.85e+05,2014,211,4,1.5,2040,10726,1,0,0,3,7,1380,660,1954,1954,98177,47.772,122.36,1610,10020,60,0,5.5,3650,12060
2.25e+05,2015,479,3,1,940,9272,1,0,0,3,7,940,0,1954,1954,98148,47.435,122.33,1270,9375,61,0,4,2210,10315
2.16e+05,2015,447,2,1,1810,10360,1,0,0,3,6,1010,800,1946,1946,98178,47.504,122.27,1810,10360,69,0,3,3620,12170
1.265e+06,2015,413,3,1.75,2240,5657,1,0,2,4,8,1910,330,1941,1941,98105,47.662,122.27,2970,5657,74,0,4.75,5210,7897
4.99e+05,2015,367,2,1.5,1540,6549,2,0,0,3,7,1540,0,1980,1980,98133,47.719,122.35,1470,6552,35,0,3.5,3010,8092
5.6e+05,2015,459,3,1,1110,5000,1,0,0,3,7,1110,0,1947,1947,98107,47.655,122.36,1420,5000,68,0,4,2530,6110
8.3e+05,2015,445,4,2.25,3010,12202,1,0,0,4,9,3010,0,1959,1959,98005,47.639,122.17,2480,10143,56,0,6.25,5490,13153
6.9e+05,2014,173,2,1,970,4560,1,0,0,4,7,970,0,1907,1907,98103,47.656,122.33,1500,4560,107,0,3,2470,5530
3.55e+05,2014,174,2,2.25,930,747,2,0,0,3,8,630,300,2007,2007,98144,47.584,122.32,940,6000,7,0,4.25,1870,6930
3.55e+05,2014,177,4,2.5,1890,7867,2,0,0,3,8,1890,0,1996,1996,98038,47.379,122.03,2250,7867,18,0,6.5,4140,9757
3.23e+05,2015,484,4,2.75,2230,50094,1,0,2,4,7,1330,900,1977,1977,98092,47.258,122.1,2230,40770,38,0,6.75,4460,43000
3.695e+05,2015,456,3,1,1200,9194,1,0,0,4,7,1200,0,1952,1952,98155,47.736,122.32,1330,8650,63,0,4,2530,9850
3.891e+05,2014,242,2,1,840,5400,1,0,0,4,7,840,0,1948,1948,98118,47.549,122.27,1340,5400,66,0,3,2180,6240
9.25e+05,2014,249,4,2.5,3110,11422,2,0,0,3,9,3110,0,1989,1989,98115,47.683,122.27,2850,7254,25,0,6.5,5960,10364
4.78e+05,2014,125,3,2.5,3040,4535,2,0,0,3,9,3040,0,2007,2007,98056,47.51,122.19,2670,4666,7,0,5.5,5710,7706
6e+05,2015,383,3,1,970,4800,1,0,0,3,6,970,0,1950,1950,98112,47.621,122.3,1500,2042,65,0,4,2470,3012
8.5e+05,2014,139,4,3.5,2640,5900,2,0,2,3,8,2640,0,1937,1998,98136,47.542,122.38,1700,5900,77,1,7.5,4340,8540
2.7e+05,2014,236,3,2.25,1760,8287,1,0,0,3,7,1160,600,1986,1986,98188,47.45,122.27,1290,9587,28,0,5.25,3050,11347
5.39e+05,2015,380,3,1.5,1460,5040,1,0,0,3,7,1100,360,1971,1971,98133,47.711,122.36,2330,7560,44,0,4.5,3790,9020
2.45e+05,2015,366,3,2,1440,7008,1,0,0,3,7,1440,0,1985,1985,98030,47.37,122.18,1680,7200,30,0,5,3120,8640
8.79e+05,2014,176,4,2.75,4230,31747,2,0,0,4,10,4230,0,1985,1985,98072,47.731,122.13,4080,35576,29,0,6.75,8310,39806
2.4995e+05,2015,440,4,1.75,1620,10530,1,0,0,3,7,1620,0,1968,1968,98030,47.381,122.21,1890,9975,47,0,5.75,3510,11595
1.098e+06,2014,257,6,3.25,3560,1.0736e+05,1,0,0,4,8,2760,800,1963,1963,98005,47.636,122.15,3210,35001,51,0,9.25,6770,38561
6.25e+05,2014,232,2,1,1100,4160,1,0,0,3,7,1100,0,1919,1919,98109,47.635,122.35,1900,4000,95,0,3,3000,5100
7.3e+05,2014,205,3,1.75,2040,11294,1,0,0,4,7,1340,700,1952,1952,98004,47.592,122.2,2120,9587,62,0,4.75,4160,11627
5.51e+05,2014,140,3,2.5,2830,5802,2,0,0,3,9,2830,0,2001,2001,98028,47.761,122.23,2500,5788,13,0,5.5,5330,8618
3.6e+05,2014,197,4,2.5,2080,4080,1,0,0,5,7,1040,1040,1962,1962,98144,47.572,122.29,1340,4080,52,0,6.5,3420,6160
4.025e+05,2015,439,4,2,1650,3504,1,0,0,3,7,760,890,1951,2013,98144,47.58,122.29,1480,3504,64,1,6,3130,5154
3.7e+05,2014,236,2,1.5,1010,2102,2,0,0,3,7,1010,0,1984,1984,98119,47.637,122.38,1480,2632,30,0,3.5,2490,3642
2.23e+06,2014,278,3,3.5,3760,5634,2,1,4,3,11,2830,930,2014,2014,98056,47.529,122.2,3560,5762,0,0,6.5,7320,9522
8.03e+05,2015,369,2,1,1440,33747,1,0,0,3,7,1440,0,1928,1928,98034,47.722,122.21,1980,8400,87,0,3,3420,9840
4.52e+05,2014,210,3,1.5,1250,4000,1,0,0,3,7,1250,0,1955,1955,98117,47.692,122.38,1030,4000,59,0,4.5,2280,5250
3.5995e+05,2014,170,3,2.25,1940,11612,1,0,0,4,8,1100,840,1981,1981,98178,47.502,122.23,2180,8954,33,0,5.25,4120,10894
4.1e+05,2015,422,4,2.5,2240,4447,2,0,0,3,7,2240,0,2006,2006,98059,47.487,122.16,2000,3800,9,0,6.5,4240,6040
4.645e+05,2014,211,4,2.5,1750,11381,1,0,0,4,7,1610,140,1947,1947,98155,47.742,122.32,1080,11375,67,0,6.5,2830,13125
9.85e+05,2014,204,4,3.25,4030,36762,2,0,0,3,11,4030,0,1988,1988,98077,47.724,122.04,4090,40371,26,0,7.25,8120,44401
6.9e+05,2014,237,3,2.25,2430,8327,1,0,0,4,9,1430,1000,1978,1978,98006,47.553,122.16,2550,10427,36,0,5.25,4980,12857
2.84e+05,2015,445,4,2.5,1830,6360,2,0,0,3,8,1830,0,1994,1994,98031,47.418,122.18,1830,6596,21,0,6.5,3660,8426
2.85e+05,2014,208,4,1.75,2510,7440,1,0,2,4,8,1290,1220,1962,1962,98032,47.375,122.28,1790,8000,52,0,5.75,4300,10510
4.4e+05,2014,317,4,2.5,2350,7203,2,0,0,3,8,2350,0,1989,1989,98059,47.512,122.15,2260,7274,25,0,6.5,4610,9624
8.12e+05,2014,265,4,2.5,2270,5000,2,0,0,3,9,2270,0,2014,2014,98117,47.692,122.37,1210,5000,0,0,6.5,3480,7270
4.88e+05,2014,198,3,2.5,3160,13603,2,0,0,3,8,3160,0,2003,2003,98019,47.744,121.98,3050,9232,11,0,5.5,6210,12392
6.27e+05,2014,147,3,3.5,2710,3475,2,0,0,3,8,1650,1060,2005,2005,98027,47.536,122.07,2440,2867,9,0,6.5,5150,5577
4.3e+05,2015,366,2,1,700,4800,1,0,0,3,7,700,0,1922,1922,98122,47.615,122.3,1440,4800,93,0,3,2140,5500
6.13e+05,2014,188,2,2,1170,1890,1,0,1,4,8,1170,0,1927,1927,98119,47.64,122.37,2160,4000,87,0,4,3330,5170
3.9e+05,2015,413,1,1,710,4000,1,0,0,4,6,610,100,1928,1928,98103,47.656,122.35,1440,4500,87,0,2,2150,5210
6.4e+05,2014,238,3,2.5,2790,31798,1,0,0,5,8,1650,1140,1953,1953,98027,47.524,122.04,1400,14849,61,0,5.5,4190,17639
8.1e+05,2015,486,4,2.5,3260,5608,2,0,0,3,9,3260,0,2003,2003,98029,47.545,122,3010,5608,12,0,6.5,6270,8868
3.35e+05,2014,204,2,1.75,1000,5100,1,0,0,3,6,940,60,1906,1906,98117,47.679,122.39,1900,5100,108,0,3.75,2900,6100
6.5e+05,2015,490,4,2.5,3180,5438,2,0,0,3,9,3180,0,2003,2003,98065,47.542,121.86,3030,5335,12,0,6.5,6210,8515
2.5e+05,2014,182,3,2.25,1920,7738,1,0,0,3,8,1520,400,1965,1965,98148,47.456,122.33,2170,8452,49,0,5.25,4090,10372
5.0001e+05,2015,415,4,2.5,2400,9612,1,0,0,3,8,1230,1170,1962,2009,98059,47.48,122.13,2430,5539,53,1,6.5,4830,7939
6.89e+05,2014,249,2,1.75,2330,10143,1,0,2,4,7,1220,1110,1953,1953,98146,47.49,122.36,2560,9750,61,0,3.75,4890,12080
1.9995e+05,2014,218,2,1,700,5200,1,0,0,5,5,700,0,1952,1952,98056,47.492,122.17,970,5200,62,0,3,1670,5900
4.75e+05,2014,338,3,2.5,2680,87117,1,0,0,3,7,1340,1340,1989,1989,98024,47.565,121.94,2580,87117,25,0,5.5,5260,89797
6.35e+05,2015,417,3,1.75,1210,4400,1,0,0,4,8,1210,0,1930,1930,98105,47.662,122.29,2020,3750,85,0,4.75,3230,4960
1.6995e+05,2014,248,3,1,840,8470,1,0,0,4,6,840,0,1961,1961,98023,47.328,122.34,840,8450,53,0,4,1680,9290
3.29e+05,2015,484,2,1,990,57499,1,0,0,2,6,990,0,1949,1949,98070,47.414,122.46,2090,27442,66,0,3,3080,28432
5.358e+05,2014,141,4,2.5,1900,5790,2,0,0,3,8,1900,0,1994,1994,98029,47.569,122,2030,5790,20,0,6.5,3930,7690
3.16e+05,2014,211,2,1,730,5040,1,0,0,3,6,730,0,1927,1927,98126,47.539,122.37,790,5040,87,0,3,1520,5770
2.53e+05,2014,331,3,2,1290,7372,1,0,0,5,7,1290,0,1990,1990,98042,47.366,122.08,1290,7366,24,0,5,2580,8656
2.6e+05,2014,300,3,1,1190,11120,1,0,0,3,6,1190,0,1947,1947,98024,47.569,121.9,1230,12720,67,0,4,2420,13910
8.75e+05,2015,474,3,2.5,1690,10592,1,0,0,3,8,1690,0,1973,2009,98040,47.58,122.23,2260,9945,42,1,5.5,3950,11635
3.9e+05,2015,424,5,1.75,2250,8970,1,0,0,4,7,1500,750,1966,1966,98034,47.722,122.19,1940,8710,49,0,6.75,4190,10960
1.2989e+05,2014,312,2,1,710,9900,1,0,0,3,6,710,0,1943,1943,98166,47.479,122.34,1070,9900,71,0,3,1780,10610
4.425e+05,2014,325,4,2.25,1840,7575,1,0,0,4,7,1390,450,1973,1973,98034,47.733,122.2,1820,7500,41,0,6.25,3660,9340
3.37e+05,2014,180,4,2.5,2230,5970,2,0,0,4,7,2230,0,2002,2002,98042,47.374,122.13,1970,4919,12,0,6.5,4200,7149
6.8172e+05,2014,148,4,2.5,3150,7277,2,0,0,3,9,3150,0,2006,2006,98056,47.516,122.2,3030,8643,8,0,6.5,6180,11793
2.635e+05,2014,264,4,1.75,2210,6375,1,0,0,3,8,1640,570,1977,1977,98003,47.327,122.33,2070,7210,37,0,5.75,4280,9420
1.9995e+05,2014,211,3,1.5,1510,6600,1,0,0,3,6,1510,0,1938,1938,98168,47.482,122.33,990,6600,76,0,4.5,2500,8110
2.1e+05,2014,162,4,1.75,1200,7680,1,0,0,3,7,1200,0,1968,1968,98092,47.314,122.19,1490,7800,46,0,5.75,2690,9000
4.9e+05,2015,436,3,1.75,1470,9750,1,0,0,4,7,1470,0,1978,1978,98052,47.697,122.12,1800,9600,37,0,4.75,3270,11070
9.2276e+05,2014,304,4,3.5,3560,4951,2,0,0,3,9,3560,0,2014,2014,98074,47.618,122.06,3540,5500,0,0,7.5,7100,9060
4.56e+05,2014,170,3,1.5,1440,28516,1,0,0,4,7,1440,0,1975,1975,98075,47.583,122,2080,27049,39,0,4.5,3520,28489
6.69e+05,2014,197,4,2.5,2470,4945,2,0,0,3,8,2470,0,2012,2012,98053,47.69,122.02,2510,4988,2,0,6.5,4980,7458
4.5e+05,2014,175,2,1,1380,4390,1,0,0,4,8,880,500,1931,1931,98115,47.695,122.32,1390,5234,83,0,3,2770,6614
1.05e+06,2014,285,4,3.25,3830,8331,2,0,0,3,9,3830,0,2014,2014,98053,47.691,122.02,4080,8425,0,0,7.25,7910,12255
4.92e+05,2014,155,4,3.75,2810,10840,2,0,2,4,8,2070,740,1994,1994,98045,47.486,121.8,2370,11248,20,0,7.75,5180,14058
5.5e+05,2014,195,3,2,2380,17950,2,0,0,4,8,2110,270,1934,1934,98155,47.759,122.28,2030,23900,80,0,5,4410,26280
3.59e+05,2015,494,2,2.75,1370,1140,2,0,0,3,8,1080,290,2009,2009,98133,47.705,122.34,1370,1090,6,0,4.75,2740,2460
6.7e+05,2014,341,3,1,1600,16868,1,0,1,3,7,990,610,1946,1946,98040,47.587,122.24,2600,12735,68,0,4,4200,14335
4.25e+05,2015,431,4,2.5,1930,14196,1,0,0,4,7,1330,600,1977,1977,98072,47.741,122.1,1470,12852,38,0,6.5,3400,14782
5.05e+05,2014,238,4,2,2730,12000,1,0,0,4,8,1410,1320,1998,1998,98155,47.773,122.27,2730,9039,16,0,6,5460,11769
7.25e+05,2014,211,4,1.75,2190,9400,1,0,0,4,7,1450,740,1962,1962,98033,47.653,122.2,1980,9000,52,0,5.75,4170,11190
3.2e+05,2014,242,5,1,1740,27350,1,0,0,4,5,1740,0,1958,1958,98059,47.481,122.15,2760,10749,56,0,6,4500,12489
2.63e+05,2014,180,3,1.75,1410,8100,2,0,0,3,7,1410,0,1985,1985,98038,47.362,122.05,1560,8100,29,0,4.75,2970,9510
1.799e+05,2014,256,2,1,680,6400,1,0,0,3,6,680,0,1943,1943,98168,47.514,122.32,1240,7800,71,0,3,1920,8480
4.02e+05,2014,221,4,1.75,1640,10500,1,0,0,4,7,1010,630,1968,1968,98052,47.693,122.12,1680,7650,46,0,5.75,3320,9290
2.9998e+05,2014,258,4,1.5,1580,10230,1,0,0,3,6,790,790,1945,2008,98178,47.5,122.25,1130,6955,69,1,5.5,2710,8535
5.7e+05,2014,253,3,2,1270,3090,2,0,0,5,7,1270,0,1911,1911,98117,47.685,122.36,1440,3090,103,0,5,2710,4360
7.85e+05,2014,307,3,2.5,2930,33981,2,0,2,3,9,2930,0,2000,2000,98059,47.515,122.12,3720,35230,14,0,5.5,6650,38160
3.06e+05,2014,143,2,1,780,13500,1,0,0,4,7,780,0,1946,1989,98077,47.738,122.07,2200,67518,68,1,3,2980,68298
3.88e+05,2015,446,2,1.75,800,4800,1,0,0,4,6,800,0,1922,1922,98136,47.556,122.4,1090,5000,93,0,3.75,1890,5800
2.499e+05,2014,300,2,2,1470,2541,2,0,0,3,6,1470,0,2005,2005,98038,47.35,122.02,1310,2721,9,0,4,2780,4191
5.35e+05,2014,249,6,1.75,2460,6000,1,0,0,4,7,1230,1230,1913,1913,98115,47.672,122.32,1560,4275,101,0,7.75,4020,6735
7.5e+05,2014,214,5,1.75,2850,11860,1,0,0,3,9,2850,0,1951,1951,98155,47.75,122.28,2640,11604,63,0,6.75,5490,14454
3.7e+05,2015,480,2,1.5,1280,2096,2,0,0,3,7,1080,200,2007,2007,98144,47.587,122.31,1340,7452,8,0,3.5,2620,8732
3.6e+05,2015,484,3,2.5,2150,14092,2,0,0,3,8,2150,0,1991,1991,98058,47.462,122.13,2400,10699,24,0,5.5,4550,12849
4.67e+05,2015,457,3,2.5,1425,1179,3,0,0,3,8,1425,0,2008,2008,98125,47.696,122.32,1285,1253,7,0,5.5,2710,2678
7.7e+05,2014,197,3,2.5,3680,35617,1,0,0,3,10,2390,1290,1985,1985,98052,47.721,122.12,3570,35633,29,0,5.5,7250,39313
4.27e+05,2014,177,3,2.5,2432,9391,2,0,2,3,9,2432,0,2005,2005,98001,47.345,122.27,2912,8932,9,0,5.5,5344,11364
6.75e+05,2014,300,3,1.75,1240,13869,1,0,0,4,7,1240,0,1957,1957,98033,47.692,122.21,1970,7790,57,0,4.75,3210,9030
2.4e+05,2014,269,4,2.5,2040,11841,2,0,0,3,7,2040,0,1994,1994,98042,47.369,122.07,1730,8808,20,0,6.5,3770,10848
2.7995e+05,2015,407,3,1.75,1660,8303,1,0,0,3,7,1380,280,1974,1974,98058,47.437,122.17,1740,8320,41,0,4.75,3400,9980
5.95e+05,2014,223,4,1.75,2000,5100,1,0,0,4,7,1130,870,1949,1949,98117,47.68,122.39,1540,5100,65,0,5.75,3540,7100
3.35e+05,2015,423,4,1.5,3160,19745,1,0,0,4,6,1840,1320,1968,1968,98010,47.31,122.01,1540,8611,47,0,5.5,4700,11771
3.3e+05,2015,493,4,1.75,1720,8300,1,0,0,4,8,1720,0,1965,1965,98055,47.465,122.19,1840,8300,50,0,5.75,3560,10020
8.75e+05,2014,318,4,2.25,2380,4876,2,0,0,4,9,2240,140,1948,1948,98117,47.682,122.4,1780,4559,66,0,6.25,4160,6939
3.67e+05,2014,204,3,1,810,7000,1,0,0,3,7,810,0,1968,1968,98052,47.659,122.13,1820,7589,46,0,4,2630,8399
7.2e+05,2015,443,4,2.5,3450,39683,2,0,0,3,10,3450,0,2002,2002,98010,47.342,122.03,3350,39750,13,0,6.5,6800,43200
6.25e+05,2014,141,4,2.5,2630,48706,2,0,0,3,8,2630,0,1986,1986,98072,47.775,122.13,2680,48706,28,0,6.5,5310,51336
4.61e+05,2015,413,3,1.5,1270,1416,3,0,0,3,8,1270,0,2007,2007,98115,47.699,122.32,1270,1413,8,0,4.5,2540,2683
6.56e+05,2015,431,2,2.5,2270,1763,3,0,0,3,7,1820,450,2009,2009,98052,47.676,122.12,2180,1763,6,0,4.5,4450,4033
4.65e+05,2014,148,3,2.25,1840,5752,2,0,0,3,7,1840,0,2003,2003,98034,47.704,122.19,1670,2462,11,0,5.25,3510,4302
8.245e+05,2015,473,4,2.5,2610,3500,1,0,0,5,7,1610,1000,1927,1927,98115,47.685,122.33,1820,3900,88,0,6.5,4430,6510
3.87e+05,2014,126,3,1,1230,9568,1,0,0,5,7,1230,0,1962,1962,98056,47.539,122.18,1270,9575,52,0,4,2500,10805
2.3e+05,2014,149,2,1,950,7560,1,0,0,3,6,950,0,1958,1958,98058,47.45,122.18,1160,7560,56,0,3,2110,8510
3.4e+05,2014,251,5,2,1750,8220,1,0,0,3,7,1750,0,1956,1956,98155,47.769,122.32,1210,6760,58,0,7,2960,8510
7.15e+05,2015,447,2,1,1000,3513,1,0,4,4,5,1000,0,1914,1914,98116,47.593,122.39,1930,4920,101,0,3,2930,5920
7.49e+05,2014,286,4,2,2040,11850,1,0,2,3,7,1020,1020,1959,1959,98033,47.689,122.21,2040,8504,55,0,6,4080,10544
2.95e+05,2014,326,3,2.5,1690,4102,2,0,0,3,7,1690,0,2003,2003,98038,47.355,122.02,1830,4733,11,0,5.5,3520,6423
3.125e+05,2014,261,2,1,870,7227,1,0,0,3,7,870,0,1948,1948,98133,47.729,122.33,1250,7252,66,0,3,2120,8122
7.33e+05,2014,221,3,2.5,2160,9888,2,0,0,4,9,2160,0,1989,1989,98052,47.671,122.14,3060,7829,25,0,5.5,5220,9989
4.75e+05,2015,427,4,2.5,2040,16200,2,0,0,3,8,2040,0,1997,1997,98019,47.737,121.96,2530,15389,18,0,6.5,4570,17429
3.75e+05,2014,229,3,2.5,1520,5649,2,0,0,4,7,1520,0,1989,1989,98034,47.722,122.16,1540,5000,25,0,5.5,3060,6520
2.6e+05,2014,173,4,2.5,2000,37045,2,0,0,3,8,2000,0,1989,1989,98042,47.34,122.07,2390,36868,25,0,6.5,4390,38868
7.625e+05,2015,399,4,2.25,3130,41382,2,0,0,3,9,3130,0,1986,1986,98053,47.668,122.03,3130,54886,29,0,6.25,6260,58016
